,Date,daily number of doses received by Larimer County residents,total number of doses recevied by residents,daily number of residents receiving first dose,total number of residents receiving first dose,daily number of residents vaccinated,total number of residents vaccinated,daily number of 70+ vaccinated,total number of 70+ vaccinated,daily number of 70+ at least one dose,total number of 70+ at least one dose,daily number of Latinx residents vaccinated,total of Latinx residents vaccinated,daily number of White non-Latinx residents vaccinated,total of White non-Latinx residents vaccinated,daily number of non-White non-Latinx residents vaccinated,total of non-White non-Latinx residents vaccinated,dailyUnknown,totalUnknown,daily_additional_doses,total_additional_doses
0,12/14/2020,32,32,32,32,1,1,0.0,0,1.0,1,0.0,0,1,1,0.0,0,,0,0,0
1,12/15/2020,13,45,13,45,0,1,,0,,1,,0,0,1,0.0,0,,0,0,0
2,12/16/2020,303,348,303,348,0,1,0.0,0,2.0,3,0.0,0,0,1,0.0,0,0.0,0,0,0
3,12/17/2020,990,1338,990,1338,0,1,0.0,0,11.0,14,0.0,0,0,1,0.0,0,0.0,0,0,0
4,12/18/2020,1057,2395,1057,2395,2,3,0.0,0,15.0,29,0.0,0,2,3,0.0,0,0.0,0,0,0
5,12/19/2020,722,3117,722,3117,0,3,0.0,0,14.0,43,0.0,0,0,3,0.0,0,0.0,0,0,0
6,12/20/2020,266,3383,266,3383,0,3,0.0,0,4.0,47,0.0,0,0,3,0.0,0,0.0,0,0,0
7,12/21/2020,358,3741,358,3741,3,6,0.0,0,3.0,50,0.0,0,3,6,0.0,0,0.0,0,0,0
8,12/22/2020,364,4105,364,4105,0,6,0.0,0,7.0,57,0.0,0,0,6,0.0,0,0.0,0,0,0
9,12/23/2020,440,4545,440,4545,0,6,0.0,0,6.0,63,0.0,0,0,6,0.0,0,0.0,0,0,0
10,12/24/2020,105,4650,105,4650,0,6,0.0,0,3.0,66,0.0,0,0,6,0.0,0,0.0,0,0,0
11,12/25/2020,1,4651,1,4651,0,6,,0,,66,,0,0,6,,0,,0,0,0
12,12/26/2020,228,4879,228,4879,1,7,0.0,0,3.0,69,0.0,0,1,7,0.0,0,0.0,0,0,0
13,12/27/2020,278,5157,278,5157,0,7,0.0,0,197.0,266,0.0,0,0,7,0.0,0,,0,0,0
14,12/28/2020,708,5865,708,5865,0,7,0.0,0,386.0,652,0.0,0,0,7,0.0,0,0.0,0,0,0
15,12/29/2020,912,6777,911,6776,1,8,0.0,0,461.0,1113,0.0,0,1,8,0.0,0,0.0,0,0,0
16,12/30/2020,883,7660,883,7659,0,8,0.0,0,273.0,1386,0.0,0,0,8,0.0,0,0.0,0,0,0
17,12/31/2020,895,8555,895,8554,0,8,0.0,0,343.0,1729,0.0,0,0,8,0.0,0,0.0,0,0,0
18,1/1/2021,4,8559,3,8557,1,9,,0,,1729,,0,1,9,,0,,0,0,0
19,1/2/2021,392,8951,392,8949,1,10,0.0,0,141.0,1870,0.0,0,1,10,0.0,0,0.0,0,0,0
20,1/3/2021,123,9074,123,9072,0,10,0.0,0,52.0,1922,0.0,0,0,10,0.0,0,0.0,0,0,0
21,1/4/2021,588,9662,575,9647,12,22,0.0,0,320.0,2242,0.0,0,10,20,2.0,2,0.0,0,0,0
22,1/5/2021,646,10308,637,10284,10,32,0.0,0,409.0,2651,0.0,0,9,29,1.0,3,0.0,0,0,0
23,1/6/2021,1232,11540,914,11198,312,344,4.0,4,515.0,3166,18.0,18,273,302,17.0,20,4.0,4,0,0
24,1/7/2021,1657,13197,702,11900,933,1277,11.0,15,406.0,3572,34.0,52,842,1144,42.0,62,15.0,19,0,0
25,1/8/2021,1990,15187,980,12880,996,2273,11.0,26,478.0,4050,48.0,100,885,2029,44.0,106,19.0,38,1,1
26,1/9/2021,1230,16417,529,13409,684,2957,12.0,38,303.0,4353,16.0,116,619,2648,37.0,143,12.0,50,0,1
27,1/10/2021,702,17119,427,13836,272,3229,4.0,42,260.0,4613,10.0,126,245,2893,14.0,157,3.0,53,0,1
28,1/11/2021,1149,18268,798,14634,348,3577,1.0,43,536.0,5149,10.0,136,316,3209,19.0,176,3.0,56,0,1
29,1/12/2021,1178,19446,880,15514,297,3874,8.0,51,517.0,5666,14.0,150,257,3466,18.0,194,8.0,64,1,2
30,1/13/2021,1079,20525,833,16347,243,4117,1.0,52,376.0,6042,23.0,173,197,3663,15.0,209,8.0,72,0,2
31,1/14/2021,871,21396,836,17183,35,4152,1.0,53,494.0,6536,2.0,175,31,3694,1.0,210,1.0,73,0,2
32,1/15/2021,1219,22615,1207,18390,12,4164,0.0,53,760.0,7296,0.0,175,12,3706,0.0,210,0.0,73,0,2
33,1/16/2021,985,23600,971,19361,14,4178,1.0,54,585.0,7881,0.0,175,13,3719,1.0,211,0.0,73,0,2
34,1/17/2021,52,23652,48,19409,4,4182,0.0,54,19.0,7900,0.0,175,2,3721,2.0,213,0.0,73,0,2
35,1/18/2021,1016,24668,814,20223,200,4382,48.0,102,600.0,8500,8.0,183,174,3895,13.0,226,5.0,78,2,4
36,1/19/2021,1256,25924,1116,21339,138,4520,8.0,110,736.0,9236,7.0,190,118,4013,6.0,232,7.0,85,0,4
37,1/20/2021,1422,27346,1202,22541,218,4738,17.0,127,570.0,9806,15.0,205,177,4190,9.0,241,17.0,102,1,5
38,1/21/2021,2250,29596,2041,24582,209,4947,7.0,134,1587.0,11393,13.0,218,174,4364,15.0,256,7.0,109,0,5
39,1/22/2021,1737,31333,1461,26043,275,5222,90.0,224,1092.0,12485,34.0,252,222,4586,13.0,269,6.0,115,0,5
40,1/23/2021,895,32228,560,26603,334,5556,58.0,282,416.0,12901,8.0,260,305,4891,13.0,282,8.0,123,0,5
41,1/24/2021,393,32621,104,26707,286,5842,206.0,488,61.0,12962,8.0,268,269,5160,9.0,291,,123,0,5
42,1/25/2021,1405,34026,784,27491,612,6454,362.0,850,554.0,13516,14.0,282,571,5731,15.0,306,12.0,135,0,5
43,1/26/2021,1621,35647,691,28182,917,7371,453.0,1303,441.0,13957,30.0,312,842,6573,32.0,338,13.0,148,0,5
44,1/27/2021,1838,37485,769,28951,1065,8436,537.0,1840,334.0,14291,40.0,352,970,7543,45.0,383,10.0,158,0,5
45,1/28/2021,1345,38830,539,29490,803,9239,356.0,2196,295.0,14586,25.0,377,735,8278,28.0,411,15.0,173,2,7
46,1/29/2021,1634,40464,1156,30646,475,9714,157.0,2353,826.0,15412,21.0,398,412,8690,32.0,443,10.0,183,0,7
47,1/30/2021,1230,41694,736,31382,490,10204,213.0,2566,599.0,16011,24.0,422,440,9130,20.0,463,6.0,189,0,7
48,1/31/2021,623,42317,398,31780,224,10428,76.0,2642,353.0,16364,5.0,427,198,9328,15.0,478,6.0,195,1,8
49,2/1/2021,1606,43923,902,32682,704,11132,469.0,3111,655.0,17019,17.0,444,650,9978,27.0,505,10.0,205,1,9
50,2/2/2021,1863,45786,729,33411,1130,12262,734.0,3845,582.0,17601,43.0,487,1042,11020,34.0,539,11.0,216,0,9
51,2/3/2021,1263,47049,583,33994,677,12939,320.0,4165,226.0,17827,48.0,535,577,11597,41.0,580,11.0,227,0,9
52,2/4/2021,2533,49582,1792,35786,732,13671,489.0,4654,1549.0,19376,29.0,564,656,12253,37.0,617,10.0,237,1,10
53,2/5/2021,2580,52162,1533,37319,1034,14705,681.0,5335,1305.0,20681,38.0,602,948,13201,30.0,647,18.0,255,2,12
54,2/6/2021,2220,54382,1597,38916,615,15320,442.0,5777,1241.0,21922,7.0,609,584,13785,22.0,669,2.0,257,0,12
55,2/7/2021,232,54614,89,39005,141,15461,94.0,5871,26.0,21948,7.0,616,125,13910,4.0,673,5.0,262,1,13
56,2/8/2021,2485,57099,1597,40602,882,16343,597.0,6468,1139.0,23087,26.0,642,811,14721,28.0,701,17.0,279,0,13
57,2/9/2021,2390,59489,1545,42147,840,17183,511.0,6979,997.0,24084,25.0,667,755,15476,32.0,733,28.0,307,0,13
58,2/10/2021,1585,61074,966,43113,615,17798,321.0,7300,288.0,24372,26.0,693,547,16023,26.0,759,16.0,323,4,17
59,2/11/2021,3533,64607,2001,45114,1524,19322,1054.0,8354,809.0,25181,55.0,748,1394,17417,49.0,808,26.0,349,2,19
60,2/12/2021,3262,67869,1810,46924,1442,20764,954.0,9308,800.0,25981,61.0,809,1326,18743,42.0,850,13.0,362,0,19
61,2/13/2021,2996,70865,2363,49287,627,21391,309.0,9617,672.0,26653,13.0,822,580,19323,23.0,873,11.0,373,1,20
62,2/14/2021,421,71286,350,49637,71,21462,49.0,9666,46.0,26699,2.0,824,64,19387,3.0,876,2.0,375,0,20
63,2/15/2021,2622,73908,2129,51766,491,21953,325.0,9991,256.0,26955,17.0,841,460,19847,12.0,888,2.0,377,0,20
64,2/16/2021,2749,76657,1917,53683,827,22780,499.0,10490,230.0,27185,35.0,876,752,20599,24.0,912,16.0,393,0,20
65,2/17/2021,1633,78290,656,54339,973,23753,480.0,10970,155.0,27340,29.0,905,888,21487,36.0,948,20.0,413,0,20
66,2/18/2021,2640,80930,1674,56013,955,24708,733.0,11703,275.0,27615,37.0,942,880,22367,30.0,978,8.0,421,1,21
67,2/19/2021,2424,83354,1031,57044,1377,26085,1019.0,12722,155.0,27770,44.0,986,1275,23642,43.0,1021,15.0,436,3,24
68,2/20/2021,1651,85005,688,57732,959,27044,784.0,13506,134.0,27904,22.0,1008,899,24541,28.0,1049,10.0,446,1,25
69,2/21/2021,108,85113,40,57772,67,27111,37.0,13543,8.0,27912,1.0,1009,64,24605,2.0,1051,0.0,446,0,25
70,2/22/2021,2024,87137,763,58535,1250,28361,925.0,14468,147.0,28059,37.0,1046,1166,25771,37.0,1088,10.0,456,1,26
71,2/23/2021,1221,88358,517,59052,703,29064,470.0,14938,161.0,28220,20.0,1066,635,26406,35.0,1123,13.0,469,0,26
72,2/24/2021,1409,89767,754,59806,648,29712,276.0,15214,136.0,28356,31.0,1097,593,26999,19.0,1142,5.0,474,1,27
73,2/25/2021,3864,93631,2071,61877,1788,31500,1508.0,16722,351.0,28707,47.0,1144,1688,28687,36.0,1178,17.0,491,0,27
74,2/26/2021,3272,96903,1157,63034,2109,33609,1744.0,18466,201.0,28908,33.0,1177,1988,30675,59.0,1237,29.0,520,2,29
75,2/27/2021,3496,100399,1663,64697,1824,35433,1561.0,20027,544.0,29452,36.0,1213,1709,32384,52.0,1289,27.0,547,1,30
76,2/28/2021,427,100826,357,65054,69,35502,43.0,20070,114.0,29566,2.0,1215,63,32447,2.0,1291,2.0,549,0,30
77,3/1/2021,2816,103642,1341,66395,1469,36971,1078.0,21148,300.0,29866,53.0,1268,1358,33805,46.0,1337,12.0,561,5,35
78,3/2/2021,3256,106898,1728,68123,1520,38491,1050.0,22198,383.0,30249,38.0,1306,1411,35216,44.0,1381,27.0,588,1,36
79,3/3/2021,1657,108555,1091,69214,564,39055,176.0,22374,202.0,30451,32.0,1338,504,35720,24.0,1405,4.0,592,0,36
80,3/4/2021,3004,111559,1582,70796,1423,40478,816.0,23190,170.0,30621,43.0,1381,1307,37027,53.0,1458,20.0,612,25,61
81,3/5/2021,3483,115042,2055,72851,1436,41914,814.0,24004,426.0,31047,39.0,1420,1332,38359,42.0,1500,23.0,635,26,87
82,3/6/2021,4105,119147,2322,75173,1993,43907,755.0,24759,268.0,31315,95.0,1515,1785,40144,78.0,1578,35.0,670,582,669
83,3/7/2021,417,119564,301,75474,125,44032,37.0,24796,20.0,31335,1.0,1516,119,40263,3.0,1581,2.0,672,23,692
84,3/8/2021,2822,122386,1055,76529,1775,45807,261.0,25057,74.0,31409,49.0,1565,1641,41904,62.0,1643,23.0,695,124,816
85,3/9/2021,3182,125568,1651,78180,1546,47353,263.0,25320,96.0,31505,51.0,1616,1406,43310,64.0,1707,25.0,720,73,889
86,3/10/2021,2383,127951,1368,79548,1022,48375,300.0,25620,83.0,31588,54.0,1670,920,44230,32.0,1739,16.0,736,63,952
87,3/11/2021,4175,132126,2378,81926,1804,50179,400.0,26020,135.0,31723,63.0,1733,1654,45884,67.0,1806,20.0,756,76,1028
88,3/12/2021,3949,136075,2576,84502,1395,51574,198.0,26218,67.0,31790,67.0,1800,1242,47126,53.0,1859,33.0,789,69,1097
89,3/13/2021,214,136289,131,84633,99,51673,20.0,26238,7.0,31797,1.0,1801,92,47218,4.0,1863,2.0,791,30,1127
90,3/14/2021,100,136389,60,84693,39,51712,9.0,26247,0.0,31797,1.0,1802,36,47254,1.0,1864,1.0,792,2,1129
91,3/15/2021,897,137286,361,85054,536,52248,85.0,26332,15.0,31812,19.0,1821,493,47747,17.0,1881,7.0,799,19,1148
92,3/16/2021,3286,140572,2115,87169,1174,53422,227.0,26559,45.0,31857,64.0,1885,1047,48794,41.0,1922,22.0,821,30,1178
93,3/17/2021,2907,143479,1786,88955,1125,54547,238.0,26797,88.0,31945,40.0,1925,1030,49824,35.0,1957,20.0,841,31,1209
94,3/18/2021,4004,147483,2092,91047,1923,56470,338.0,27135,91.0,32036,97.0,2022,1741,51565,64.0,2021,21.0,862,21,1230
95,3/19/2021,3000,150483,1751,92798,1250,57720,221.0,27356,42.0,32078,60.0,2082,1125,52690,46.0,2067,19.0,881,16,1246
96,3/20/2021,3081,153564,1965,94763,1118,58838,313.0,27669,54.0,32132,37.0,2119,1006,53696,54.0,2121,21.0,902,36,1282
97,3/21/2021,659,154223,396,95159,265,59103,26.0,27695,5.0,32137,11.0,2130,236,53932,16.0,2137,2.0,904,18,1300
98,3/22/2021,3110,157333,2244,97403,865,59968,188.0,27883,56.0,32193,19.0,2149,796,54728,37.0,2174,13.0,917,26,1326
99,3/23/2021,4441,161774,3566,100969,1177,61145,194.0,28077,75.0,32268,40.0,2189,1049,55777,50.0,2224,38.0,955,487,1813
100,3/24/2021,3162,164936,2427,103396,748,61893,117.0,28194,37.0,32305,40.0,2229,668,56445,26.0,2250,14.0,969,33,1846
101,3/25/2021,5069,170005,3053,106449,2016,63909,312.0,28506,71.0,32376,68.0,2297,1848,58293,69.0,2319,31.0,1000,15,1861
102,3/26/2021,4579,174584,2732,109181,1845,65754,328.0,28834,65.0,32441,119.0,2416,1583,59876,112.0,2431,31.0,1031,30,1891
103,3/27/2021,3341,177925,1912,111093,1424,67178,325.0,29159,21.0,32462,49.0,2465,1309,61185,46.0,2477,20.0,1051,5,1896
104,3/28/2021,1169,179094,809,111902,361,67539,92.0,29251,16.0,32478,12.0,2477,331,61516,16.0,2493,2.0,1053,4,1900
105,3/29/2021,3982,183076,2686,114588,1295,68834,229.0,29480,52.0,32530,39.0,2516,1215,62731,28.0,2521,13.0,1066,8,1908
106,3/30/2021,4373,187449,2756,117344,1644,70478,237.0,29717,74.0,32604,55.0,2571,1503,64234,68.0,2589,18.0,1084,46,1954
107,3/31/2021,3567,191016,2554,119898,1047,71525,166.0,29883,47.0,32651,41.0,2612,936,65170,50.0,2639,20.0,1104,29,1983
108,4/1/2021,5111,196127,3334,123232,1788,73313,148.0,30031,76.0,32727,73.0,2685,1637,66807,59.0,2698,19.0,1123,32,2015
109,4/2/2021,4704,200831,2521,125753,2182,75495,245.0,30276,49.0,32776,82.0,2767,1984,68791,91.0,2789,25.0,1148,27,2042
110,4/3/2021,4258,205089,3527,129280,763,76258,94.0,30370,41.0,32817,37.0,2804,677,69468,29.0,2818,20.0,1168,69,2111
111,4/4/2021,371,205460,257,129537,132,76390,6.0,30376,7.0,32824,3.0,2807,116,69584,11.0,2829,2.0,1170,33,2144
112,4/5/2021,4687,210147,3758,133295,953,77343,75.0,30451,47.0,32871,70.0,2877,815,70399,49.0,2878,19.0,1189,91,2235
113,4/6/2021,5163,215310,3031,136326,2317,79660,85.0,30536,58.0,32929,80.0,2957,2054,72453,126.0,3004,57.0,1246,270,2505
114,4/7/2021,4966,220276,3686,140012,2172,81832,59.0,30595,109.0,33038,118.0,3075,1847,74300,134.0,3138,73.0,1319,1163,3668
115,4/8/2021,6688,226964,4511,144523,2872,84704,137.0,30732,123.0,33161,136.0,3211,2518,76818,142.0,3280,76.0,1395,925,4593
116,4/9/2021,5723,232687,3263,147786,3231,87935,77.0,30809,71.0,33232,162.0,3373,2801,79619,181.0,3461,87.0,1482,809,5402
117,4/10/2021,4431,237118,3163,150949,1747,89682,51.0,30860,71.0,33303,99.0,3472,1476,81095,119.0,3580,53.0,1535,513,5915
118,4/11/2021,1035,238153,794,151743,286,89968,5.0,30865,11.0,33314,12.0,3484,239,81334,24.0,3604,11.0,1546,57,5972
119,4/12/2021,5037,243190,3638,155381,2017,91985,76.0,30941,96.0,33410,77.0,3561,1747,83081,133.0,3737,60.0,1606,506,6478
120,4/13/2021,5033,248223,3561,158942,1487,93472,55.0,30996,77.0,33487,70.0,3631,1297,84378,96.0,3833,24.0,1630,21,6499
121,4/14/2021,2953,251176,1436,160378,1511,94983,86.0,31082,26.0,33513,93.0,3724,1315,85693,70.0,3903,33.0,1663,2,6501
122,4/15/2021,4951,256127,2328,162706,2608,97591,102.0,31184,58.0,33571,218.0,3942,2168,87861,161.0,4064,61.0,1724,2,6503
123,4/16/2021,3907,260034,2077,164783,1817,99408,44.0,31228,34.0,33605,67.0,4009,1590,89451,126.0,4190,34.0,1758,4,6507
124,4/17/2021,4586,264620,2402,167185,2168,101576,39.0,31267,57.0,33662,99.0,4108,1885,91336,132.0,4322,52.0,1810,4,6511
125,4/18/2021,1038,265658,408,167593,623,102199,13.0,31280,11.0,33673,42.0,4150,518,91854,33.0,4355,30.0,1840,4,6515
126,4/19/2021,3860,269518,1411,169004,2425,104624,44.0,31324,40.0,33713,165.0,4315,2039,93893,161.0,4516,60.0,1900,5,6520
127,4/20/2021,4696,274214,1866,170870,2817,107441,47.0,31371,69.0,33782,160.0,4475,2400,96293,193.0,4709,64.0,1964,5,6525
128,4/21/2021,3166,277380,708,171578,2449,109890,35.0,31406,31.0,33813,146.0,4621,2061,98354,163.0,4872,79.0,2043,4,6529
129,4/22/2021,4659,282039,1773,173351,2874,112764,46.0,31452,62.0,33875,143.0,4764,2464,100818,193.0,5065,74.0,2117,2,6531
130,4/23/2021,3591,285630,1178,174529,2398,115162,41.0,31493,30.0,33905,73.0,4837,2114,102932,128.0,5193,83.0,2200,5,6536
131,4/24/2021,3360,288990,1118,175647,2237,117399,14.0,31507,20.0,33925,104.0,4941,1896,104828,196.0,5389,41.0,2241,5,6541
132,4/25/2021,795,289785,344,175991,450,117849,6.0,31513,6.0,33931,104.0,5045,267,105095,38.0,5427,41.0,2282,1,6542
133,4/26/2021,4358,294143,1115,177106,3236,121085,35.0,31548,31.0,33962,146.0,5191,2783,107878,214.0,5641,93.0,2375,4,6546
134,4/27/2021,3344,297487,1192,178298,2145,123230,36.0,31584,37.0,33999,79.0,5270,1889,109767,134.0,5775,43.0,2418,10,6556
135,4/28/2021,2985,300472,715,179013,2269,125499,45.0,31629,20.0,34019,167.0,5437,1840,111607,196.0,5971,66.0,2484,14,6570
136,4/29/2021,3968,304440,821,179834,3141,128640,67.0,31696,33.0,34052,227.0,5664,2581,114188,225.0,6196,108.0,2592,8,6578
137,4/30/2021,2869,307309,641,180475,2228,130868,44.0,31740,24.0,34076,73.0,5737,1894,116082,198.0,6394,63.0,2655,11,6589
138,5/1/2021,3642,310951,819,181294,2805,133673,35.0,31775,18.0,34094,282.0,6019,2184,118266,200.0,6594,139.0,2794,16,6605
139,5/2/2021,528,311479,232,181526,307,133980,7.0,31782,2.0,34096,12.0,6031,247,118513,38.0,6632,10.0,2804,10,6615
140,5/3/2021,3425,314904,636,182162,2788,136768,47.0,31829,34.0,34130,107.0,6138,2392,120905,212.0,6844,77.0,2881,12,6627
141,5/4/2021,4344,319248,696,182858,3666,140434,67.0,31896,27.0,34157,148.0,6286,3149,124054,258.0,7102,111.0,2992,28,6655
142,5/5/2021,2227,321475,477,183335,1786,142220,63.0,31959,24.0,34181,86.0,6372,1480,125534,141.0,7243,79.0,3071,13,6668
143,5/6/2021,3688,325163,822,184157,2984,145204,100.0,32059,40.0,34221,178.0,6550,2473,128007,197.0,7440,136.0,3207,45,6713
144,5/7/2021,2942,328105,543,184700,2491,147695,44.0,32103,11.0,34232,134.0,6684,2047,130054,212.0,7652,98.0,3305,38,6751
145,5/8/2021,2984,331089,554,185254,2533,150228,45.0,32148,16.0,34248,167.0,6851,2042,132096,194.0,7846,130.0,3435,47,6798
146,5/9/2021,366,331455,140,185394,239,150467,4.0,32152,2.0,34250,10.0,6861,199,132295,20.0,7866,10.0,3445,3,6801
147,5/10/2021,2424,333879,379,185773,2079,152546,60.0,32212,16.0,34266,87.0,6948,1691,133986,205.0,8071,96.0,3541,25,6826
148,5/11/2021,2716,336595,542,186315,2217,154763,92.0,32304,24.0,34290,190.0,7138,1728,135714,203.0,8274,96.0,3637,17,6843
149,5/12/2021,1223,337818,458,186773,817,155580,23.0,32327,14.0,34304,48.0,7186,648,136362,86.0,8360,35.0,3672,23,6866
150,5/13/2021,3253,341071,1032,187805,2237,157817,82.0,32409,25.0,34329,151.0,7337,1822,138184,159.0,8519,105.0,3777,16,6882
151,5/14/2021,2474,343545,1280,189085,1292,159109,51.0,32460,30.0,34359,64.0,7401,1072,139256,101.0,8620,55.0,3832,34,6916
152,5/15/2021,3021,346566,1509,190594,1597,160706,40.0,32500,15.0,34374,114.0,7515,1267,140523,142.0,8762,74.0,3906,25,6941
153,5/16/2021,945,347511,573,191167,405,161111,8.0,32508,8.0,34382,83.0,7598,252,140775,30.0,8792,40.0,3946,10,6951
154,5/17/2021,2451,349962,1211,192378,1311,162422,38.0,32546,27.0,34409,48.0,7646,1102,141877,101.0,8893,60.0,4006,21,6972
155,5/18/2021,2587,352549,1178,193556,1443,163865,44.0,32590,22.0,34431,72.0,7718,1212,143089,83.0,8976,76.0,4082,19,6991
156,5/19/2021,1875,354424,1153,194709,786,164651,24.0,32614,19.0,34450,42.0,7760,636,143725,69.0,9045,39.0,4121,16,7007
157,5/20/2021,1980,356404,924,195633,1099,165750,45.0,32659,27.0,34477,93.0,7853,875,144600,81.0,9126,50.0,4171,17,7024
158,5/21/2021,1627,358031,922,196555,784,166534,18.0,32677,16.0,34493,43.0,7896,624,145224,60.0,9186,57.0,4228,27,7051
159,5/22/2021,1685,359716,792,197347,922,167456,9.0,32686,13.0,34506,122.0,8018,640,145864,74.0,9260,86.0,4314,15,7066
160,5/23/2021,680,360396,342,197689,368,167824,2.0,32688,5.0,34511,68.0,8086,227,146091,18.0,9278,55.0,4369,3,7069
161,5/24/2021,1336,361732,537,198226,851,168675,36.0,32724,20.0,34531,43.0,8129,684,146775,83.0,9361,41.0,4410,19,7088
162,5/25/2021,1232,362964,508,198734,756,169431,22.0,32746,20.0,34551,57.0,8186,569,147344,65.0,9426,65.0,4475,18,7106
163,5/26/2021,968,363932,554,199288,526,169957,17.0,32763,25.0,34576,37.0,8223,415,147759,44.0,9470,30.0,4505,25,7131
164,5/27/2021,1271,365203,657,199945,679,170636,32.0,32795,19.0,34595,54.0,8277,548,148307,50.0,9520,27.0,4532,19,7150
165,5/28/2021,1030,366233,597,200542,478,171114,18.0,32813,22.0,34617,29.0,8306,373,148680,48.0,9568,28.0,4560,16,7166
166,5/29/2021,1017,367250,493,201035,561,171675,18.0,32831,8.0,34625,32.0,8338,442,149122,42.0,9610,45.0,4605,12,7178
167,5/30/2021,331,367581,220,201255,142,171817,5.0,32836,3.0,34628,12.0,8350,103,149225,17.0,9627,10.0,4615,10,7188
168,5/31/2021,339,367920,192,201447,174,171991,8.0,32844,6.0,34634,8.0,8358,139,149364,13.0,9640,14.0,4629,10,7198
169,6/1/2021,967,368887,396,201843,603,172594,27.0,32871,17.0,34651,49.0,8407,461,149825,46.0,9686,47.0,4676,23,7221
170,6/2/2021,720,369607,369,202212,407,173001,16.0,32887,8.0,34659,34.0,8441,322,150147,23.0,9709,28.0,4704,8,7229
171,6/3/2021,1307,370914,522,202734,835,173836,22.0,32909,12.0,34671,47.0,8488,689,150836,57.0,9766,42.0,4746,15,7244
172,6/4/2021,1502,372416,403,203137,1140,174976,16.0,32925,9.0,34680,71.0,8559,951,151787,70.0,9836,48.0,4794,4,7248
173,6/5/2021,1414,373830,357,203494,1084,176060,12.0,32937,6.0,34686,64.0,8623,888,152675,92.0,9928,40.0,4834,9,7257
174,6/6/2021,530,374360,141,203635,398,176458,5.0,32942,3.0,34689,43.0,8666,318,152993,25.0,9953,12.0,4846,10,7267
175,6/7/2021,1194,375554,335,203970,902,177360,14.0,32956,12.0,34701,68.0,8734,719,153712,83.0,10036,32.0,4878,19,7286
176,6/8/2021,1086,376640,252,204222,858,178218,18.0,32974,5.0,34706,57.0,8791,697,154409,69.0,10105,35.0,4913,4,7290
177,6/9/2021,1080,377720,283,204505,843,179061,15.0,32989,12.0,34718,78.0,8869,646,155055,72.0,10177,47.0,4960,12,7302
178,6/10/2021,1309,379029,333,204838,1013,180074,20.0,33009,4.0,34722,93.0,8962,799,155854,67.0,10244,54.0,5014,10,7312
179,6/11/2021,1112,380141,326,205164,829,180903,19.0,33028,13.0,34735,57.0,9019,650,156504,78.0,10322,44.0,5058,9,7321
180,6/12/2021,1045,381186,289,205453,798,181701,15.0,33043,9.0,34744,73.0,9092,619,157123,63.0,10385,43.0,5101,9,7330
181,6/13/2021,371,381557,98,205551,284,181985,4.0,33047,1.0,34745,37.0,9129,203,157326,25.0,10410,19.0,5120,6,7336
182,6/14/2021,830,382387,282,205833,592,182577,15.0,33062,4.0,34749,44.0,9173,449,157775,42.0,10452,57.0,5177,6,7342
183,6/15/2021,695,383082,238,206071,479,183056,20.0,33082,10.0,34759,40.0,9213,389,158164,34.0,10486,16.0,5193,2,7344
184,6/16/2021,624,383706,204,206275,446,183502,12.0,33094,4.0,34763,38.0,9251,340,158504,33.0,10519,35.0,5228,9,7353
185,6/17/2021,694,384400,251,206526,468,183970,13.0,33107,10.0,34773,41.0,9292,349,158853,49.0,10568,29.0,5257,4,7357
186,6/18/2021,1037,385437,380,206906,687,184657,23.0,33130,11.0,34784,52.0,9344,555,159408,51.0,10619,29.0,5286,7,7364
187,6/19/2021,635,386072,154,207060,496,185153,10.0,33140,6.0,34790,51.0,9395,366,159774,53.0,10672,26.0,5312,9,7373
188,6/20/2021,300,386372,114,207174,192,185345,3.0,33143,2.0,34792,36.0,9431,119,159893,15.0,10687,22.0,5334,5,7378
189,6/21/2021,516,386888,214,207388,328,185673,5.0,33148,8.0,34800,29.0,9460,243,160136,35.0,10722,21.0,5355,8,7386
190,6/22/2021,608,387496,250,207638,388,186061,12.0,33160,7.0,34807,31.0,9491,303,160439,25.0,10747,29.0,5384,5,7391
191,6/23/2021,511,388007,186,207824,352,186413,7.0,33167,10.0,34817,38.0,9529,255,160694,37.0,10784,22.0,5406,11,7402
192,6/24/2021,518,388525,210,208034,332,186745,12.0,33179,9.0,34826,30.0,9559,258,160952,23.0,10807,21.0,5427,1,7403
193,6/25/2021,687,389212,273,208307,436,187181,12.0,33191,8.0,34834,42.0,9601,323,161275,43.0,10850,28.0,5455,5,7408
194,6/26/2021,597,389809,166,208473,440,187621,9.0,33200,9.0,34843,77.0,9678,288,161563,43.0,10893,32.0,5487,4,7412
195,6/27/2021,183,389992,71,208544,113,187734,2.0,33202,3.0,34846,9.0,9687,82,161645,12.0,10905,10.0,5497,2,7414
196,6/28/2021,487,390479,209,208753,284,188018,7.0,33209,6.0,34852,39.0,9726,205,161850,24.0,10929,16.0,5513,2,7416
197,6/29/2021,559,391038,253,209006,327,188345,16.0,33225,11.0,34863,42.0,9768,237,162087,22.0,10951,26.0,5539,11,7427
198,6/30/2021,412,391450,207,209213,219,188564,8.0,33233,11.0,34874,19.0,9787,164,162251,16.0,10967,20.0,5559,12,7439
199,7/1/2021,485,391935,208,209421,295,188859,8.0,33241,7.0,34881,21.0,9808,221,162472,33.0,11000,20.0,5579,4,7443
200,7/2/2021,570,392505,274,209695,307,189166,5.0,33246,7.0,34888,26.0,9834,242,162714,23.0,11023,16.0,5595,3,7446
201,7/3/2021,308,392813,120,209815,195,189361,4.0,33250,3.0,34891,29.0,9863,126,162840,21.0,11044,19.0,5614,5,7451
202,7/4/2021,53,392866,18,209833,35,189396,1.0,33251,0.0,34891,4.0,9867,22,162862,1.0,11045,8.0,5622,0,7451
203,7/5/2021,317,393183,140,209973,175,189571,3.0,33254,1.0,34892,18.0,9885,121,162983,26.0,11071,10.0,5632,4,7455
204,7/6/2021,450,393633,188,210161,271,189842,4.0,33258,5.0,34897,45.0,9930,192,163175,19.0,11090,15.0,5647,1,7456
205,7/7/2021,371,394004,210,210371,175,190017,7.0,33265,6.0,34903,19.0,9949,129,163304,12.0,11102,15.0,5662,4,7460
206,7/8/2021,426,394430,201,210572,246,190263,10.0,33275,8.0,34911,23.0,9972,177,163481,23.0,11125,23.0,5685,3,7463
207,7/9/2021,482,394912,195,210767,293,190556,9.0,33284,2.0,34913,36.0,10008,215,163696,24.0,11149,18.0,5703,6,7469
208,7/10/2021,259,395171,147,210914,127,190683,5.0,33289,2.0,34915,5.0,10013,105,163801,10.0,11159,7.0,5710,2,7471
209,7/11/2021,223,395394,119,211033,122,190805,6.0,33295,6.0,34921,11.0,10024,88,163889,10.0,11169,13.0,5723,7,7478
210,7/12/2021,385,395779,202,211235,196,191001,7.0,33302,4.0,34925,25.0,10049,130,164019,24.0,11193,17.0,5740,4,7482
211,7/13/2021,437,396216,225,211460,225,191226,16.0,33318,10.0,34935,27.0,10076,175,164194,12.0,11205,11.0,5751,5,7487
212,7/14/2021,282,396498,149,211609,156,191382,8.0,33326,5.0,34940,20.0,10096,112,164306,9.0,11214,15.0,5766,7,7494
213,7/15/2021,360,396858,189,211798,182,191564,1.0,33327,4.0,34944,15.0,10111,137,164443,13.0,11227,17.0,5783,3,7497
214,7/16/2021,510,397368,244,212042,276,191840,8.0,33335,9.0,34953,24.0,10135,210,164653,22.0,11249,20.0,5803,5,7502
215,7/17/2021,277,397645,158,212200,129,191969,11.0,33346,5.0,34958,11.0,10146,97,164750,10.0,11259,11.0,5814,6,7508
216,7/18/2021,195,397840,118,212318,89,192058,4.0,33350,3.0,34961,13.0,10159,63,164813,6.0,11265,7.0,5821,4,7512
217,7/19/2021,405,398245,205,212523,206,192264,8.0,33358,8.0,34969,26.0,10185,150,164963,17.0,11282,13.0,5834,4,7516
218,7/20/2021,415,398660,208,212731,215,192479,6.0,33364,8.0,34977,12.0,10197,166,165129,23.0,11305,14.0,5848,5,7521
219,7/21/2021,335,398995,183,212914,172,192651,13.0,33377,14.0,34991,12.0,10209,129,165258,14.0,11319,17.0,5865,3,7524
220,7/22/2021,394,399389,234,213148,168,192819,7.0,33384,19.0,35010,18.0,10227,124,165382,18.0,11337,8.0,5873,6,7530
221,7/23/2021,550,399939,316,213464,237,193056,6.0,33390,10.0,35020,36.0,10263,162,165544,20.0,11357,19.0,5892,3,7533
222,7/24/2021,352,400291,215,213679,156,193212,8.0,33398,10.0,35030,19.0,10282,114,165658,9.0,11366,14.0,5906,5,7538
223,7/25/2021,199,400490,144,213823,63,193275,0.0,33398,4.0,35034,7.0,10289,45,165703,5.0,11371,6.0,5912,4,7542
224,7/26/2021,345,400835,199,214022,144,193419,1.0,33399,7.0,35041,11.0,10300,98,165801,18.0,11389,17.0,5929,4,7546
225,7/27/2021,423,401258,237,214259,174,193593,5.0,33404,16.0,35057,21.0,10321,122,165923,18.0,11407,13.0,5942,15,7561
226,7/28/2021,468,401726,284,214543,222,193815,3.0,33407,10.0,35067,28.0,10349,144,166067,17.0,11424,33.0,5975,5,7566
227,7/29/2021,512,402238,306,214849,236,194051,8.0,33415,6.0,35073,24.0,10373,180,166247,13.0,11437,19.0,5994,9,7575
228,7/30/2021,684,402922,475,215324,247,194298,10.0,33425,14.0,35087,25.0,10398,187,166434,16.0,11453,19.0,6013,5,7580
229,7/31/2021,334,403256,202,215526,136,194434,4.0,33429,1.0,35088,15.0,10413,107,166541,9.0,11462,5.0,6018,5,7585
230,8/1/2021,267,403523,170,215696,105,194539,0.0,33429,2.0,35090,15.0,10428,66,166607,8.0,11470,16.0,6034,8,7593
231,8/2/2021,445,403968,297,215993,172,194711,4.0,33433,13.0,35103,20.0,10448,119,166726,20.0,11490,13.0,6047,6,7599
232,8/3/2021,561,404529,347,216340,240,194951,6.0,33439,13.0,35116,37.0,10485,162,166888,15.0,11505,26.0,6073,4,7603
233,8/4/2021,390,404919,273,216613,138,195089,3.0,33442,14.0,35130,10.0,10495,105,166993,5.0,11510,18.0,6091,10,7613
234,8/5/2021,445,405364,287,216900,169,195258,5.0,33447,11.0,35141,19.0,10514,122,167115,17.0,11527,11.0,6102,4,7617
235,8/6/2021,678,406042,459,217359,265,195523,12.0,33459,16.0,35157,22.0,10536,201,167316,22.0,11549,20.0,6122,4,7621
236,8/7/2021,439,406481,305,217664,157,195680,4.0,33463,10.0,35167,12.0,10548,124,167440,5.0,11554,16.0,6138,5,7626
237,8/8/2021,217,406698,126,217790,98,195778,3.0,33466,5.0,35172,8.0,10556,72,167512,6.0,11560,12.0,6150,5,7631
238,8/9/2021,465,407163,281,218071,214,195992,4.0,33470,6.0,35178,22.0,10578,159,167671,11.0,11571,22.0,6172,8,7639
239,8/10/2021,503,407666,301,218372,227,196219,6.0,33476,14.0,35192,25.0,10603,179,167850,10.0,11581,13.0,6185,8,7647
240,8/11/2021,418,408084,265,218637,175,196394,11.0,33487,5.0,35197,16.0,10619,133,167983,14.0,11595,12.0,6197,4,7651
241,8/12/2021,541,408625,319,218956,258,196652,7.0,33494,13.0,35210,31.0,10650,181,168164,23.0,11618,23.0,6220,7,7658
242,8/13/2021,659,409284,380,219336,297,196949,11.0,33505,9.0,35219,31.0,10681,216,168380,19.0,11637,31.0,6251,6,7664
243,8/14/2021,503,409787,257,219593,249,197198,7.0,33512,9.0,35228,10.0,10691,213,168593,9.0,11646,17.0,6268,46,7710
244,8/15/2021,263,410050,128,219721,124,197322,2.0,33514,3.0,35231,11.0,10702,90,168683,6.0,11652,17.0,6285,18,7728
245,8/16/2021,539,410589,310,220031,168,197490,4.0,33518,11.0,35242,15.0,10717,128,168811,13.0,11665,12.0,6297,76,7804
246,8/17/2021,483,411072,228,220259,194,197684,20.0,33538,10.0,35252,17.0,10734,147,168958,10.0,11675,20.0,6317,79,7883
247,8/18/2021,591,411663,323,220582,255,197939,5.0,33543,15.0,35267,30.0,10764,172,169130,13.0,11688,40.0,6357,72,7955
248,8/19/2021,567,412230,278,220860,256,198195,7.0,33550,9.0,35276,21.0,10785,206,169336,17.0,11705,12.0,6369,74,8029
249,8/20/2021,841,413071,340,221200,451,198646,15.0,33565,11.0,35287,44.0,10829,358,169694,29.0,11734,20.0,6389,84,8113
250,8/21/2021,646,413717,211,221411,209,198855,4.0,33569,7.0,35294,14.0,10843,171,169865,13.0,11747,11.0,6400,192,8305
251,8/22/2021,316,414033,150,221561,142,198997,1.0,33570,2.0,35296,19.0,10862,100,169965,9.0,11756,14.0,6414,31,8336
252,8/23/2021,527,414560,262,221823,222,199219,10.0,33580,9.0,35305,19.0,10881,168,170133,12.0,11768,23.0,6437,60,8396
253,8/24/2021,569,415129,272,222095,276,199495,10.0,33590,8.0,35313,27.0,10908,216,170349,15.0,11783,18.0,6455,56,8452
254,8/25/2021,593,415722,320,222415,258,199753,12.0,33602,13.0,35326,19.0,10927,197,170546,9.0,11792,33.0,6488,47,8499
255,8/26/2021,534,416256,262,222677,252,200005,9.0,33611,14.0,35340,18.0,10945,194,170740,23.0,11815,17.0,6505,43,8542
256,8/27/2021,887,417143,351,223028,403,200408,15.0,33626,11.0,35351,38.0,10983,298,171038,22.0,11837,45.0,6550,152,8694
257,8/28/2021,1465,418608,202,223230,249,200657,7.0,33633,5.0,35356,23.0,11006,184,171222,14.0,11851,28.0,6578,987,9681
258,8/29/2021,1081,419689,161,223391,136,200793,4.0,33637,4.0,35360,8.0,11014,111,171333,12.0,11863,5.0,6583,771,10452
259,8/30/2021,616,420305,271,223662,281,201074,9.0,33646,13.0,35373,24.0,11038,216,171549,9.0,11872,32.0,6615,93,10545
260,8/31/2021,811,421116,235,223897,237,201311,7.0,33653,12.0,35385,18.0,11056,188,171737,18.0,11890,13.0,6628,341,10886
261,9/1/2021,950,422066,248,224145,221,201532,12.0,33665,15.0,35400,21.0,11077,168,171905,13.0,11903,19.0,6647,486,11372
262,9/2/2021,829,422895,184,224329,205,201737,13.0,33678,14.0,35414,18.0,11095,153,172058,16.0,11919,18.0,6665,459,11831
263,9/3/2021,855,423750,340,224669,372,202109,13.0,33691,12.0,35426,44.0,11139,272,172330,21.0,11940,35.0,6700,163,11994
264,9/4/2021,375,424125,163,224832,164,202273,6.0,33697,8.0,35434,13.0,11152,127,172457,11.0,11951,13.0,6713,57,12051
265,9/5/2021,251,424376,131,224963,108,202381,2.0,33699,4.0,35438,12.0,11164,77,172534,9.0,11960,10.0,6723,21,12072
266,9/6/2021,113,424489,47,225010,59,202440,1.0,33700,0.0,35438,4.0,11168,43,172577,8.0,11968,4.0,6727,12,12084
267,9/7/2021,952,425441,199,225209,272,202712,19.0,33719,12.0,35450,22.0,11190,208,172785,17.0,11985,25.0,6752,485,12569
268,9/8/2021,789,426230,219,225428,224,202936,11.0,33730,12.0,35462,24.0,11214,166,172951,10.0,11995,24.0,6776,370,12939
269,9/9/2021,401,426631,175,225603,193,203129,9.0,33739,8.0,35470,21.0,11235,141,173092,14.0,12009,17.0,6793,54,12993
270,9/10/2021,753,427384,340,225943,307,203436,9.0,33748,23.0,35493,28.0,11263,231,173323,20.0,12029,28.0,6821,146,13139
271,9/11/2021,1634,429018,162,226105,210,203646,10.0,33758,19.0,35512,18.0,11281,160,173483,15.0,12044,17.0,6838,1267,14406
272,9/12/2021,232,429250,100,226205,114,203760,1.0,33759,2.0,35514,11.0,11292,74,173557,10.0,12054,19.0,6857,16,14422
273,9/13/2021,492,429742,220,226425,245,204005,9.0,33768,8.0,35522,24.0,11316,184,173741,12.0,12066,25.0,6882,45,14467
274,9/14/2021,845,430587,205,226630,275,204280,14.0,33782,16.0,35538,17.0,11333,221,173962,14.0,12080,23.0,6905,400,14867
275,9/15/2021,830,431417,190,226820,266,204546,15.0,33797,15.0,35553,21.0,11354,196,174158,17.0,12097,32.0,6937,398,15265
276,9/16/2021,355,431772,134,226954,193,204739,9.0,33806,8.0,35561,32.0,11386,138,174296,11.0,12108,12.0,6949,43,15308
277,9/17/2021,746,432518,284,227238,387,205126,13.0,33819,13.0,35574,29.0,11415,289,174585,38.0,12146,31.0,6980,123,15431
278,9/18/2021,1838,434356,128,227366,171,205297,5.0,33824,20.0,35594,10.0,11425,126,174711,15.0,12161,20.0,7000,1542,16973
279,9/19/2021,181,434537,74,227440,106,205403,3.0,33827,2.0,35596,6.0,11431,82,174793,5.0,12166,13.0,7013,11,16984
280,9/20/2021,385,434922,144,227584,216,205619,8.0,33835,9.0,35605,27.0,11458,160,174953,10.0,12176,19.0,7032,55,17039
281,9/21/2021,771,435693,166,227750,199,205818,9.0,33844,14.0,35619,21.0,11479,153,175106,8.0,12184,17.0,7049,420,17459
282,9/22/2021,718,436411,164,227914,230,206048,6.0,33850,12.0,35631,15.0,11494,181,175287,16.0,12200,18.0,7067,362,17821
283,9/23/2021,348,436759,144,228058,179,206227,8.0,33858,3.0,35634,9.0,11503,132,175419,13.0,12213,25.0,7092,47,17868
284,9/24/2021,696,437455,208,228266,275,206502,16.0,33874,16.0,35650,20.0,11523,218,175637,11.0,12224,26.0,7118,232,18100
285,9/25/2021,1734,439189,136,228402,176,206678,11.0,33885,21.0,35671,15.0,11538,137,175774,12.0,12236,12.0,7130,1428,19528
286,9/26/2021,263,439452,65,228467,87,206765,3.0,33888,3.0,35674,11.0,11549,65,175839,4.0,12240,7.0,7137,110,19638
287,9/27/2021,566,440018,156,228623,124,206889,7.0,33895,11.0,35685,7.0,11556,96,175935,8.0,12248,13.0,7150,302,19940
288,9/28/2021,1128,441146,157,228780,202,207091,19.0,33914,23.0,35708,15.0,11571,153,176088,9.0,12257,25.0,7175,790,20730
289,9/29/2021,1143,442289,174,228954,171,207262,12.0,33926,19.0,35727,15.0,11586,127,176215,7.0,12264,22.0,7197,812,21542
290,9/30/2021,706,442995,161,229115,166,207428,15.0,33941,7.0,35734,11.0,11597,127,176342,10.0,12274,18.0,7215,409,21951
291,10/1/2021,1062,444057,175,229290,301,207729,20.0,33961,15.0,35749,20.0,11617,238,176580,21.0,12295,22.0,7237,601,22552
292,10/2/2021,1815,445872,118,229408,115,207844,12.0,33973,14.0,35763,9.0,11626,96,176676,5.0,12300,5.0,7242,1588,24140
293,10/3/2021,392,446264,64,229472,113,207957,1.0,33974,2.0,35765,18.0,11644,77,176753,7.0,12307,11.0,7253,227,24367
294,10/4/2021,794,447058,113,229585,156,208113,7.0,33981,12.0,35777,27.0,11671,102,176855,14.0,12321,13.0,7266,532,24899
295,10/5/2021,1118,448176,137,229722,135,208248,12.0,33993,17.0,35794,13.0,11684,103,176958,5.0,12326,14.0,7280,857,25756
296,10/6/2021,997,449173,106,229828,155,208403,8.0,34001,14.0,35808,11.0,11695,122,177080,5.0,12331,17.0,7297,753,26509
297,10/7/2021,784,449957,132,229960,107,208510,8.0,34009,14.0,35822,8.0,11703,83,177163,5.0,12336,11.0,7308,566,27075
298,10/8/2021,1037,450994,157,230117,239,208749,19.0,34028,11.0,35833,20.0,11723,186,177349,11.0,12347,22.0,7330,652,27727
299,10/9/2021,1676,452670,108,230225,131,208880,11.0,34039,8.0,35841,22.0,11745,98,177447,3.0,12350,8.0,7338,1439,29166
300,10/10/2021,243,452913,50,230275,63,208943,2.0,34041,2.0,35843,4.0,11749,49,177496,5.0,12355,5.0,7343,131,29297
301,10/11/2021,821,453734,123,230398,136,209079,17.0,34058,18.0,35861,3.0,11752,112,177608,10.0,12365,11.0,7354,573,29870
302,10/12/2021,1023,454757,118,230516,133,209212,8.0,34066,20.0,35881,16.0,11768,104,177712,4.0,12369,9.0,7363,782,30652
303,10/13/2021,971,455728,116,230632,150,209362,16.0,34082,8.0,35889,16.0,11784,114,177826,12.0,12381,8.0,7371,723,31375
304,10/14/2021,711,456439,100,230732,127,209489,14.0,34096,9.0,35898,20.0,11804,94,177920,8.0,12389,5.0,7376,491,31866
305,10/15/2021,1028,457467,177,230909,215,209704,11.0,34107,7.0,35905,15.0,11819,169,178089,13.0,12402,18.0,7394,671,32537
306,10/16/2021,803,458270,66,230975,80,209784,4.0,34111,3.0,35908,6.0,11825,69,178158,2.0,12404,3.0,7397,657,33194
307,10/17/2021,196,458466,48,231023,63,209847,1.0,34112,2.0,35910,4.0,11829,47,178205,3.0,12407,9.0,7406,83,33277
308,10/18/2021,652,459118,119,231142,135,209982,10.0,34122,4.0,35914,13.0,11842,106,178311,6.0,12413,10.0,7416,413,33690
309,10/19/2021,1049,460167,120,231262,134,210116,4.0,34126,11.0,35925,8.0,11850,108,178419,8.0,12421,10.0,7426,805,34495
310,10/20/2021,894,461061,122,231384,121,210237,6.0,34132,12.0,35937,9.0,11859,91,178510,7.0,12428,14.0,7440,665,35160
311,10/21/2021,534,461595,107,231491,127,210364,9.0,34141,8.0,35945,14.0,11873,85,178595,11.0,12439,17.0,7457,321,35481
312,10/22/2021,1477,463072,195,231686,230,210594,9.0,34150,13.0,35958,20.0,11893,171,178766,14.0,12453,25.0,7482,1072,36553
313,10/23/2021,1880,464952,88,231774,195,210789,14.0,34164,15.0,35973,4.0,11897,170,178936,11.0,12464,10.0,7492,1600,38153
314,10/24/2021,569,465521,81,231855,152,210941,8.0,34172,11.0,35984,12.0,11909,128,179064,7.0,12471,5.0,7497,349,38502
315,10/25/2021,1384,466905,136,231991,297,211238,27.0,34199,17.0,36001,12.0,11921,252,179316,21.0,12492,12.0,7509,964,39466
316,10/26/2021,2143,469048,177,232168,299,211537,14.0,34213,17.0,36018,19.0,11940,248,179564,18.0,12510,14.0,7523,1677,41143
317,10/27/2021,1973,471021,153,232321,274,211811,19.0,34232,19.0,36037,9.0,11949,242,179806,14.0,12524,9.0,7532,1554,42697
318,10/28/2021,1711,472732,138,232459,260,212071,11.0,34243,20.0,36057,11.0,11960,219,180025,17.0,12541,13.0,7545,1324,44021
319,10/29/2021,1657,474389,179,232638,278,212349,12.0,34255,15.0,36072,10.0,11970,243,180268,12.0,12553,13.0,7558,1211,45232
320,10/30/2021,1586,475975,79,232717,150,212499,13.0,34268,8.0,36080,6.0,11976,129,180397,9.0,12562,6.0,7564,1366,46598
321,10/31/2021,463,476438,48,232765,74,212573,2.0,34270,6.0,36086,6.0,11982,62,180459,4.0,12566,2.0,7566,340,46938
322,11/1/2021,1240,477678,137,232902,217,212790,10.0,34280,10.0,36096,10.0,11992,177,180636,12.0,12578,18.0,7584,894,47832
323,11/2/2021,1818,479496,130,233032,200,212990,8.0,34288,17.0,36113,14.0,12006,162,180798,13.0,12591,11.0,7595,1503,49335
324,11/3/2021,1743,481239,159,233191,229,213219,12.0,34300,17.0,36130,15.0,12021,181,180979,16.0,12607,17.0,7612,1370,50705
325,11/4/2021,1409,482648,145,233336,182,213401,4.0,34304,13.0,36143,1.0,12022,158,181137,12.0,12619,11.0,7623,1106,51811
326,11/5/2021,2015,484663,226,233562,299,213700,14.0,34318,12.0,36155,17.0,12039,250,181387,14.0,12633,18.0,7641,1522,53333
327,11/6/2021,1578,486241,215,233777,142,213842,4.0,34322,7.0,36162,6.0,12045,115,181502,15.0,12648,6.0,7647,1229,54562
328,11/7/2021,522,486763,118,233895,77,213919,1.0,34323,8.0,36170,5.0,12050,63,181565,3.0,12651,6.0,7653,327,54889
329,11/8/2021,1525,488288,385,234280,198,214117,7.0,34330,9.0,36179,11.0,12061,164,181729,9.0,12660,14.0,7667,963,55852
330,11/9/2021,2632,490920,943,235223,221,214338,10.0,34340,21.0,36200,15.0,12076,163,181892,16.0,12676,27.0,7694,1488,57340
331,11/10/2021,2486,493406,822,236045,223,214561,11.0,34351,17.0,36217,12.0,12088,176,182068,22.0,12698,13.0,7707,1465,58805
332,11/11/2021,2348,495754,966,237011,188,214749,17.0,34368,8.0,36225,13.0,12101,154,182222,13.0,12711,8.0,7715,1214,60019
333,11/12/2021,2553,498307,754,237765,240,214989,12.0,34380,19.0,36244,23.0,12124,191,182413,13.0,12724,13.0,7728,1570,61589
334,11/13/2021,1926,500233,405,238170,140,215129,4.0,34384,12.0,36256,7.0,12131,104,182517,15.0,12739,14.0,7742,1391,62980
335,11/14/2021,1481,501714,911,239081,107,215236,1.0,34385,2.0,36258,11.0,12142,72,182589,14.0,12753,10.0,7752,472,63452
336,11/15/2021,1953,503667,452,239533,199,215435,7.0,34392,11.0,36269,12.0,12154,159,182748,12.0,12765,16.0,7768,1323,64775
337,11/16/2021,2397,506064,454,239987,212,215647,5.0,34397,21.0,36290,26.0,12180,155,182903,17.0,12782,14.0,7782,1743,66518
338,11/17/2021,2721,508785,633,240620,268,215915,12.0,34409,16.0,36306,16.0,12196,221,183124,17.0,12799,14.0,7796,1851,68369
339,11/18/2021,1886,510671,377,240997,177,216092,7.0,34416,11.0,36317,15.0,12211,142,183266,15.0,12814,5.0,7801,1347,69716
340,11/19/2021,2560,513231,715,241712,280,216372,13.0,34429,14.0,36331,9.0,12220,234,183500,20.0,12834,17.0,7818,1585,71301
341,11/20/2021,1876,515107,531,242243,112,216484,6.0,34435,5.0,36336,8.0,12228,95,183595,4.0,12838,5.0,7823,1236,72537
342,11/21/2021,639,515746,124,242367,85,216569,0.0,34435,1.0,36337,3.0,12231,69,183664,8.0,12846,5.0,7828,433,72970
343,11/22/2021,1971,517717,427,242794,208,216777,11.0,34446,21.0,36358,10.0,12241,169,183833,11.0,12857,18.0,7846,1356,74326
344,11/23/2021,1836,519553,289,243083,184,216961,8.0,34454,15.0,36373,15.0,12256,148,183981,14.0,12871,7.0,7853,1372,75698
345,11/24/2021,1509,521062,215,243298,163,217124,6.0,34460,11.0,36384,14.0,12270,131,184112,12.0,12883,6.0,7859,1145,76843
346,11/25/2021,46,521108,9,243307,2,217126,0.0,34460,0.0,36384,0.0,12270,1,184113,1.0,12884,,7859,35,76878
347,11/26/2021,1256,522364,190,243497,202,217328,3.0,34463,4.0,36388,17.0,12287,163,184276,12.0,12896,10.0,7869,883,77761
348,11/27/2021,949,523313,137,243634,152,217480,2.0,34465,2.0,36390,7.0,12294,130,184406,8.0,12904,7.0,7876,662,78423
349,11/28/2021,539,523852,96,243730,104,217584,2.0,34467,2.0,36392,9.0,12303,83,184489,5.0,12909,7.0,7883,345,78768
350,11/29/2021,1841,525693,275,244005,408,217992,8.0,34475,13.0,36405,29.0,12332,339,184828,25.0,12934,15.0,7898,1179,79947
351,11/30/2021,2657,528350,338,244343,787,218779,8.0,34483,11.0,36416,51.0,12383,663,185491,61.0,12995,12.0,7910,1552,81499
352,12/1/2021,2431,530781,263,244606,746,219525,13.0,34496,11.0,36427,30.0,12413,656,186147,56.0,13051,4.0,7914,1433,82932
353,12/2/2021,2804,533585,351,244957,911,220436,9.0,34505,15.0,36442,69.0,12482,740,186887,73.0,13124,29.0,7943,1569,84501
354,12/3/2021,2586,536171,287,245244,755,221191,11.0,34516,4.0,36446,61.0,12543,596,187483,69.0,13193,29.0,7972,1564,86065
355,12/4/2021,2181,538352,161,245405,420,221611,4.0,34520,1.0,36447,24.0,12567,329,187812,36.0,13229,31.0,8003,1607,87672
356,12/5/2021,1377,539729,104,245509,840,222451,1.0,34521,0.0,36447,67.0,12634,667,188479,69.0,13298,37.0,8040,442,88114
357,12/6/2021,1916,541645,234,245743,466,222917,7.0,34528,5.0,36452,54.0,12688,363,188842,33.0,13331,16.0,8056,1228,89342
358,12/7/2021,2446,544091,307,246050,468,223385,10.0,34538,9.0,36461,49.0,12737,372,189214,31.0,13362,16.0,8072,1690,91032
359,12/8/2021,2229,546320,270,246320,512,223897,9.0,34547,12.0,36473,29.0,12766,429,189643,40.0,13402,14.0,8086,1469,92501
360,12/9/2021,2143,548463,303,246623,459,224356,6.0,34553,8.0,36481,27.0,12793,356,189999,43.0,13445,33.0,8119,1395,93896
361,12/10/2021,2085,550548,241,246864,403,224759,10.0,34563,9.0,36490,38.0,12831,313,190312,32.0,13477,20.0,8139,1451,95347
362,12/11/2021,1779,552327,136,247000,492,225251,6.0,34569,1.0,36491,59.0,12890,366,190678,41.0,13518,26.0,8165,1153,96500
363,12/12/2021,415,552742,55,247055,88,225339,1.0,34570,3.0,36494,4.0,12894,71,190749,7.0,13525,6.0,8171,275,96775
364,12/13/2021,1749,554491,298,247353,392,225731,9.0,34579,9.0,36503,26.0,12920,318,191067,35.0,13560,13.0,8184,1077,97852
365,12/14/2021,2176,556667,276,247629,365,226096,7.0,34586,5.0,36508,33.0,12953,299,191366,16.0,13576,17.0,8201,1560,99412
366,12/15/2021,1735,558402,202,247831,228,226324,6.0,34592,4.0,36512,9.0,12962,185,191551,19.0,13595,15.0,8216,1318,100730
367,12/16/2021,1765,560167,314,248145,246,226570,7.0,34599,8.0,36520,15.0,12977,207,191758,15.0,13610,9.0,8225,1223,101953
368,12/17/2021,2110,562277,308,248453,441,227011,6.0,34605,10.0,36530,28.0,13005,363,192121,39.0,13649,11.0,8236,1372,103325
369,12/18/2021,1800,564077,179,248632,240,227251,4.0,34609,4.0,36534,17.0,13022,205,192326,10.0,13659,8.0,8244,1382,104707
370,12/19/2021,438,564515,44,248676,80,227331,1.0,34610,3.0,36537,5.0,13027,66,192392,3.0,13662,6.0,8250,314,105021
371,12/20/2021,1549,566064,197,248873,242,227573,10.0,34620,9.0,36546,27.0,13054,192,192584,16.0,13678,7.0,8257,1115,106136
372,12/21/2021,2185,568249,309,249182,294,227867,10.0,34630,8.0,36554,28.0,13082,228,192812,25.0,13703,13.0,8270,1590,107726
373,12/22/2021,1871,570120,219,249401,285,228152,4.0,34634,9.0,36563,28.0,13110,227,193039,22.0,13725,8.0,8278,1370,109096
374,12/23/2021,1235,571355,217,249618,206,228358,5.0,34639,4.0,36567,23.0,13133,156,193195,16.0,13741,11.0,8289,825,109921
375,12/24/2021,320,571675,45,249663,63,228421,3.0,34642,2.0,36569,4.0,13137,54,193249,4.0,13745,1.0,8290,214,110135
376,12/25/2021,14,571689,3,249666,2,228423,0.0,34642,0.0,36569,,13137,1,193250,1.0,13746,,8290,9,110144
377,12/26/2021,356,572045,60,249726,68,228491,1.0,34643,0.0,36569,7.0,13144,53,193303,5.0,13751,3.0,8293,230,110374
378,12/27/2021,1250,573295,175,249901,221,228712,4.0,34647,5.0,36574,18.0,13162,175,193478,20.0,13771,8.0,8301,861,111235
379,12/28/2021,1890,575185,269,250170,295,229007,12.0,34659,12.0,36586,35.0,13197,230,193708,16.0,13787,14.0,8315,1330,112565
380,12/29/2021,1695,576880,212,250382,251,229258,5.0,34664,6.0,36592,27.0,13224,191,193899,22.0,13809,11.0,8326,1243,113808
381,12/30/2021,1365,578245,223,250605,240,229498,7.0,34671,9.0,36601,26.0,13250,187,194086,15.0,13824,12.0,8338,912,114720
382,12/31/2021,501,578746,97,250702,92,229590,0.0,34671,2.0,36603,7.0,13257,75,194161,5.0,13829,5.0,8343,315,115035
383,1/1/2022,93,578839,12,250714,16,229606,1.0,34672,1.0,36604,0.0,13257,13,194174,2.0,13831,1.0,8344,65,115100
384,1/2/2022,315,579154,45,250759,59,229665,1.0,34673,1.0,36605,7.0,13264,41,194215,8.0,13839,3.0,8347,212,115312
385,1/3/2022,1595,580749,330,251089,345,230010,4.0,34677,5.0,36610,34.0,13298,281,194496,20.0,13859,10.0,8357,930,116242
386,1/4/2022,1671,582420,263,251352,275,230285,10.0,34687,7.0,36617,30.0,13328,217,194713,17.0,13876,11.0,8368,1146,117388
387,1/5/2022,1330,583750,205,251557,200,230485,7.0,34694,8.0,36625,13.0,13341,163,194876,9.0,13885,15.0,8383,938,118326
388,1/6/2022,1226,584976,253,251810,232,230717,4.0,34698,4.0,36629,24.0,13365,173,195049,13.0,13898,22.0,8405,750,119076
389,1/7/2022,2054,587030,253,252063,340,231057,6.0,34704,9.0,36638,35.0,13400,262,195311,30.0,13928,13.0,8418,1473,120549
390,1/8/2022,1573,588603,125,252188,130,231187,0.0,34704,3.0,36641,7.0,13407,109,195420,7.0,13935,7.0,8425,1322,121871
391,1/9/2022,499,589102,92,252280,72,231259,0.0,34704,2.0,36643,14.0,13421,49,195469,3.0,13938,6.0,8431,336,122207
392,1/10/2022,1552,590654,287,252567,250,231509,3.0,34707,6.0,36649,19.0,13440,193,195662,27.0,13965,11.0,8442,1026,123233
393,1/11/2022,1559,592213,219,252786,274,231783,3.0,34710,4.0,36653,31.0,13471,209,195871,15.0,13980,19.0,8461,1078,124311
394,1/12/2022,1401,593614,178,252964,185,231968,6.0,34716,5.0,36658,29.0,13500,126,195997,20.0,14000,10.0,8471,1050,125361
395,1/13/2022,1097,594711,191,253155,177,232145,3.0,34719,2.0,36660,14.0,13514,131,196128,18.0,14018,14.0,8485,738,126099
396,1/14/2022,1617,596328,279,253434,214,232359,2.0,34721,9.0,36669,25.0,13539,156,196284,20.0,14038,13.0,8498,1139,127238
397,1/15/2022,1216,597544,137,253571,102,232461,1.0,34722,3.0,36672,11.0,13550,80,196364,9.0,14047,2.0,8500,978,128216
398,1/16/2022,290,597834,47,253618,35,232496,1.0,34723,0.0,36672,1.0,13551,31,196395,3.0,14050,0.0,8500,208,128424
399,1/17/2022,774,598608,160,253778,127,232623,4.0,34727,5.0,36677,12.0,13563,105,196500,8.0,14058,2.0,8502,489,128913
400,1/18/2022,886,599494,164,253942,165,232788,2.0,34729,6.0,36683,25.0,13588,126,196626,6.0,14064,8.0,8510,564,129477
401,1/19/2022,720,600214,121,254063,117,232905,4.0,34733,7.0,36690,9.0,13597,86,196712,10.0,14074,12.0,8522,494,129971
402,1/20/2022,779,600993,145,254208,147,233052,0.0,34733,10.0,36700,17.0,13614,111,196823,10.0,14084,9.0,8531,494,130465
403,1/21/2022,1174,602167,166,254374,171,233223,7.0,34740,2.0,36702,15.0,13629,132,196955,12.0,14096,12.0,8543,846,131311
404,1/22/2022,781,602948,87,254461,103,233326,0.0,34740,1.0,36703,14.0,13643,74,197029,6.0,14102,9.0,8552,593,131904
405,1/23/2022,210,603158,24,254485,53,233379,1.0,34741,0.0,36703,5.0,13648,41,197070,7.0,14109,0.0,8552,133,132037
406,1/24/2022,488,603646,75,254560,107,233486,1.0,34742,1.0,36704,14.0,13662,78,197148,8.0,14117,7.0,8559,309,132346
407,1/25/2022,661,604307,116,254676,142,233628,3.0,34745,2.0,36706,15.0,13677,100,197248,20.0,14137,7.0,8566,404,132750
408,1/26/2022,642,604949,100,254776,139,233767,8.0,34753,2.0,36708,12.0,13689,106,197354,13.0,14150,8.0,8574,412,133162
409,1/27/2022,615,605564,114,254890,170,233937,5.0,34758,1.0,36709,29.0,13718,125,197479,10.0,14160,6.0,8580,337,133499
410,1/28/2022,966,606530,163,255053,169,234106,6.0,34764,6.0,36715,20.0,13738,119,197598,14.0,14174,16.0,8596,639,134138
411,1/29/2022,558,607088,68,255121,85,234191,1.0,34765,4.0,36719,10.0,13748,62,197660,8.0,14182,5.0,8601,405,134543
412,1/30/2022,191,607279,33,255154,43,234234,1.0,34766,1.0,36720,13.0,13761,26,197686,1.0,14183,3.0,8604,117,134660
413,1/31/2022,555,607834,136,255290,120,234354,2.0,34768,2.0,36722,17.0,13778,79,197765,13.0,14196,11.0,8615,303,134963
414,2/1/2022,548,608382,99,255389,137,234491,0.0,34768,4.0,36726,19.0,13797,102,197867,11.0,14207,5.0,8620,314,135277
415,2/2/2022,127,608509,18,255407,45,234536,0.0,34768,1.0,36727,2.0,13799,41,197908,1.0,14208,1.0,8621,67,135344
416,2/3/2022,367,608876,75,255482,115,234651,1.0,34769,3.0,36730,24.0,13823,79,197987,6.0,14214,6.0,8627,182,135526
417,2/4/2022,641,609517,109,255591,145,234796,6.0,34775,3.0,36733,16.0,13839,114,198101,9.0,14223,6.0,8633,389,135915
418,2/5/2022,456,609973,57,255648,112,234908,2.0,34777,0.0,36733,7.0,13846,90,198191,6.0,14229,9.0,8642,289,136204
419,2/6/2022,123,610096,20,255668,34,234942,0.0,34777,1.0,36734,1.0,13847,23,198214,6.0,14235,4.0,8646,70,136274
420,2/7/2022,362,610458,61,255729,110,235052,0.0,34777,0.0,36734,12.0,13859,85,198299,5.0,14240,8.0,8654,193,136467
421,2/8/2022,440,610898,86,255815,114,235166,0.0,34777,3.0,36737,19.0,13878,83,198382,5.0,14245,7.0,8661,250,136717
422,2/9/2022,350,611248,63,255878,97,235263,3.0,34780,1.0,36738,18.0,13896,64,198446,3.0,14248,12.0,8673,193,136910
423,2/10/2022,367,611615,83,255961,88,235351,1.0,34781,3.0,36741,16.0,13912,59,198505,8.0,14256,5.0,8678,197,137107
424,2/11/2022,526,612141,95,256056,153,235504,3.0,34784,0.0,36741,28.0,13940,106,198611,7.0,14263,12.0,8690,283,137390
425,2/12/2022,247,612388,42,256098,50,235554,0.0,34784,0.0,36741,5.0,13945,38,198649,5.0,14268,2.0,8692,158,137548
426,2/13/2022,53,612441,13,256111,11,235565,0.0,34784,1.0,36742,0.0,13945,6,198655,4.0,14272,1.0,8693,31,137579
