,Date,daily number of doses received by Larimer County residents,total number of doses recevied by residents,daily number of residents receiving first dose,total number of residents receiving first dose,daily number of residents vaccinated,total number of residents vaccinated,daily number of 70+ vaccinated,total number of 70+ vaccinated,daily number of 70+ at least one dose,total number of 70+ at least one dose,daily number of Latinx residents vaccinated,total of Latinx residents vaccinated,daily number of White non-Latinx residents vaccinated,total of White non-Latinx residents vaccinated,daily number of non-White non-Latinx residents vaccinated,total of non-White non-Latinx residents vaccinated,dailyUnknown,totalUnknown,daily_additional_doses,total_additional_doses
0,12/14/2020,32,32,32,32,1,1,0.0,0,1.0,1,0.0,0,1,1,0.0,0,,0,0,0
1,12/15/2020,13,45,13,45,0,1,,0,,1,,0,0,1,0.0,0,,0,0,0
2,12/16/2020,303,348,303,348,0,1,0.0,0,2.0,3,0.0,0,0,1,0.0,0,0.0,0,0,0
3,12/17/2020,989,1337,989,1337,0,1,0.0,0,11.0,14,0.0,0,0,1,0.0,0,0.0,0,0,0
4,12/18/2020,1057,2394,1057,2394,2,3,0.0,0,15.0,29,0.0,0,2,3,0.0,0,0.0,0,0,0
5,12/19/2020,721,3115,721,3115,0,3,0.0,0,14.0,43,0.0,0,0,3,0.0,0,0.0,0,0,0
6,12/20/2020,265,3380,265,3380,0,3,0.0,0,4.0,47,0.0,0,0,3,0.0,0,0.0,0,0,0
7,12/21/2020,356,3736,356,3736,3,6,0.0,0,3.0,50,0.0,0,3,6,0.0,0,0.0,0,0,0
8,12/22/2020,363,4099,363,4099,0,6,0.0,0,7.0,57,0.0,0,0,6,0.0,0,0.0,0,0,0
9,12/23/2020,438,4537,438,4537,0,6,0.0,0,6.0,63,0.0,0,0,6,0.0,0,0.0,0,0,0
10,12/24/2020,106,4643,106,4643,0,6,0.0,0,3.0,66,0.0,0,0,6,0.0,0,0.0,0,0,0
11,12/25/2020,1,4644,1,4644,0,6,,0,,66,,0,0,6,,0,,0,0,0
12,12/26/2020,227,4871,227,4871,1,7,0.0,0,3.0,69,0.0,0,1,7,0.0,0,0.0,0,0,0
13,12/27/2020,278,5149,278,5149,0,7,0.0,0,197.0,266,0.0,0,0,7,0.0,0,,0,0,0
14,12/28/2020,711,5860,711,5860,0,7,0.0,0,386.0,652,0.0,0,0,7,0.0,0,0.0,0,0,0
15,12/29/2020,909,6769,908,6768,1,8,0.0,0,460.0,1112,0.0,0,1,8,0.0,0,0.0,0,0,0
16,12/30/2020,884,7653,884,7652,0,8,0.0,0,273.0,1385,0.0,0,0,8,0.0,0,0.0,0,0,0
17,12/31/2020,894,8547,894,8546,0,8,0.0,0,342.0,1727,0.0,0,0,8,0.0,0,0.0,0,0,0
18,1/1/2021,4,8551,3,8549,1,9,,0,,1727,,0,1,9,,0,,0,0,0
19,1/2/2021,391,8942,391,8940,1,10,0.0,0,141.0,1868,0.0,0,1,10,0.0,0,0.0,0,0,0
20,1/3/2021,124,9066,124,9064,0,10,0.0,0,52.0,1920,0.0,0,0,10,0.0,0,0.0,0,0,0
21,1/4/2021,589,9655,575,9639,13,23,0.0,0,320.0,2240,0.0,0,10,20,2.0,2,1.0,1,0,0
22,1/5/2021,645,10300,636,10275,10,33,0.0,0,409.0,2649,0.0,0,9,29,1.0,3,0.0,1,0,0
23,1/6/2021,1230,11530,912,11187,310,343,4.0,4,515.0,3164,18.0,18,272,301,16.0,19,4.0,5,0,0
24,1/7/2021,1659,13189,704,11891,926,1269,10.0,14,406.0,3570,33.0,51,836,1137,42.0,61,15.0,20,0,0
25,1/8/2021,1989,15178,980,12871,987,2256,11.0,25,479.0,4049,47.0,98,878,2015,43.0,104,19.0,39,1,1
26,1/9/2021,1230,16408,530,13401,682,2938,12.0,37,303.0,4352,16.0,114,618,2633,37.0,141,11.0,50,0,1
27,1/10/2021,701,17109,427,13828,270,3208,4.0,41,261.0,4613,10.0,124,244,2877,13.0,154,3.0,53,0,1
28,1/11/2021,1146,18255,797,14625,346,3554,1.0,42,535.0,5148,10.0,134,314,3191,19.0,173,3.0,56,0,1
29,1/12/2021,1179,19434,881,15506,297,3851,8.0,50,518.0,5666,14.0,148,257,3448,18.0,191,8.0,64,1,2
30,1/13/2021,1080,20514,836,16342,241,4092,1.0,51,378.0,6044,23.0,171,195,3643,15.0,206,8.0,72,0,2
31,1/14/2021,873,21387,838,17180,35,4127,1.0,52,494.0,6538,2.0,173,31,3674,1.0,207,1.0,73,0,2
32,1/15/2021,1221,22608,1208,18388,13,4140,0.0,52,760.0,7298,0.0,173,13,3687,0.0,207,0.0,73,0,2
33,1/16/2021,985,23593,971,19359,14,4154,1.0,53,585.0,7883,0.0,173,13,3700,1.0,208,0.0,73,0,2
34,1/17/2021,54,23647,50,19409,4,4158,0.0,53,19.0,7902,0.0,173,2,3702,2.0,210,0.0,73,0,2
35,1/18/2021,1013,24660,811,20220,200,4358,48.0,101,598.0,8500,8.0,181,174,3876,13.0,223,5.0,78,2,4
36,1/19/2021,1255,25915,1115,21335,138,4496,7.0,108,737.0,9237,7.0,188,117,3993,6.0,229,8.0,86,0,4
37,1/20/2021,1425,27340,1205,22540,218,4714,17.0,125,572.0,9809,15.0,203,177,4170,9.0,238,17.0,103,1,5
38,1/21/2021,2252,29592,2043,24583,209,4923,7.0,132,1585.0,11394,13.0,216,174,4344,15.0,253,7.0,110,0,5
39,1/22/2021,1739,31331,1462,26045,276,5199,90.0,222,1091.0,12485,34.0,250,222,4566,13.0,266,7.0,117,0,5
40,1/23/2021,896,32227,563,26608,324,5523,51.0,273,417.0,12902,8.0,258,296,4862,13.0,279,7.0,124,0,5
41,1/24/2021,393,32620,104,26712,283,5806,203.0,476,61.0,12963,8.0,266,267,5129,8.0,287,,124,0,5
42,1/25/2021,1408,34028,786,27498,605,6411,355.0,831,554.0,13517,14.0,280,564,5693,15.0,302,12.0,136,0,5
43,1/26/2021,1622,35650,693,28191,912,7323,450.0,1281,441.0,13958,30.0,310,838,6531,32.0,334,12.0,148,0,5
44,1/27/2021,1846,37496,778,28969,1060,8383,533.0,1814,341.0,14299,40.0,350,967,7498,44.0,378,9.0,157,0,5
45,1/28/2021,1349,38845,542,29511,802,9185,354.0,2168,298.0,14597,25.0,375,734,8232,28.0,406,15.0,172,2,7
46,1/29/2021,1638,40483,1160,30671,473,9658,156.0,2324,828.0,15425,21.0,396,410,8642,32.0,438,10.0,182,0,7
47,1/30/2021,1227,41710,733,31404,490,10148,213.0,2537,598.0,16023,24.0,420,439,9081,21.0,459,6.0,188,0,7
48,1/31/2021,632,42342,407,31811,224,10372,76.0,2613,362.0,16385,5.0,425,198,9279,15.0,474,6.0,194,1,8
49,2/1/2021,1608,43950,904,32715,699,11071,466.0,3079,655.0,17040,17.0,442,646,9925,26.0,500,10.0,204,1,9
50,2/2/2021,1866,45816,732,33447,1123,12194,729.0,3808,584.0,17624,43.0,485,1035,10960,34.0,534,11.0,215,0,9
51,2/3/2021,1270,47086,584,34031,683,12877,324.0,4132,225.0,17849,48.0,533,585,11545,41.0,575,9.0,224,0,9
52,2/4/2021,2538,49624,1795,35826,732,13609,488.0,4620,1552.0,19401,30.0,563,655,12200,37.0,612,10.0,234,1,10
53,2/5/2021,2580,52204,1533,37359,1033,14642,680.0,5300,1305.0,20706,38.0,601,947,13147,30.0,642,18.0,252,2,12
54,2/6/2021,2218,54422,1596,38955,611,15253,439.0,5739,1240.0,21946,6.0,607,581,13728,22.0,664,2.0,254,0,12
55,2/7/2021,233,54655,89,39044,140,15393,93.0,5832,26.0,21972,7.0,614,124,13852,4.0,668,5.0,259,1,13
56,2/8/2021,2480,57135,1595,40639,872,16265,587.0,6419,1138.0,23110,26.0,640,802,14654,27.0,695,17.0,276,0,13
57,2/9/2021,2388,59523,1543,42182,839,17104,511.0,6930,997.0,24107,26.0,666,754,15408,32.0,727,27.0,303,0,13
58,2/10/2021,1584,61107,964,43146,614,17718,319.0,7249,288.0,24395,25.0,691,547,15955,26.0,753,16.0,319,4,17
59,2/11/2021,3533,64640,2000,45146,1519,19237,1048.0,8297,808.0,25203,55.0,746,1388,17343,49.0,802,27.0,346,2,19
60,2/12/2021,3269,67909,1814,46960,1436,20673,947.0,9244,801.0,26004,60.0,806,1321,18664,42.0,844,13.0,359,0,19
61,2/13/2021,2998,70907,2365,49325,624,21297,307.0,9551,673.0,26677,13.0,819,577,19241,22.0,866,12.0,371,1,20
62,2/14/2021,420,71327,349,49674,71,21368,49.0,9600,45.0,26722,2.0,821,64,19305,3.0,869,2.0,373,0,20
63,2/15/2021,2628,73955,2132,51806,492,21860,324.0,9924,256.0,26978,17.0,838,461,19766,12.0,881,2.0,375,0,20
64,2/16/2021,2755,76710,1921,53727,824,22684,495.0,10419,231.0,27209,35.0,873,749,20515,24.0,905,16.0,391,0,20
65,2/17/2021,1635,78345,656,54383,972,23656,479.0,10898,155.0,27364,29.0,902,887,21402,36.0,941,20.0,411,0,20
66,2/18/2021,2643,80988,1679,56062,948,24604,727.0,11625,277.0,27641,37.0,939,874,22276,30.0,971,7.0,418,1,21
67,2/19/2021,2423,83411,1033,57095,1369,25973,1011.0,12636,159.0,27800,44.0,983,1266,23542,44.0,1015,15.0,433,3,24
68,2/20/2021,1654,85065,687,57782,958,26931,781.0,13417,133.0,27933,22.0,1005,897,24439,29.0,1044,10.0,443,1,25
69,2/21/2021,110,85175,40,57822,69,27000,38.0,13455,8.0,27941,1.0,1006,66,24505,2.0,1046,0.0,443,0,25
70,2/22/2021,2024,87199,763,58585,1241,28241,917.0,14372,147.0,28088,37.0,1043,1157,25662,37.0,1083,10.0,453,1,26
71,2/23/2021,1226,88425,520,59105,703,28944,469.0,14841,161.0,28249,20.0,1063,634,26296,36.0,1119,13.0,466,0,26
72,2/24/2021,1412,89837,754,59859,651,29595,276.0,15117,136.0,28385,31.0,1094,596,26892,19.0,1138,5.0,471,1,27
73,2/25/2021,3870,93707,2074,61933,1782,31377,1501.0,16618,352.0,28737,47.0,1141,1682,28574,36.0,1174,17.0,488,0,27
74,2/26/2021,3276,96983,1157,63090,2109,33486,1743.0,18361,203.0,28940,33.0,1174,1988,30562,59.0,1233,29.0,517,2,29
75,2/27/2021,3491,100474,1662,64752,1817,35303,1555.0,19916,544.0,29484,36.0,1210,1702,32264,52.0,1285,27.0,544,1,30
76,2/28/2021,429,100903,359,65111,69,35372,43.0,19959,115.0,29599,2.0,1212,63,32327,2.0,1287,2.0,546,0,30
77,3/1/2021,2823,103726,1348,66459,1467,36839,1076.0,21035,299.0,29898,53.0,1265,1356,33683,46.0,1333,12.0,558,5,35
78,3/2/2021,3255,106981,1727,68186,1518,38357,1051.0,22086,383.0,30281,38.0,1303,1409,35092,44.0,1377,27.0,585,1,36
79,3/3/2021,1660,108641,1095,69281,562,38919,174.0,22260,203.0,30484,32.0,1335,502,35594,24.0,1401,4.0,589,0,36
80,3/4/2021,3005,111646,1583,70864,1419,40338,814.0,23074,170.0,30654,42.0,1377,1303,36897,54.0,1455,20.0,609,25,61
81,3/5/2021,3488,115134,2059,72923,1433,41771,811.0,23885,426.0,31080,39.0,1416,1328,38225,43.0,1498,23.0,632,26,87
82,3/6/2021,4120,119254,2336,75259,1979,43750,753.0,24638,268.0,31348,93.0,1509,1777,40002,76.0,1574,33.0,665,589,676
83,3/7/2021,416,119670,302,75561,122,43872,35.0,24673,21.0,31369,1.0,1510,117,40119,2.0,1576,2.0,667,21,697
84,3/8/2021,2824,122494,1056,76617,1770,45642,259.0,24932,75.0,31444,49.0,1559,1636,41755,63.0,1639,22.0,689,124,821
85,3/9/2021,3190,125684,1655,78272,1549,47191,265.0,25197,96.0,31540,51.0,1610,1408,43163,65.0,1704,25.0,714,74,895
86,3/10/2021,2382,128066,1368,79640,1016,48207,298.0,25495,84.0,31624,54.0,1664,914,44077,32.0,1736,16.0,730,64,959
87,3/11/2021,4179,132245,2381,82021,1803,50010,400.0,25895,135.0,31759,63.0,1727,1654,45731,67.0,1803,19.0,749,75,1034
88,3/12/2021,3944,136189,2574,84595,1384,51394,197.0,26092,67.0,31826,64.0,1791,1234,46965,53.0,1856,33.0,782,74,1108
89,3/13/2021,212,136401,129,84724,99,51493,20.0,26112,6.0,31832,1.0,1792,92,47057,4.0,1860,2.0,784,30,1138
90,3/14/2021,101,136502,61,84785,39,51532,9.0,26121,0.0,31832,1.0,1793,36,47093,1.0,1861,1.0,785,2,1140
91,3/15/2021,900,137402,363,85148,536,52068,85.0,26206,15.0,31847,19.0,1812,493,47586,17.0,1878,7.0,792,19,1159
92,3/16/2021,3288,140690,2116,87264,1170,53238,227.0,26433,46.0,31893,65.0,1877,1042,48628,42.0,1920,21.0,813,30,1189
93,3/17/2021,2915,143605,1787,89051,1131,54369,239.0,26672,88.0,31981,40.0,1917,1036,49664,35.0,1955,20.0,833,32,1221
94,3/18/2021,4007,147612,2091,91142,1919,56288,336.0,27008,91.0,32072,96.0,2013,1738,51402,64.0,2019,21.0,854,21,1242
95,3/19/2021,3001,150613,1752,92894,1248,57536,222.0,27230,42.0,32114,60.0,2073,1123,52525,45.0,2064,20.0,874,16,1258
96,3/20/2021,3082,153695,1966,94860,1117,58653,313.0,27543,54.0,32168,37.0,2110,1004,53529,55.0,2119,21.0,895,35,1293
97,3/21/2021,662,154357,398,95258,266,58919,26.0,27569,5.0,32173,11.0,2121,236,53765,16.0,2135,3.0,898,18,1311
98,3/22/2021,3112,157469,2244,97502,865,59784,188.0,27757,56.0,32229,19.0,2140,796,54561,37.0,2172,13.0,911,25,1336
99,3/23/2021,4452,161921,3574,101076,1171,60955,194.0,27951,75.0,32304,38.0,2178,1043,55604,51.0,2223,39.0,950,496,1832
100,3/24/2021,3167,165088,2431,103507,745,61700,118.0,28069,37.0,32341,41.0,2219,664,56268,26.0,2249,14.0,964,40,1872
101,3/25/2021,5069,170157,3055,106562,2010,63710,312.0,28381,71.0,32412,67.0,2286,1842,58110,70.0,2319,31.0,995,15,1887
102,3/26/2021,4583,174740,2724,109286,1856,65566,329.0,28710,65.0,32477,115.0,2401,1596,59706,114.0,2433,31.0,1026,31,1918
103,3/27/2021,3343,178083,1915,111201,1423,66989,325.0,29035,21.0,32498,49.0,2450,1308,61014,46.0,2479,20.0,1046,4,1922
104,3/28/2021,1173,179256,811,112012,362,67351,93.0,29128,16.0,32514,12.0,2462,332,61346,16.0,2495,2.0,1048,4,1926
105,3/29/2021,3989,183245,2691,114703,1291,68642,229.0,29357,53.0,32567,38.0,2500,1212,62558,28.0,2523,13.0,1061,8,1934
106,3/30/2021,4367,187612,2749,117452,1639,70281,237.0,29594,74.0,32641,55.0,2555,1498,64056,68.0,2591,18.0,1079,43,1977
107,3/31/2021,3584,191196,2566,120018,1048,71329,165.0,29759,47.0,32688,42.0,2597,936,64992,50.0,2641,20.0,1099,33,2010
108,4/1/2021,5108,196304,3330,123348,1784,73113,147.0,29906,76.0,32764,73.0,2670,1632,66624,60.0,2701,19.0,1118,34,2044
109,4/2/2021,4713,201017,2526,125874,2180,75293,245.0,30151,50.0,32814,82.0,2752,1980,68604,91.0,2792,27.0,1145,29,2073
110,4/3/2021,4261,205278,3529,129403,763,76056,94.0,30245,41.0,32855,36.0,2788,679,69283,29.0,2821,19.0,1164,70,2143
111,4/4/2021,373,205651,258,129661,133,76189,6.0,30251,7.0,32862,3.0,2791,116,69399,11.0,2832,3.0,1167,33,2176
112,4/5/2021,4696,210347,3770,133431,947,77136,75.0,30326,47.0,32909,69.0,2860,810,70209,49.0,2881,19.0,1186,93,2269
113,4/6/2021,5164,215511,3027,136458,2313,79449,85.0,30411,58.0,32967,80.0,2940,2052,72261,126.0,3007,55.0,1241,274,2543
114,4/7/2021,4970,220481,3686,140144,2157,81606,60.0,30471,109.0,33076,119.0,3059,1832,74093,134.0,3141,72.0,1313,1175,3718
115,4/8/2021,6690,227171,4513,144657,2849,84455,137.0,30608,123.0,33199,135.0,3194,2502,76595,140.0,3281,72.0,1385,939,4657
116,4/9/2021,5727,232898,3271,147928,3215,87670,77.0,30685,71.0,33270,162.0,3356,2780,79375,180.0,3461,93.0,1478,824,5481
117,4/10/2021,4431,237329,3165,151093,1732,89402,50.0,30735,71.0,33341,97.0,3453,1466,80841,116.0,3577,53.0,1531,520,6001
118,4/11/2021,1037,238366,794,151887,288,89690,6.0,30741,11.0,33352,12.0,3465,241,81082,24.0,3601,11.0,1542,56,6057
119,4/12/2021,5042,243408,3641,155528,2003,91693,75.0,30816,96.0,33448,77.0,3542,1734,82816,132.0,3733,60.0,1602,516,6573
120,4/13/2021,5037,248445,3561,159089,1488,93181,55.0,30871,77.0,33525,70.0,3612,1298,84114,96.0,3829,24.0,1626,22,6595
121,4/14/2021,2959,251404,1441,160530,1511,94692,86.0,30957,26.0,33551,93.0,3705,1315,85429,70.0,3899,33.0,1659,2,6597
122,4/15/2021,4945,256349,2320,162850,2607,97299,102.0,31059,58.0,33609,217.0,3922,2168,87597,161.0,4060,61.0,1720,3,6600
123,4/16/2021,3908,260257,2076,164926,1816,99115,44.0,31103,34.0,33643,65.0,3987,1589,89186,127.0,4187,35.0,1755,4,6604
124,4/17/2021,4592,264849,2404,167330,2171,101286,39.0,31142,57.0,33700,99.0,4086,1888,91074,133.0,4320,51.0,1806,4,6608
125,4/18/2021,1041,265890,410,167740,624,101910,13.0,31155,11.0,33711,42.0,4128,519,91593,33.0,4353,30.0,1836,3,6611
126,4/19/2021,3857,269747,1407,169147,2425,104335,44.0,31199,40.0,33751,166.0,4294,2039,93632,162.0,4515,58.0,1894,5,6616
127,4/20/2021,4705,274452,1872,171019,2816,107151,47.0,31246,69.0,33820,159.0,4453,2401,96033,193.0,4708,63.0,1957,5,6621
128,4/21/2021,3176,277628,712,171731,2451,109602,35.0,31281,31.0,33851,145.0,4598,2062,98095,165.0,4873,79.0,2036,6,6627
129,4/22/2021,4658,282286,1771,173502,2874,112476,46.0,31327,62.0,33913,143.0,4741,2465,100560,193.0,5066,73.0,2109,2,6629
130,4/23/2021,3587,285873,1177,174679,2394,114870,41.0,31368,30.0,33943,73.0,4814,2111,102671,128.0,5194,82.0,2191,5,6634
131,4/24/2021,3357,289230,1119,175798,2234,117104,14.0,31382,20.0,33963,105.0,4919,1894,104565,195.0,5389,40.0,2231,4,6638
132,4/25/2021,796,290026,343,176141,452,117556,6.0,31388,6.0,33969,105.0,5024,268,104833,39.0,5428,40.0,2271,1,6639
133,4/26/2021,4358,294384,1110,177251,3237,120793,36.0,31424,31.0,34000,148.0,5172,2781,107614,215.0,5643,93.0,2364,4,6643
134,4/27/2021,3345,297729,1194,178445,2144,122937,36.0,31460,37.0,34037,79.0,5251,1889,109503,134.0,5777,42.0,2406,10,6653
135,4/28/2021,2993,300722,716,179161,2275,125212,45.0,31505,20.0,34057,168.0,5419,1845,111348,197.0,5974,65.0,2471,13,6666
136,4/29/2021,3964,304686,821,179982,3137,128349,67.0,31572,33.0,34090,227.0,5646,2577,113925,226.0,6200,107.0,2578,7,6673
137,4/30/2021,2873,307559,642,180624,2230,130579,44.0,31616,24.0,34114,74.0,5720,1893,115818,200.0,6400,63.0,2641,12,6685
138,5/1/2021,3651,311210,816,181440,2817,133396,35.0,31651,18.0,34132,283.0,6003,2192,118010,202.0,6602,140.0,2781,16,6701
139,5/2/2021,528,311738,232,181672,307,133703,7.0,31658,2.0,34134,12.0,6015,246,118256,39.0,6641,10.0,2791,10,6711
140,5/3/2021,3432,315170,637,182309,2794,136497,47.0,31705,34.0,34168,107.0,6122,2396,120652,214.0,6855,77.0,2868,13,6724
141,5/4/2021,4349,319519,698,183007,3669,140166,67.0,31772,27.0,34195,148.0,6270,3151,123803,259.0,7114,111.0,2979,30,6754
142,5/5/2021,2232,321751,477,183484,1789,141955,63.0,31835,24.0,34219,86.0,6356,1482,125285,141.0,7255,80.0,3059,14,6768
143,5/6/2021,3688,325439,822,184306,2984,144939,100.0,31935,40.0,34259,179.0,6535,2471,127756,196.0,7451,138.0,3197,45,6813
144,5/7/2021,2940,328379,543,184849,2485,147424,44.0,31979,11.0,34270,135.0,6670,2041,129797,211.0,7662,98.0,3295,40,6853
145,5/8/2021,2995,331374,555,185404,2542,149966,45.0,32024,16.0,34286,165.0,6835,2052,131849,195.0,7857,130.0,3425,48,6901
146,5/9/2021,369,331743,140,185544,242,150208,4.0,32028,2.0,34288,10.0,6845,202,132051,20.0,7877,10.0,3435,3,6904
147,5/10/2021,2427,334170,380,185924,2080,152288,59.0,32087,16.0,34304,87.0,6932,1692,133743,205.0,8082,96.0,3531,25,6929
148,5/11/2021,2719,336889,542,186466,2216,154504,91.0,32178,24.0,34328,189.0,7121,1728,135471,203.0,8285,96.0,3627,17,6946
149,5/12/2021,1230,338119,461,186927,821,155325,23.0,32201,14.0,34342,49.0,7170,651,136122,86.0,8371,35.0,3662,23,6969
150,5/13/2021,3249,341368,1030,187957,2233,157558,82.0,32283,25.0,34367,149.0,7319,1823,137945,157.0,8528,104.0,3766,17,6986
151,5/14/2021,2469,343837,1280,189237,1286,158844,51.0,32334,31.0,34398,64.0,7383,1071,139016,98.0,8626,53.0,3819,34,7020
152,5/15/2021,3023,346860,1513,190750,1591,160435,40.0,32374,15.0,34413,115.0,7498,1263,140279,139.0,8765,74.0,3893,28,7048
153,5/16/2021,944,347804,573,191323,404,160839,8.0,32382,8.0,34421,83.0,7581,251,140530,30.0,8795,40.0,3933,10,7058
154,5/17/2021,2441,350245,1211,192534,1303,162142,38.0,32420,27.0,34448,48.0,7629,1095,141625,102.0,8897,58.0,3991,20,7078
155,5/18/2021,2587,352832,1175,193709,1444,163586,44.0,32464,22.0,34470,72.0,7701,1214,142839,84.0,8981,74.0,4065,17,7095
156,5/19/2021,1877,354709,1154,194863,786,164372,24.0,32488,20.0,34490,42.0,7743,636,143475,69.0,9050,39.0,4104,17,7112
157,5/20/2021,1979,356688,923,195786,1095,165467,45.0,32533,27.0,34517,94.0,7837,872,144347,80.0,9130,49.0,4153,18,7130
158,5/21/2021,1630,358318,923,196709,784,166251,18.0,32551,16.0,34533,43.0,7880,624,144971,60.0,9190,57.0,4210,29,7159
159,5/22/2021,1691,360009,795,197504,925,167176,9.0,32560,13.0,34546,123.0,8003,643,145614,74.0,9264,85.0,4295,18,7177
160,5/23/2021,678,360687,340,197844,367,167543,2.0,32562,5.0,34551,68.0,8071,226,145840,18.0,9282,55.0,4350,3,7180
161,5/24/2021,1337,362024,539,198383,847,168390,36.0,32598,20.0,34571,43.0,8114,680,146520,83.0,9365,41.0,4391,22,7202
162,5/25/2021,1234,363258,510,198893,755,169145,22.0,32620,20.0,34591,58.0,8172,566,147086,66.0,9431,65.0,4456,19,7221
163,5/26/2021,965,364223,551,199444,523,169668,17.0,32637,25.0,34616,38.0,8210,414,147500,44.0,9475,27.0,4483,28,7249
164,5/27/2021,1278,365501,662,200106,678,170346,32.0,32669,19.0,34635,54.0,8264,549,148049,49.0,9524,26.0,4509,22,7271
165,5/28/2021,1032,366533,597,200703,479,170825,18.0,32687,22.0,34657,30.0,8294,372,148421,51.0,9575,26.0,4535,17,7288
166,5/29/2021,1018,367551,493,201196,562,171387,18.0,32705,8.0,34665,32.0,8326,443,148864,42.0,9617,45.0,4580,12,7300
167,5/30/2021,333,367884,220,201416,144,171531,5.0,32710,3.0,34668,12.0,8338,105,148969,17.0,9634,10.0,4590,10,7310
168,5/31/2021,337,368221,191,201607,170,171701,8.0,32718,6.0,34674,8.0,8346,137,149106,12.0,9646,13.0,4603,11,7321
169,6/1/2021,974,369195,401,202008,603,172304,26.0,32744,17.0,34691,49.0,8395,461,149567,46.0,9692,47.0,4650,25,7346
170,6/2/2021,722,369917,371,202379,406,172710,16.0,32760,8.0,34699,34.0,8429,322,149889,23.0,9715,27.0,4677,9,7355
171,6/3/2021,1308,371225,520,202899,836,173546,22.0,32782,12.0,34711,48.0,8477,689,150578,58.0,9773,41.0,4718,15,7370
172,6/4/2021,1498,372723,399,203298,1139,174685,16.0,32798,9.0,34720,72.0,8549,954,151532,67.0,9840,46.0,4764,5,7375
173,6/5/2021,1415,374138,356,203654,1086,175771,12.0,32810,6.0,34726,64.0,8613,889,152421,93.0,9933,40.0,4804,9,7384
174,6/6/2021,531,374669,142,203796,398,176169,5.0,32815,3.0,34729,43.0,8656,318,152739,25.0,9958,12.0,4816,11,7395
175,6/7/2021,1194,375863,336,204132,901,177070,14.0,32829,12.0,34741,68.0,8724,718,153457,83.0,10041,32.0,4848,18,7413
176,6/8/2021,1088,376951,253,204385,858,177928,18.0,32847,5.0,34746,59.0,8783,696,154153,70.0,10111,33.0,4881,5,7418
177,6/9/2021,1080,378031,282,204667,844,178772,16.0,32863,12.0,34758,78.0,8861,647,154800,72.0,10183,47.0,4928,12,7430
178,6/10/2021,1311,379342,338,205005,1011,179783,20.0,32883,4.0,34762,92.0,8953,798,155598,67.0,10250,54.0,4982,10,7440
179,6/11/2021,1113,380455,324,205329,830,180613,20.0,32903,13.0,34775,57.0,9010,652,156250,77.0,10327,44.0,5026,9,7449
180,6/12/2021,1048,381503,290,205619,800,181413,15.0,32918,9.0,34784,73.0,9083,619,156869,65.0,10392,43.0,5069,9,7458
181,6/13/2021,371,381874,98,205717,284,181697,4.0,32922,1.0,34785,37.0,9120,203,157072,25.0,10417,19.0,5088,6,7464
182,6/14/2021,828,382702,282,205999,590,182287,15.0,32937,4.0,34789,44.0,9164,448,157520,42.0,10459,56.0,5144,6,7470
183,6/15/2021,698,383400,236,206235,483,182770,20.0,32957,10.0,34799,41.0,9205,390,157910,35.0,10494,17.0,5161,2,7472
184,6/16/2021,629,384029,204,206439,451,183221,12.0,32969,4.0,34803,38.0,9243,344,158254,34.0,10528,35.0,5196,9,7481
185,6/17/2021,697,384726,252,206691,468,183689,13.0,32982,10.0,34813,42.0,9285,348,158602,49.0,10577,29.0,5225,5,7486
186,6/18/2021,1038,385764,381,207072,686,184375,23.0,33005,11.0,34824,52.0,9337,554,159156,51.0,10628,29.0,5254,8,7494
187,6/19/2021,637,386401,152,207224,499,184874,10.0,33015,6.0,34830,52.0,9389,367,159523,54.0,10682,26.0,5280,10,7504
188,6/20/2021,299,386700,113,207337,192,185066,3.0,33018,2.0,34832,36.0,9425,119,159642,15.0,10697,22.0,5302,5,7509
189,6/21/2021,516,387216,215,207552,327,185393,5.0,33023,8.0,34840,28.0,9453,243,159885,35.0,10732,21.0,5323,8,7517
190,6/22/2021,614,387830,252,207804,392,185785,12.0,33035,7.0,34847,31.0,9484,308,160193,26.0,10758,27.0,5350,5,7522
191,6/23/2021,509,388339,185,207989,352,186137,7.0,33042,10.0,34857,38.0,9522,254,160447,37.0,10795,23.0,5373,11,7533
192,6/24/2021,523,388862,211,208200,335,186472,12.0,33054,9.0,34866,30.0,9552,260,160707,23.0,10818,22.0,5395,1,7534
193,6/25/2021,690,389552,275,208475,437,186909,12.0,33066,8.0,34874,42.0,9594,326,161033,42.0,10860,27.0,5422,5,7539
194,6/26/2021,597,390149,166,208641,440,187349,9.0,33075,9.0,34883,77.0,9671,289,161322,43.0,10903,31.0,5453,4,7543
195,6/27/2021,183,390332,71,208712,113,187462,2.0,33077,3.0,34886,9.0,9680,82,161404,12.0,10915,10.0,5463,2,7545
196,6/28/2021,487,390819,209,208921,285,187747,7.0,33084,6.0,34892,39.0,9719,205,161609,25.0,10940,16.0,5479,2,7547
197,6/29/2021,559,391378,251,209172,329,188076,16.0,33100,11.0,34903,42.0,9761,238,161847,23.0,10963,26.0,5505,11,7558
198,6/30/2021,411,391789,205,209377,221,188297,8.0,33108,11.0,34914,19.0,9780,166,162013,16.0,10979,20.0,5525,11,7569
199,7/1/2021,488,392277,210,209587,295,188592,8.0,33116,7.0,34921,21.0,9801,221,162234,33.0,11012,20.0,5545,5,7574
200,7/2/2021,569,392846,272,209859,307,188899,5.0,33121,7.0,34928,27.0,9828,241,162475,24.0,11036,15.0,5560,3,7577
201,7/3/2021,307,393153,120,209979,194,189093,4.0,33125,3.0,34931,29.0,9857,126,162601,20.0,11056,19.0,5579,5,7582
202,7/4/2021,54,393207,19,209998,35,189128,1.0,33126,0.0,34931,4.0,9861,22,162623,1.0,11057,8.0,5587,0,7582
203,7/5/2021,315,393522,138,210136,177,189305,3.0,33129,1.0,34932,18.0,9879,121,162744,28.0,11085,10.0,5597,4,7586
204,7/6/2021,457,393979,192,210328,274,189579,4.0,33133,5.0,34937,45.0,9924,195,162939,19.0,11104,15.0,5612,1,7587
205,7/7/2021,374,394353,210,210538,178,189757,7.0,33140,6.0,34943,19.0,9943,131,163070,13.0,11117,15.0,5627,4,7591
206,7/8/2021,425,394778,199,210737,246,190003,10.0,33150,8.0,34951,23.0,9966,176,163246,23.0,11140,24.0,5651,3,7594
207,7/9/2021,483,395261,195,210932,294,190297,9.0,33159,2.0,34953,37.0,10003,215,163461,25.0,11165,17.0,5668,6,7600
208,7/10/2021,260,395521,148,211080,128,190425,5.0,33164,2.0,34955,5.0,10008,106,163567,10.0,11175,7.0,5675,2,7602
209,7/11/2021,223,395744,119,211199,122,190547,6.0,33170,6.0,34961,11.0,10019,88,163655,10.0,11185,13.0,5688,7,7609
210,7/12/2021,385,396129,202,211401,195,190742,7.0,33177,4.0,34965,25.0,10044,130,163785,23.0,11208,17.0,5705,5,7614
211,7/13/2021,437,396566,224,211625,226,190968,16.0,33193,10.0,34975,26.0,10070,177,163962,12.0,11220,11.0,5716,4,7618
212,7/14/2021,286,396852,152,211777,154,191122,8.0,33201,5.0,34980,20.0,10090,110,164072,9.0,11229,15.0,5731,9,7627
213,7/15/2021,363,397215,191,211968,183,191305,1.0,33202,4.0,34984,15.0,10105,137,164209,14.0,11243,17.0,5748,3,7630
214,7/16/2021,511,397726,245,212213,278,191583,8.0,33210,9.0,34993,25.0,10130,211,164420,22.0,11265,20.0,5768,4,7634
215,7/17/2021,276,398002,158,212371,128,191711,11.0,33221,5.0,34998,12.0,10142,96,164516,9.0,11274,11.0,5779,7,7641
216,7/18/2021,196,398198,119,212490,89,191800,4.0,33225,3.0,35001,13.0,10155,63,164579,6.0,11280,7.0,5786,4,7645
217,7/19/2021,406,398604,206,212696,206,192006,8.0,33233,8.0,35009,26.0,10181,150,164729,17.0,11297,13.0,5799,4,7649
218,7/20/2021,417,399021,210,212906,215,192221,6.0,33239,8.0,35017,12.0,10193,166,164895,23.0,11320,14.0,5813,5,7654
219,7/21/2021,335,399356,183,213089,172,192393,13.0,33252,14.0,35031,12.0,10205,129,165024,14.0,11334,17.0,5830,3,7657
220,7/22/2021,394,399750,232,213321,169,192562,6.0,33258,18.0,35049,19.0,10224,124,165148,18.0,11352,8.0,5838,6,7663
221,7/23/2021,552,400302,318,213639,237,192799,6.0,33264,10.0,35059,37.0,10261,161,165309,20.0,11372,19.0,5857,3,7666
222,7/24/2021,352,400654,214,213853,157,192956,8.0,33272,10.0,35069,19.0,10280,115,165424,9.0,11381,14.0,5871,5,7671
223,7/25/2021,195,400849,143,213996,62,193018,0.0,33272,4.0,35073,7.0,10287,44,165468,5.0,11386,6.0,5877,4,7675
224,7/26/2021,347,401196,201,214197,143,193161,1.0,33273,7.0,35080,11.0,10298,97,165565,18.0,11404,17.0,5894,4,7679
225,7/27/2021,424,401620,238,214435,174,193335,5.0,33278,16.0,35096,22.0,10320,122,165687,17.0,11421,13.0,5907,14,7693
226,7/28/2021,467,402087,282,214717,222,193557,3.0,33281,10.0,35106,28.0,10348,144,165831,17.0,11438,33.0,5940,5,7698
227,7/29/2021,510,402597,307,215024,232,193789,8.0,33289,6.0,35112,24.0,10372,176,166007,14.0,11452,18.0,5958,10,7708
228,7/30/2021,688,403285,476,215500,249,194038,10.0,33299,14.0,35126,25.0,10397,189,166196,16.0,11468,19.0,5977,5,7713
229,7/31/2021,334,403619,200,215700,138,194176,4.0,33303,1.0,35127,15.0,10412,109,166305,9.0,11477,5.0,5982,5,7718
230,8/1/2021,268,403887,171,215871,105,194281,0.0,33303,2.0,35129,15.0,10427,66,166371,8.0,11485,16.0,5998,8,7726
231,8/2/2021,448,404335,299,216170,173,194454,4.0,33307,13.0,35142,22.0,10449,118,166489,20.0,11505,13.0,6011,6,7732
232,8/3/2021,558,404893,345,216515,238,194692,6.0,33313,14.0,35156,37.0,10486,159,166648,15.0,11520,27.0,6038,4,7736
233,8/4/2021,392,405285,274,216789,139,194831,3.0,33316,14.0,35170,10.0,10496,106,166754,5.0,11525,18.0,6056,10,7746
234,8/5/2021,444,405729,287,217076,168,194999,5.0,33321,11.0,35181,19.0,10515,122,166876,16.0,11541,11.0,6067,4,7750
235,8/6/2021,682,406411,462,217538,266,195265,13.0,33334,16.0,35197,22.0,10537,201,167077,22.0,11563,21.0,6088,4,7754
236,8/7/2021,438,406849,306,217844,155,195420,4.0,33338,10.0,35207,12.0,10549,122,167199,5.0,11568,16.0,6104,5,7759
237,8/8/2021,218,407067,126,217970,99,195519,3.0,33341,5.0,35212,8.0,10557,72,167271,7.0,11575,12.0,6116,5,7764
238,8/9/2021,462,407529,279,218249,213,195732,4.0,33345,6.0,35218,22.0,10579,158,167429,11.0,11586,22.0,6138,6,7770
239,8/10/2021,504,408033,301,218550,228,195960,6.0,33351,14.0,35232,24.0,10603,180,167609,11.0,11597,13.0,6151,8,7778
240,8/11/2021,419,408452,264,218814,177,196137,11.0,33362,5.0,35237,17.0,10620,134,167743,14.0,11611,12.0,6163,2,7780
241,8/12/2021,542,408994,320,219134,259,196396,7.0,33369,15.0,35252,31.0,10651,183,167926,23.0,11634,22.0,6185,7,7787
242,8/13/2021,657,409651,378,219512,298,196694,11.0,33380,9.0,35261,31.0,10682,217,168143,19.0,11653,31.0,6216,5,7792
243,8/14/2021,505,410156,258,219770,249,196943,7.0,33387,9.0,35270,12.0,10694,211,168354,9.0,11662,17.0,6233,46,7838
244,8/15/2021,263,410419,129,219899,123,197066,2.0,33389,3.0,35273,11.0,10705,89,168443,6.0,11668,17.0,6250,15,7853
245,8/16/2021,539,410958,311,220210,170,197236,5.0,33394,11.0,35284,15.0,10720,130,168573,13.0,11681,12.0,6262,69,7922
246,8/17/2021,483,411441,228,220438,194,197430,19.0,33413,10.0,35294,17.0,10737,146,168719,10.0,11691,21.0,6283,66,7988
247,8/18/2021,592,412033,324,220762,257,197687,5.0,33418,15.0,35309,30.0,10767,175,168894,13.0,11704,39.0,6322,64,8052
248,8/19/2021,565,412598,278,221040,255,197942,7.0,33425,9.0,35318,21.0,10788,205,169099,17.0,11721,12.0,6334,67,8119
249,8/20/2021,842,413440,340,221380,450,198392,14.0,33439,10.0,35328,44.0,10832,357,169456,29.0,11750,20.0,6354,79,8198
250,8/21/2021,645,414085,208,221588,209,198601,4.0,33443,7.0,35335,14.0,10846,171,169627,13.0,11763,11.0,6365,174,8372
251,8/22/2021,313,414398,150,221738,140,198741,1.0,33444,2.0,35337,19.0,10865,98,169725,9.0,11772,14.0,6379,29,8401
252,8/23/2021,527,414925,261,221999,222,198963,10.0,33454,9.0,35346,19.0,10884,169,169894,12.0,11784,22.0,6401,58,8459
253,8/24/2021,571,415496,275,222274,274,199237,10.0,33464,8.0,35354,27.0,10911,215,170109,14.0,11798,18.0,6419,49,8508
254,8/25/2021,597,416093,323,222597,257,199494,12.0,33476,13.0,35367,19.0,10930,196,170305,9.0,11807,33.0,6452,48,8556
255,8/26/2021,535,416628,260,222857,253,199747,9.0,33485,14.0,35381,18.0,10948,195,170500,23.0,11830,17.0,6469,42,8598
256,8/27/2021,890,417518,352,223209,404,200151,15.0,33500,11.0,35392,38.0,10986,298,170798,23.0,11853,45.0,6514,144,8742
257,8/28/2021,1466,418984,202,223411,251,200402,7.0,33507,5.0,35397,23.0,11009,188,170986,13.0,11866,27.0,6541,968,9710
258,8/29/2021,1082,420066,162,223573,136,200538,4.0,33511,4.0,35401,8.0,11017,111,171097,12.0,11878,5.0,6546,764,10474
259,8/30/2021,616,420682,272,223845,279,200817,8.0,33519,13.0,35414,24.0,11041,214,171311,9.0,11887,32.0,6578,88,10562
260,8/31/2021,810,421492,234,224079,237,201054,7.0,33526,12.0,35426,19.0,11060,187,171498,18.0,11905,13.0,6591,332,10894
261,9/1/2021,956,422537,250,224363,222,201163,13.0,33500,16.0,35446,21.0,11083,169,171567,13.0,11917,19.0,6596,474,11391
262,9/2/2021,825,423362,182,224545,204,201367,15.0,33515,12.0,35458,18.0,11101,152,171719,17.0,11934,17.0,6613,444,11835
263,9/3/2021,851,424213,339,224884,369,201736,14.0,33529,12.0,35470,43.0,11144,270,171989,21.0,11955,35.0,6648,158,11993
264,9/4/2021,377,424590,164,225048,165,201901,6.0,33535,8.0,35478,13.0,11157,128,172117,11.0,11966,13.0,6661,55,12048
265,9/5/2021,251,424841,131,225179,108,202009,2.0,33537,4.0,35482,13.0,11170,77,172194,9.0,11975,9.0,6670,21,12069
266,9/6/2021,112,424953,46,225225,59,202068,1.0,33538,0.0,35482,4.0,11174,43,172237,8.0,11983,4.0,6674,11,12080
267,9/7/2021,953,425906,199,225424,273,202341,19.0,33557,12.0,35494,22.0,11196,209,172446,17.0,12000,25.0,6699,471,12551
268,9/8/2021,789,426695,218,225642,226,202567,11.0,33568,12.0,35506,24.0,11220,170,172616,11.0,12011,21.0,6720,363,12914
269,9/9/2021,401,427096,176,225818,192,202759,10.0,33578,8.0,35514,21.0,11241,140,172756,14.0,12025,17.0,6737,54,12968
270,9/10/2021,755,427851,341,226159,308,203067,9.0,33587,24.0,35538,28.0,11269,232,172988,20.0,12045,28.0,6765,142,13110
271,9/11/2021,1634,429485,162,226321,211,203278,11.0,33598,19.0,35557,17.0,11286,162,173150,15.0,12060,17.0,6782,1252,14362
272,9/12/2021,232,429717,101,226422,113,203391,1.0,33599,2.0,35559,11.0,11297,73,173223,10.0,12070,19.0,6801,16,14378
273,9/13/2021,492,430209,218,226640,245,203636,9.0,33608,8.0,35567,24.0,11321,184,173407,12.0,12082,25.0,6826,44,14422
274,9/14/2021,844,431053,203,226843,274,203910,13.0,33621,15.0,35582,17.0,11338,220,173627,14.0,12096,23.0,6849,391,14813
275,9/15/2021,833,431886,191,227034,269,204179,15.0,33636,15.0,35597,21.0,11359,200,173827,16.0,12112,32.0,6881,391,15204
276,9/16/2021,358,432244,134,227168,195,204374,9.0,33645,8.0,35605,32.0,11391,140,173967,12.0,12124,11.0,6892,42,15246
277,9/17/2021,747,432991,285,227453,388,204762,13.0,33658,13.0,35618,29.0,11420,290,174257,38.0,12162,31.0,6923,117,15363
278,9/18/2021,1842,434833,127,227580,176,204938,6.0,33664,20.0,35638,10.0,11430,130,174387,16.0,12178,20.0,6943,1520,16883
279,9/19/2021,182,435015,75,227655,106,205044,3.0,33667,2.0,35640,7.0,11437,81,174468,5.0,12183,13.0,6956,9,16892
280,9/20/2021,385,435400,144,227799,215,205259,8.0,33675,9.0,35649,27.0,11464,159,174627,10.0,12193,19.0,6975,55,16947
281,9/21/2021,772,436172,165,227964,201,205460,9.0,33684,13.0,35662,21.0,11485,155,174782,9.0,12202,16.0,6991,413,17360
282,9/22/2021,720,436892,164,228128,230,205690,6.0,33690,12.0,35674,15.0,11500,183,174965,16.0,12218,16.0,7007,357,17717
283,9/23/2021,346,437238,143,228271,178,205868,8.0,33698,3.0,35677,9.0,11509,131,175096,13.0,12231,25.0,7032,45,17762
284,9/24/2021,690,437928,206,228477,274,206142,17.0,33715,16.0,35693,20.0,11529,217,175313,11.0,12242,26.0,7058,225,17987
285,9/25/2021,1731,439659,133,228610,176,206318,11.0,33726,21.0,35714,15.0,11544,137,175450,12.0,12254,12.0,7070,1415,19402
286,9/26/2021,264,439923,66,228676,88,206406,3.0,33729,3.0,35717,11.0,11555,66,175516,4.0,12258,7.0,7077,108,19510
287,9/27/2021,566,440489,156,228832,123,206529,7.0,33736,11.0,35728,7.0,11562,95,175611,8.0,12266,13.0,7090,303,19813
288,9/28/2021,1131,441620,158,228990,202,206731,19.0,33755,23.0,35751,15.0,11577,153,175764,9.0,12275,25.0,7115,783,20596
289,9/29/2021,1137,442757,174,229164,170,206901,12.0,33767,19.0,35770,15.0,11592,128,175892,7.0,12282,20.0,7135,798,21394
290,9/30/2021,708,443465,160,229324,168,207069,15.0,33782,7.0,35777,11.0,11603,128,176020,11.0,12293,18.0,7153,409,21803
291,10/1/2021,1074,444539,177,229501,304,207373,21.0,33803,16.0,35793,20.0,11623,241,176261,21.0,12314,22.0,7175,601,22404
292,10/2/2021,1815,446354,118,229619,115,207488,12.0,33815,14.0,35807,9.0,11632,96,176357,5.0,12319,5.0,7180,1583,23987
293,10/3/2021,391,446745,63,229682,113,207601,1.0,33816,2.0,35809,18.0,11650,77,176434,7.0,12326,11.0,7191,225,24212
294,10/4/2021,796,447541,114,229796,157,207758,7.0,33823,13.0,35822,27.0,11677,103,176537,14.0,12340,13.0,7204,531,24743
295,10/5/2021,1123,448664,139,229935,133,207891,12.0,33835,17.0,35839,13.0,11690,101,176638,6.0,12346,13.0,7217,854,25597
296,10/6/2021,1000,449664,107,230042,155,208046,8.0,33843,14.0,35853,11.0,11701,124,176762,5.0,12351,15.0,7232,752,26349
297,10/7/2021,790,450454,136,230178,108,208154,8.0,33851,15.0,35868,8.0,11709,84,176846,5.0,12356,11.0,7243,566,26915
298,10/8/2021,1038,451492,159,230337,241,208395,19.0,33870,11.0,35879,21.0,11730,187,177033,11.0,12367,22.0,7265,650,27565
299,10/9/2021,1676,453168,108,230445,132,208527,11.0,33881,8.0,35887,22.0,11752,98,177131,4.0,12371,8.0,7273,1431,28996
300,10/10/2021,243,453411,50,230495,63,208590,2.0,33883,2.0,35889,4.0,11756,49,177180,5.0,12376,5.0,7278,131,29127
301,10/11/2021,819,454230,119,230614,137,208727,17.0,33900,18.0,35907,3.0,11759,112,177292,10.0,12386,12.0,7290,573,29700
302,10/12/2021,1024,455254,115,230729,133,208860,8.0,33908,19.0,35926,16.0,11775,105,177397,4.0,12390,8.0,7298,786,30486
303,10/13/2021,974,456228,118,230847,151,209011,17.0,33925,9.0,35935,16.0,11791,114,177511,12.0,12402,9.0,7307,721,31207
304,10/14/2021,714,456942,100,230947,128,209139,14.0,33939,9.0,35944,20.0,11811,95,177606,8.0,12410,5.0,7312,493,31700
305,10/15/2021,1025,457967,176,231123,213,209352,11.0,33950,7.0,35951,15.0,11826,168,177774,12.0,12422,18.0,7330,671,32371
306,10/16/2021,802,458769,65,231188,80,209432,4.0,33954,3.0,35954,6.0,11832,69,177843,2.0,12424,3.0,7333,657,33028
307,10/17/2021,196,458965,48,231236,63,209495,1.0,33955,2.0,35956,4.0,11836,47,177890,3.0,12427,9.0,7342,83,33111
308,10/18/2021,650,459615,117,231353,133,209628,10.0,33965,3.0,35959,13.0,11849,105,177995,6.0,12433,9.0,7351,415,33526
309,10/19/2021,1052,460667,120,231473,134,209762,4.0,33969,11.0,35970,8.0,11857,108,178103,8.0,12441,10.0,7361,806,34332
310,10/20/2021,891,461558,120,231593,119,209881,6.0,33975,12.0,35982,8.0,11865,90,178193,7.0,12448,14.0,7375,664,34996
311,10/21/2021,534,462092,108,231701,126,210007,9.0,33984,8.0,35990,13.0,11878,85,178278,11.0,12459,17.0,7392,321,35317
312,10/22/2021,1478,463570,195,231896,227,210234,9.0,33993,13.0,36003,19.0,11897,168,178446,14.0,12473,26.0,7418,1077,36394
313,10/23/2021,1879,465449,86,231982,195,210429,14.0,34007,14.0,36017,4.0,11901,169,178615,12.0,12485,10.0,7428,1598,37992
314,10/24/2021,573,466022,80,232062,151,210580,8.0,34015,11.0,36028,12.0,11913,127,178742,7.0,12492,5.0,7433,354,38346
315,10/25/2021,1424,467446,135,232197,303,210883,27.0,34042,17.0,36045,12.0,11925,258,179000,21.0,12513,12.0,7445,996,39342
316,10/26/2021,2145,469591,176,232373,301,211184,15.0,34057,18.0,36063,19.0,11944,251,179251,17.0,12530,14.0,7459,1673,41015
317,10/27/2021,1967,471558,149,232522,271,211455,18.0,34075,18.0,36081,9.0,11953,239,179490,14.0,12544,9.0,7468,1551,42566
318,10/28/2021,1717,473275,137,232659,263,211718,11.0,34086,19.0,36100,11.0,11964,221,179711,17.0,12561,14.0,7482,1328,43894
319,10/29/2021,1661,474936,177,232836,277,211995,12.0,34098,16.0,36116,10.0,11974,242,179953,12.0,12573,13.0,7495,1217,45111
320,10/30/2021,1584,476520,77,232913,150,212145,13.0,34111,8.0,36124,6.0,11980,129,180082,9.0,12582,6.0,7501,1367,46478
321,10/31/2021,461,476981,48,232961,73,212218,2.0,34113,6.0,36130,6.0,11986,61,180143,4.0,12586,2.0,7503,338,46816
322,11/1/2021,1249,478230,138,233099,215,212433,10.0,34123,10.0,36140,9.0,11995,176,180319,12.0,12598,18.0,7521,901,47717
323,11/2/2021,1822,480052,130,233229,202,212635,8.0,34131,17.0,36157,14.0,12009,163,180482,14.0,12612,11.0,7532,1505,49222
324,11/3/2021,1742,481794,159,233388,229,212864,12.0,34143,17.0,36174,15.0,12024,181,180663,16.0,12628,17.0,7549,1368,50590
325,11/4/2021,1409,483203,144,233532,182,213046,4.0,34147,13.0,36187,1.0,12025,158,180821,12.0,12640,11.0,7560,1107,51697
326,11/5/2021,2019,485222,225,233757,297,213343,14.0,34161,12.0,36199,18.0,12043,250,181071,14.0,12654,15.0,7575,1529,53226
327,11/6/2021,1580,486802,215,233972,143,213486,4.0,34165,7.0,36206,6.0,12049,116,181187,15.0,12669,6.0,7581,1228,54454
328,11/7/2021,532,487334,123,234095,77,213563,1.0,34166,8.0,36214,4.0,12053,64,181251,3.0,12672,6.0,7587,331,54785
329,11/8/2021,1526,488860,386,234481,198,213761,7.0,34173,9.0,36223,11.0,12064,164,181415,9.0,12681,14.0,7601,960,55745
330,11/9/2021,2637,491497,941,235422,222,213983,10.0,34183,21.0,36244,15.0,12079,163,181578,17.0,12698,27.0,7628,1492,57237
331,11/10/2021,2492,493989,819,236241,222,214205,11.0,34194,16.0,36260,12.0,12091,175,181753,22.0,12720,13.0,7641,1473,58710
332,11/11/2021,2348,496337,965,237206,185,214390,17.0,34211,8.0,36268,13.0,12104,151,181904,13.0,12733,8.0,7649,1217,59927
333,11/12/2021,2555,498892,756,237962,240,214630,12.0,34223,19.0,36287,23.0,12127,191,182095,14.0,12747,12.0,7661,1570,61497
334,11/13/2021,1926,500818,404,238366,140,214770,4.0,34227,12.0,36299,7.0,12134,104,182199,15.0,12762,14.0,7675,1390,62887
335,11/14/2021,1483,502301,909,239275,107,214877,1.0,34228,2.0,36301,11.0,12145,72,182271,14.0,12776,10.0,7685,476,63363
336,11/15/2021,1955,504256,449,239724,199,215076,7.0,34235,11.0,36312,12.0,12157,159,182430,12.0,12788,16.0,7701,1328,64691
337,11/16/2021,2402,506658,454,240178,211,215287,6.0,34241,21.0,36333,26.0,12183,154,182584,17.0,12805,14.0,7715,1749,66440
338,11/17/2021,2728,509386,636,240814,268,215555,12.0,34253,17.0,36350,16.0,12199,220,182804,18.0,12823,14.0,7729,1854,68294
339,11/18/2021,1893,511279,376,241190,178,215733,7.0,34260,10.0,36360,15.0,12214,143,182947,15.0,12838,5.0,7734,1354,69648
340,11/19/2021,2564,513843,714,241904,282,216015,13.0,34273,15.0,36375,9.0,12223,235,183182,20.0,12858,18.0,7752,1588,71236
341,11/20/2021,1885,515728,536,242440,114,216129,6.0,34279,5.0,36380,8.0,12231,97,183279,4.0,12862,5.0,7757,1238,72474
342,11/21/2021,639,516367,123,242563,86,216215,0.0,34279,1.0,36381,3.0,12234,70,183349,8.0,12870,5.0,7762,433,72907
343,11/22/2021,1975,518342,422,242985,208,216423,11.0,34290,21.0,36402,10.0,12244,168,183517,12.0,12882,18.0,7780,1365,74272
344,11/23/2021,1842,520184,286,243271,187,216610,8.0,34298,15.0,36417,15.0,12259,151,183668,14.0,12896,7.0,7787,1378,75650
345,11/24/2021,1514,521698,212,243483,166,216776,6.0,34304,11.0,36428,14.0,12273,134,183802,12.0,12908,6.0,7793,1151,76801
346,11/25/2021,46,521744,9,243492,2,216778,0.0,34304,0.0,36428,0.0,12273,1,183803,1.0,12909,,7793,35,76836
347,11/26/2021,1262,523006,194,243686,202,216980,3.0,34307,5.0,36433,17.0,12290,163,183966,12.0,12921,10.0,7803,885,77721
348,11/27/2021,955,523961,135,243821,154,217134,2.0,34309,2.0,36435,8.0,12298,131,184097,8.0,12929,7.0,7810,668,78389
349,11/28/2021,537,524498,93,243914,105,217239,2.0,34311,2.0,36437,9.0,12307,84,184181,5.0,12934,7.0,7817,345,78734
350,11/29/2021,1844,526342,271,244185,412,217651,8.0,34319,13.0,36450,29.0,12336,343,184524,25.0,12959,15.0,7832,1182,79916
351,11/30/2021,2666,529008,336,244521,789,218440,8.0,34327,11.0,36461,51.0,12387,665,185189,61.0,13020,12.0,7844,1561,81477
352,12/1/2021,2461,531957,269,244919,754,218914,13.0,34146,11.0,36490,30.0,12424,662,185558,56.0,13083,6.0,7849,1450,82861
353,12/2/2021,2842,534799,355,245274,924,219838,11.0,34157,14.0,36504,69.0,12493,750,186308,75.0,13158,30.0,7879,1592,84453
354,12/3/2021,2599,537398,279,245553,759,220597,11.0,34168,4.0,36508,61.0,12554,600,186908,70.0,13228,28.0,7907,1581,86034
355,12/4/2021,2192,539590,160,245713,419,221016,4.0,34172,1.0,36509,24.0,12578,327,187235,37.0,13265,31.0,7938,1620,87654
356,12/5/2021,1380,540970,98,245811,845,221861,1.0,34173,0.0,36509,68.0,12646,671,187906,71.0,13336,35.0,7973,446,88100
357,12/6/2021,1939,542909,236,246047,472,222333,7.0,34180,6.0,36515,53.0,12699,370,188276,33.0,13369,16.0,7989,1244,89344
358,12/7/2021,2467,545376,307,246354,470,222803,10.0,34190,8.0,36523,48.0,12747,374,188650,31.0,13400,17.0,8006,1709,91053
359,12/8/2021,2247,547623,270,246624,518,223321,9.0,34199,13.0,36536,32.0,12779,434,189084,39.0,13439,13.0,8019,1478,92531
360,12/9/2021,2165,549788,304,246928,461,223782,6.0,34205,8.0,36544,27.0,12806,357,189441,43.0,13482,34.0,8053,1413,93944
361,12/10/2021,2096,551884,237,247165,406,224188,10.0,34215,8.0,36552,38.0,12844,315,189756,31.0,13513,22.0,8075,1462,95406
362,12/11/2021,1789,553673,137,247302,494,224682,6.0,34221,1.0,36553,61.0,12905,367,190123,41.0,13554,25.0,8100,1160,96566
363,12/12/2021,421,554094,55,247357,87,224769,1.0,34222,3.0,36556,4.0,12909,70,190193,7.0,13561,6.0,8106,281,96847
364,12/13/2021,1762,555856,298,247655,400,225169,9.0,34231,8.0,36564,27.0,12936,322,190515,37.0,13598,14.0,8120,1082,97929
365,12/14/2021,2205,558061,277,247932,367,225536,7.0,34238,5.0,36569,33.0,12969,300,190815,17.0,13615,17.0,8137,1587,99516
366,12/15/2021,1752,559813,202,248134,231,225767,5.0,34243,4.0,36573,9.0,12978,187,191002,20.0,13635,15.0,8152,1334,100850
367,12/16/2021,1790,561603,311,248445,252,226019,7.0,34250,8.0,36581,18.0,12996,210,191212,14.0,13649,10.0,8162,1245,102095
368,12/17/2021,2127,563730,308,248753,447,226466,6.0,34256,9.0,36590,28.0,13024,367,191579,41.0,13690,11.0,8173,1382,103477
369,12/18/2021,1813,565543,175,248928,246,226712,4.0,34260,4.0,36594,17.0,13041,211,191790,10.0,13700,8.0,8181,1391,104868
370,12/19/2021,439,565982,43,248971,80,226792,1.0,34261,3.0,36597,5.0,13046,67,191857,4.0,13704,4.0,8185,316,105184
371,12/20/2021,1566,567548,203,249174,246,227038,10.0,34271,9.0,36606,28.0,13074,196,192053,16.0,13720,6.0,8191,1122,106306
372,12/21/2021,2205,569753,312,249486,294,227332,10.0,34281,9.0,36615,28.0,13102,228,192281,24.0,13744,14.0,8205,1609,107915
373,12/22/2021,1897,571650,221,249707,291,227623,5.0,34286,9.0,36624,29.0,13131,229,192510,24.0,13768,9.0,8214,1387,109302
374,12/23/2021,1246,572896,214,249921,209,227832,5.0,34291,3.0,36627,22.0,13153,157,192667,17.0,13785,13.0,8227,836,110138
375,12/24/2021,322,573218,45,249966,62,227894,2.0,34293,2.0,36629,4.0,13157,53,192720,4.0,13789,1.0,8228,217,110355
376,12/25/2021,15,573233,4,249970,2,227896,0.0,34293,0.0,36629,,13157,1,192721,1.0,13790,,8228,9,110364
377,12/26/2021,361,573594,59,250029,70,227966,1.0,34294,0.0,36629,8.0,13165,54,192775,5.0,13795,3.0,8231,234,110598
378,12/27/2021,1278,574872,181,250210,225,228191,3.0,34297,5.0,36634,17.0,13182,179,192954,20.0,13815,9.0,8240,877,111475
379,12/28/2021,1916,576788,276,250486,300,228491,12.0,34309,11.0,36645,35.0,13217,232,193186,17.0,13832,16.0,8256,1343,112818
380,12/29/2021,1708,578496,212,250698,253,228744,5.0,34314,7.0,36652,28.0,13245,192,193378,22.0,13854,11.0,8267,1253,114071
381,12/30/2021,1378,579874,223,250921,244,228988,7.0,34321,9.0,36661,27.0,13272,189,193567,15.0,13869,13.0,8280,922,114993
382,12/31/2021,512,580386,97,251018,91,229079,0.0,34321,2.0,36663,7.0,13279,74,193641,5.0,13874,5.0,8285,327,115320
383,1/1/2022,93,580479,12,251030,16,229095,1.0,34322,1.0,36664,0.0,13279,13,193654,2.0,13876,1.0,8286,65,115385
384,1/2/2022,318,580797,46,251076,58,229153,1.0,34323,1.0,36665,7.0,13286,40,193694,8.0,13884,3.0,8289,215,115600
385,1/3/2022,1608,582405,327,251403,348,229501,4.0,34327,5.0,36670,34.0,13320,283,193977,21.0,13905,10.0,8299,943,116543
386,1/4/2022,1686,584091,265,251668,281,229782,10.0,34337,7.0,36677,30.0,13350,222,194199,18.0,13923,11.0,8310,1153,117696
387,1/5/2022,1333,585424,204,251872,200,229982,7.0,34344,8.0,36685,13.0,13363,164,194363,9.0,13932,14.0,8324,942,118638
388,1/6/2022,1234,586658,254,252126,231,230213,4.0,34348,4.0,36689,25.0,13388,172,194535,13.0,13945,21.0,8345,757,119395
389,1/7/2022,2064,588722,254,252380,343,230556,7.0,34355,8.0,36697,35.0,13423,265,194800,30.0,13975,13.0,8358,1479,120874
390,1/8/2022,1583,590305,125,252505,128,230684,0.0,34355,3.0,36700,7.0,13430,107,194907,7.0,13982,7.0,8365,1334,122208
391,1/9/2022,505,590810,90,252595,76,230760,0.0,34355,2.0,36702,15.0,13445,52,194959,3.0,13985,6.0,8371,339,122547
392,1/10/2022,1571,592381,295,252890,252,231012,3.0,34358,7.0,36709,19.0,13464,197,195156,27.0,14012,9.0,8380,1034,123581
393,1/11/2022,1573,593954,224,253114,278,231290,3.0,34361,4.0,36713,32.0,13496,212,195368,15.0,14027,19.0,8399,1084,124665
394,1/12/2022,1405,595359,178,253292,185,231475,6.0,34367,5.0,36718,27.0,13523,129,195497,20.0,14047,9.0,8408,1054,125719
395,1/13/2022,1110,596469,195,253487,175,231650,2.0,34369,2.0,36720,13.0,13536,130,195627,18.0,14065,14.0,8422,748,126467
396,1/14/2022,1631,598100,275,253762,217,231867,2.0,34371,8.0,36728,24.0,13560,160,195787,20.0,14085,13.0,8435,1155,127622
397,1/15/2022,1216,599316,135,253897,101,231968,1.0,34372,3.0,36731,10.0,13570,80,195867,9.0,14094,2.0,8437,981,128603
398,1/16/2022,291,599607,47,253944,36,232004,1.0,34373,0.0,36731,1.0,13571,32,195899,3.0,14097,0.0,8437,208,128811
399,1/17/2022,794,600401,161,254105,133,232137,5.0,34378,5.0,36736,13.0,13584,108,196007,9.0,14106,3.0,8440,502,129313
400,1/18/2022,887,601288,159,254264,165,232302,2.0,34380,5.0,36741,26.0,13610,125,196132,7.0,14113,7.0,8447,569,129882
401,1/19/2022,727,602015,121,254385,120,232422,3.0,34383,7.0,36748,10.0,13620,88,196220,10.0,14123,12.0,8459,498,130380
402,1/20/2022,793,602808,144,254529,147,232569,0.0,34383,11.0,36759,17.0,13637,110,196330,10.0,14133,10.0,8469,509,130889
403,1/21/2022,1180,603988,166,254695,171,232740,7.0,34390,2.0,36761,15.0,13652,134,196464,11.0,14144,11.0,8480,851,131740
404,1/22/2022,792,604780,87,254782,105,232845,0.0,34390,1.0,36762,14.0,13666,75,196539,7.0,14151,9.0,8489,600,132340
405,1/23/2022,211,604991,22,254804,54,232899,1.0,34391,0.0,36762,6.0,13672,41,196580,7.0,14158,0.0,8489,136,132476
406,1/24/2022,494,605485,77,254881,108,233007,1.0,34392,1.0,36763,14.0,13686,79,196659,8.0,14166,7.0,8496,312,132788
407,1/25/2022,666,606151,116,254997,146,233153,3.0,34395,2.0,36765,15.0,13701,103,196762,21.0,14187,7.0,8503,405,133193
408,1/26/2022,647,606798,100,255097,141,233294,8.0,34403,2.0,36767,13.0,13714,107,196869,13.0,14200,8.0,8511,415,133608
409,1/27/2022,624,607422,117,255214,174,233468,5.0,34408,1.0,36768,30.0,13744,128,196997,10.0,14210,6.0,8517,339,133947
410,1/28/2022,974,608396,164,255378,170,233638,6.0,34414,6.0,36774,20.0,13764,118,197115,16.0,14226,16.0,8533,643,134590
411,1/29/2022,564,608960,67,255445,90,233728,1.0,34415,4.0,36778,10.0,13774,67,197182,9.0,14235,4.0,8537,407,134997
412,1/30/2022,194,609154,33,255478,46,233774,1.0,34416,1.0,36779,14.0,13788,28,197210,1.0,14236,3.0,8540,117,135114
413,1/31/2022,562,609716,135,255613,123,233897,3.0,34419,2.0,36781,17.0,13805,83,197293,13.0,14249,10.0,8550,306,135420
414,2/1/2022,554,610270,100,255713,139,234036,1.0,34420,4.0,36785,20.0,13825,102,197395,11.0,14260,6.0,8556,317,135737
415,2/2/2022,130,610400,20,255733,46,234082,0.0,34420,1.0,36786,2.0,13827,41,197436,2.0,14262,1.0,8557,67,135804
416,2/3/2022,375,610775,78,255811,118,234200,1.0,34421,3.0,36789,24.0,13851,83,197519,6.0,14268,5.0,8562,184,135988
417,2/4/2022,649,611424,114,255925,150,234350,7.0,34428,5.0,36794,17.0,13868,118,197637,9.0,14277,6.0,8568,389,136377
418,2/5/2022,461,611885,59,255984,114,234464,2.0,34430,0.0,36794,7.0,13875,92,197729,6.0,14283,9.0,8577,290,136667
419,2/6/2022,124,612009,20,256004,34,234498,0.0,34430,1.0,36795,1.0,13876,23,197752,6.0,14289,4.0,8581,71,136738
420,2/7/2022,362,612371,61,256065,110,234608,0.0,34430,0.0,36795,12.0,13888,85,197837,5.0,14294,8.0,8589,193,136931
421,2/8/2022,448,612819,86,256151,120,234728,1.0,34431,3.0,36798,19.0,13907,87,197924,5.0,14299,9.0,8598,252,137183
422,2/9/2022,354,613173,63,256214,97,234825,3.0,34434,1.0,36799,18.0,13925,64,197988,3.0,14302,12.0,8610,196,137379
423,2/10/2022,381,613554,86,256300,89,234914,1.0,34435,3.0,36802,15.0,13940,60,198048,8.0,14310,6.0,8616,207,137586
424,2/11/2022,554,614108,93,256393,161,235075,4.0,34439,1.0,36803,28.0,13968,110,198158,10.0,14320,13.0,8629,305,137891
425,2/12/2022,251,614359,41,256434,50,235125,0.0,34439,0.0,36803,5.0,13973,38,198196,5.0,14325,2.0,8631,162,138053
426,2/13/2022,79,614438,21,256455,17,235142,0.0,34439,1.0,36804,0.0,13973,11,198207,4.0,14329,2.0,8633,43,138096
427,2/14/2022,239,614677,40,256495,53,235195,4.0,34443,2.0,36806,8.0,13981,39,198246,2.0,14331,4.0,8637,148,138244
428,2/15/2022,309,614986,47,256542,94,235289,0.0,34443,0.0,36806,16.0,13997,64,198310,7.0,14338,7.0,8644,171,138415
429,2/16/2022,229,615215,41,256583,66,235355,3.0,34446,1.0,36807,12.0,14009,46,198356,5.0,14343,3.0,8647,125,138540
430,2/17/2022,168,615383,30,256613,47,235402,1.0,34447,1.0,36808,8.0,14017,34,198390,4.0,14347,1.0,8648,94,138634
431,2/18/2022,491,615874,106,256719,112,235514,3.0,34450,3.0,36811,14.0,14031,67,198457,20.0,14367,11.0,8659,273,138907
432,2/19/2022,215,616089,27,256746,61,235575,0.0,34450,0.0,36811,12.0,14043,41,198498,2.0,14369,6.0,8665,129,139036
433,2/20/2022,75,616164,18,256764,16,235591,0.0,34450,0.0,36811,0.0,14043,14,198512,0.0,14369,2.0,8667,42,139078
434,2/21/2022,251,616415,57,256821,75,235666,2.0,34452,1.0,36812,17.0,14060,49,198561,5.0,14374,4.0,8671,124,139202
435,2/22/2022,264,616679,46,256867,85,235751,5.0,34457,0.0,36812,7.0,14067,65,198626,4.0,14378,9.0,8680,137,139339
436,2/23/2022,214,616893,45,256912,47,235798,1.0,34458,0.0,36812,4.0,14071,33,198659,6.0,14384,4.0,8684,122,139461
437,2/24/2022,200,617093,31,256943,51,235849,0.0,34458,1.0,36813,9.0,14080,33,198692,2.0,14386,7.0,8691,120,139581
438,2/25/2022,317,617410,55,256998,103,235952,2.0,34460,0.0,36813,13.0,14093,69,198761,13.0,14399,8.0,8699,162,139743
439,2/26/2022,186,617596,26,257024,48,236000,2.0,34462,1.0,36814,2.0,14095,36,198797,6.0,14405,4.0,8703,113,139856
440,2/27/2022,72,617668,15,257039,21,236021,0.0,34462,1.0,36815,2.0,14097,15,198812,3.0,14408,1.0,8704,36,139892
441,2/28/2022,176,617844,48,257087,44,236065,0.0,34462,0.0,36815,9.0,14106,23,198835,5.0,14413,7.0,8711,85,139977
442,3/1/2022,198,618042,29,257116,55,236120,3.0,34465,2.0,36817,4.0,14110,49,198884,2.0,14415,0.0,8711,119,140096
443,3/2/2022,152,618194,28,257144,39,236159,2.0,34467,0.0,36817,4.0,14114,23,198907,7.0,14422,5.0,8716,87,140183
444,3/3/2022,172,618366,35,257179,45,236204,4.0,34471,2.0,36819,10.0,14124,29,198936,3.0,14425,3.0,8719,93,140276
445,3/4/2022,341,618707,54,257233,81,236285,4.0,34475,5.0,36824,16.0,14140,54,198990,4.0,14429,7.0,8726,211,140487
446,3/5/2022,125,618832,23,257256,22,236307,0.0,34475,0.0,36824,4.0,14144,17,199007,1.0,14430,0.0,8726,80,140567
447,3/6/2022,75,618907,28,257284,25,236332,0.0,34475,0.0,36824,4.0,14148,16,199023,2.0,14432,3.0,8729,22,140589
448,3/7/2022,147,619054,27,257311,31,236363,1.0,34476,0.0,36824,9.0,14157,16,199039,2.0,14434,4.0,8733,89,140678
449,3/8/2022,207,619261,31,257342,42,236405,0.0,34476,2.0,36826,5.0,14162,29,199068,3.0,14437,5.0,8738,134,140812
450,3/9/2022,91,619352,11,257353,21,236426,1.0,34477,2.0,36828,3.0,14165,16,199084,1.0,14438,1.0,8739,60,140872
451,3/10/2022,100,619452,29,257382,25,236451,1.0,34478,0.0,36828,1.0,14166,21,199105,1.0,14439,2.0,8741,48,140920
452,3/11/2022,235,619687,39,257421,81,236532,5.0,34483,1.0,36829,16.0,14182,50,199155,9.0,14448,6.0,8747,117,141037
453,3/12/2022,123,619810,23,257444,28,236560,1.0,34484,1.0,36830,1.0,14183,24,199179,1.0,14449,2.0,8749,72,141109
454,3/13/2022,42,619852,5,257449,11,236571,0.0,34484,0.0,36830,0.0,14183,9,199188,2.0,14451,0.0,8749,27,141136
455,3/14/2022,125,619977,14,257463,45,236616,1.0,34485,0.0,36830,7.0,14190,29,199217,8.0,14459,1.0,8750,66,141202
456,3/15/2022,159,620136,30,257493,24,236640,1.0,34486,2.0,36832,5.0,14195,12,199229,5.0,14464,2.0,8752,108,141310
457,3/16/2022,125,620261,28,257521,37,236677,1.0,34487,1.0,36833,4.0,14199,25,199254,4.0,14468,4.0,8756,63,141373
458,3/17/2022,96,620357,20,257541,17,236694,0.0,34487,0.0,36833,2.0,14201,13,199267,2.0,14470,0.0,8756,59,141432
459,3/18/2022,261,620618,20,257561,49,236743,3.0,34490,1.0,36834,3.0,14204,36,199303,8.0,14478,2.0,8758,193,141625
460,3/19/2022,110,620728,7,257568,18,236761,2.0,34492,0.0,36834,3.0,14207,10,199313,3.0,14481,2.0,8760,85,141710
461,3/20/2022,46,620774,5,257573,9,236770,0.0,34492,0.0,36834,,14207,9,199322,0.0,14481,0.0,8760,32,141742
462,3/21/2022,105,620879,8,257581,33,236803,0.0,34492,0.0,36834,6.0,14213,16,199338,6.0,14487,5.0,8765,65,141807
463,3/22/2022,154,621033,13,257594,21,236824,2.0,34494,1.0,36835,1.0,14214,17,199355,1.0,14488,2.0,8767,121,141928
464,3/23/2022,105,621138,7,257601,32,236856,0.0,34494,0.0,36835,4.0,14218,22,199377,4.0,14492,2.0,8769,67,141995
465,3/24/2022,104,621242,15,257616,27,236883,1.0,34495,2.0,36837,6.0,14224,19,199396,1.0,14493,1.0,8770,63,142058
466,3/25/2022,207,621449,25,257641,35,236918,0.0,34495,1.0,36838,6.0,14230,26,199422,1.0,14494,2.0,8772,149,142207
467,3/26/2022,80,621529,3,257644,8,236926,0.0,34495,0.0,36838,0.0,14230,8,199430,0.0,14494,0.0,8772,69,142276
