,Date,daily number of doses received by Larimer County residents,total number of doses recevied by residents,daily number of residents receiving first dose,total number of residents receiving first dose,daily number of residents vaccinated,total number of residents vaccinated,daily number of 70+ vaccinated,total number of 70+ vaccinated,daily number of 70+ at least one dose,total number of 70+ at least one dose,daily number of Latinx residents vaccinated,total of Latinx residents vaccinated,daily number of White non-Latinx residents vaccinated,total of White non-Latinx residents vaccinated,daily number of non-White non-Latinx residents vaccinated,total of non-White non-Latinx residents vaccinated,dailyUnknown,totalUnknown,daily_additional_doses,total_additional_doses
0,12/14/2020,32,32,32,32,1,1,0.0,0,1.0,1,0.0,0,1,1,0.0,0,,0,0,0
1,12/15/2020,14,46,14,46,0,1,,0,,1,,0,0,1,0.0,0,,0,0,0
2,12/16/2020,305,351,305,351,0,1,0.0,0,2.0,3,0.0,0,0,1,0.0,0,0.0,0,0,0
3,12/17/2020,990,1341,990,1341,0,1,0.0,0,11.0,14,0.0,0,0,1,0.0,0,0.0,0,0,0
4,12/18/2020,1055,2396,1055,2396,2,3,0.0,0,15.0,29,0.0,0,2,3,0.0,0,0.0,0,0,0
5,12/19/2020,721,3117,721,3117,0,3,0.0,0,14.0,43,0.0,0,0,3,0.0,0,0.0,0,0,0
6,12/20/2020,266,3383,266,3383,0,3,0.0,0,4.0,47,0.0,0,0,3,0.0,0,0.0,0,0,0
7,12/21/2020,358,3741,358,3741,3,6,0.0,0,3.0,50,0.0,0,3,6,0.0,0,0.0,0,0,0
8,12/22/2020,364,4105,364,4105,0,6,0.0,0,7.0,57,0.0,0,0,6,0.0,0,0.0,0,0,0
9,12/23/2020,440,4545,440,4545,0,6,0.0,0,6.0,63,0.0,0,0,6,0.0,0,0.0,0,0,0
10,12/24/2020,105,4650,105,4650,0,6,0.0,0,3.0,66,0.0,0,0,6,0.0,0,0.0,0,0,0
11,12/25/2020,1,4651,1,4651,0,6,,0,,66,,0,0,6,,0,,0,0,0
12,12/26/2020,228,4879,228,4879,1,7,0.0,0,3.0,69,0.0,0,1,7,0.0,0,0.0,0,0,0
13,12/27/2020,278,5157,278,5157,0,7,0.0,0,197.0,266,0.0,0,0,7,0.0,0,,0,0,0
14,12/28/2020,707,5864,707,5864,0,7,0.0,0,385.0,651,0.0,0,0,7,0.0,0,0.0,0,0,0
15,12/29/2020,913,6777,912,6776,1,8,0.0,0,461.0,1112,0.0,0,1,8,0.0,0,0.0,0,0,0
16,12/30/2020,882,7659,882,7658,0,8,0.0,0,273.0,1385,0.0,0,0,8,0.0,0,0.0,0,0,0
17,12/31/2020,895,8554,895,8553,0,8,0.0,0,343.0,1728,0.0,0,0,8,0.0,0,0.0,0,0,0
18,1/1/2021,4,8558,3,8556,1,9,,0,,1728,,0,1,9,,0,,0,0,0
19,1/2/2021,394,8952,394,8950,1,10,0.0,0,141.0,1869,0.0,0,1,10,0.0,0,0.0,0,0,0
20,1/3/2021,123,9075,123,9073,0,10,0.0,0,52.0,1921,0.0,0,0,10,0.0,0,0.0,0,0,0
21,1/4/2021,588,9663,575,9648,12,22,0.0,0,320.0,2241,0.0,0,10,20,2.0,2,0.0,0,0,0
22,1/5/2021,646,10309,637,10285,10,32,0.0,0,409.0,2650,0.0,0,9,29,1.0,3,0.0,0,0,0
23,1/6/2021,1233,11542,914,11199,314,346,4.0,4,515.0,3165,18.0,18,275,304,17.0,20,4.0,4,0,0
24,1/7/2021,1657,13199,702,11901,939,1285,12.0,16,406.0,3571,34.0,52,849,1153,41.0,61,15.0,19,0,0
25,1/8/2021,1989,15188,980,12881,995,2280,11.0,27,478.0,4049,48.0,100,884,2037,44.0,105,19.0,38,1,1
26,1/9/2021,1227,16415,527,13408,688,2968,14.0,41,302.0,4351,16.0,116,623,2660,37.0,142,12.0,50,0,1
27,1/10/2021,702,17117,427,13835,272,3240,4.0,45,260.0,4611,10.0,126,245,2905,14.0,156,3.0,53,0,1
28,1/11/2021,1149,18266,798,14633,348,3588,1.0,46,536.0,5147,10.0,136,316,3221,19.0,175,3.0,56,0,1
29,1/12/2021,1177,19443,879,15512,297,3885,8.0,54,517.0,5664,14.0,150,257,3478,18.0,193,8.0,64,1,2
30,1/13/2021,1078,20521,832,16344,244,4129,1.0,55,376.0,6040,23.0,173,198,3676,15.0,208,8.0,72,0,2
31,1/14/2021,870,21391,835,17179,35,4164,1.0,56,494.0,6534,2.0,175,31,3707,1.0,209,1.0,73,0,2
32,1/15/2021,1219,22610,1207,18386,12,4176,0.0,56,760.0,7294,0.0,175,12,3719,0.0,209,0.0,73,0,2
33,1/16/2021,986,23596,972,19358,14,4190,1.0,57,585.0,7879,0.0,175,13,3732,1.0,210,0.0,73,0,2
34,1/17/2021,52,23648,48,19406,4,4194,0.0,57,19.0,7898,0.0,175,2,3734,2.0,212,0.0,73,0,2
35,1/18/2021,1017,24665,815,20221,200,4394,48.0,105,601.0,8499,8.0,183,174,3908,13.0,225,5.0,78,2,4
36,1/19/2021,1255,25920,1115,21336,138,4532,8.0,113,736.0,9235,7.0,190,118,4026,6.0,231,7.0,85,0,4
37,1/20/2021,1422,27342,1202,22538,218,4750,17.0,130,569.0,9804,15.0,205,177,4203,9.0,240,17.0,102,1,5
38,1/21/2021,2250,29592,2041,24579,209,4959,7.0,137,1587.0,11391,13.0,218,174,4377,15.0,255,7.0,109,0,5
39,1/22/2021,1737,31329,1461,26040,275,5234,90.0,227,1091.0,12482,34.0,252,222,4599,13.0,268,6.0,115,0,5
40,1/23/2021,896,32225,560,26600,335,5569,58.0,285,416.0,12898,8.0,260,306,4905,13.0,281,8.0,123,0,5
41,1/24/2021,393,32618,104,26704,286,5855,206.0,491,61.0,12959,8.0,268,269,5174,9.0,290,,123,0,5
42,1/25/2021,1404,34022,784,27488,611,6466,361.0,852,554.0,13513,14.0,282,570,5744,15.0,305,12.0,135,0,5
43,1/26/2021,1621,35643,690,28178,921,7387,456.0,1308,441.0,13954,30.0,312,846,6590,32.0,337,13.0,148,0,5
44,1/27/2021,1839,37482,771,28949,1064,8451,537.0,1845,334.0,14288,39.0,351,970,7560,45.0,382,10.0,158,0,5
45,1/28/2021,1343,38825,537,29486,803,9254,356.0,2201,294.0,14582,25.0,376,734,8294,28.0,410,16.0,174,2,7
46,1/29/2021,1632,40457,1154,30640,475,9729,157.0,2358,825.0,15407,21.0,397,412,8706,32.0,442,10.0,184,0,7
47,1/30/2021,1230,41687,735,31375,491,10220,213.0,2571,599.0,16006,24.0,421,441,9147,20.0,462,6.0,190,0,7
48,1/31/2021,622,42309,398,31773,223,10443,76.0,2647,353.0,16359,5.0,426,197,9344,15.0,477,6.0,196,1,8
49,2/1/2021,1606,43915,902,32675,704,11147,469.0,3116,656.0,17015,17.0,443,650,9994,27.0,504,10.0,206,1,9
50,2/2/2021,1863,45778,729,33404,1133,12280,737.0,3853,582.0,17597,43.0,486,1045,11039,34.0,538,11.0,217,0,9
51,2/3/2021,1263,47041,583,33987,677,12957,320.0,4173,226.0,17823,48.0,534,577,11616,41.0,579,11.0,228,0,9
52,2/4/2021,2532,49573,1791,35778,737,13694,494.0,4667,1549.0,19372,29.0,563,661,12277,37.0,616,10.0,238,1,10
53,2/5/2021,2576,52149,1530,37308,1036,14730,684.0,5351,1305.0,20677,38.0,601,951,13228,29.0,645,18.0,256,2,12
54,2/6/2021,2217,54366,1597,38905,614,15344,443.0,5794,1241.0,21918,7.0,608,583,13811,22.0,667,2.0,258,0,12
55,2/7/2021,232,54598,89,38994,141,15485,94.0,5888,26.0,21944,7.0,615,125,13936,4.0,671,5.0,263,1,13
56,2/8/2021,2485,57083,1597,40591,886,16371,601.0,6489,1139.0,23083,26.0,641,815,14751,28.0,699,17.0,280,0,13
57,2/9/2021,2386,59469,1541,42132,843,17214,514.0,7003,993.0,24076,25.0,666,758,15509,32.0,731,28.0,308,0,13
58,2/10/2021,1586,61055,967,43099,615,17829,321.0,7324,288.0,24364,26.0,692,547,16056,26.0,757,16.0,324,4,17
59,2/11/2021,3530,64585,1998,45097,1525,19354,1055.0,8379,808.0,25172,55.0,747,1395,17451,49.0,806,26.0,350,1,18
60,2/12/2021,3263,67848,1810,46907,1443,20797,953.0,9332,800.0,25972,62.0,809,1326,18777,42.0,848,13.0,363,0,18
61,2/13/2021,2997,70845,2363,49270,628,21425,309.0,9641,672.0,26644,14.0,823,580,19357,23.0,871,11.0,374,1,19
62,2/14/2021,421,71266,350,49620,71,21496,49.0,9690,45.0,26689,2.0,825,64,19421,3.0,874,2.0,376,0,19
63,2/15/2021,2623,73889,2130,51750,491,21987,325.0,10015,256.0,26945,17.0,842,460,19881,12.0,886,2.0,378,0,19
64,2/16/2021,2747,76636,1917,53667,825,22812,499.0,10514,231.0,27176,35.0,877,750,20631,24.0,910,16.0,394,0,19
65,2/17/2021,1633,78269,656,54323,973,23785,480.0,10994,155.0,27331,29.0,906,888,21519,36.0,946,20.0,414,0,19
66,2/18/2021,2639,80908,1673,55996,957,24742,734.0,11728,275.0,27606,37.0,943,881,22400,30.0,976,9.0,423,1,20
67,2/19/2021,2424,83332,1030,57026,1379,26121,1019.0,12747,155.0,27761,45.0,988,1276,23676,43.0,1019,15.0,438,3,23
68,2/20/2021,1650,84982,687,57713,960,27081,785.0,13532,134.0,27895,22.0,1010,900,24576,28.0,1047,10.0,448,1,24
69,2/21/2021,108,85090,40,57753,67,27148,37.0,13569,8.0,27903,1.0,1011,64,24640,2.0,1049,0.0,448,0,24
70,2/22/2021,2021,87111,761,58514,1249,28397,925.0,14494,146.0,28049,37.0,1048,1165,25805,37.0,1086,10.0,458,1,25
71,2/23/2021,1220,88331,516,59030,704,29101,471.0,14965,160.0,28209,20.0,1068,636,26441,35.0,1121,13.0,471,0,25
72,2/24/2021,1408,89739,752,59782,649,29750,276.0,15241,135.0,28344,31.0,1099,594,27035,19.0,1140,5.0,476,1,26
73,2/25/2021,3862,93601,2070,61852,1788,31538,1508.0,16749,351.0,28695,47.0,1146,1688,28723,36.0,1176,17.0,493,0,26
74,2/26/2021,3268,96869,1156,63008,2106,33644,1745.0,18494,200.0,28895,33.0,1179,1985,30708,59.0,1235,29.0,522,2,28
75,2/27/2021,3494,100363,1662,64670,1825,35469,1563.0,20057,544.0,29439,36.0,1215,1711,32419,52.0,1287,26.0,548,1,29
76,2/28/2021,426,100789,357,65027,68,35537,42.0,20099,114.0,29553,2.0,1217,62,32481,2.0,1289,2.0,550,0,29
77,3/1/2021,2817,103606,1342,66369,1469,37006,1078.0,21177,300.0,29853,53.0,1270,1358,33839,46.0,1335,12.0,562,5,34
78,3/2/2021,3256,106862,1727,68096,1522,38528,1052.0,22229,383.0,30236,38.0,1308,1413,35252,44.0,1379,27.0,589,1,35
79,3/3/2021,1658,108520,1092,69188,564,39092,176.0,22405,203.0,30439,32.0,1340,504,35756,24.0,1403,4.0,593,0,35
80,3/4/2021,3002,111522,1581,70769,1423,40515,815.0,23220,171.0,30610,43.0,1383,1307,37063,53.0,1456,20.0,613,25,60
81,3/5/2021,3482,115004,2054,72823,1436,41951,814.0,24034,426.0,31036,38.0,1421,1331,38394,44.0,1500,23.0,636,26,86
82,3/6/2021,4102,119106,2320,75143,1996,43947,757.0,24791,268.0,31304,96.0,1517,1788,40182,78.0,1578,34.0,670,581,667
83,3/7/2021,417,119523,300,75443,126,44073,37.0,24828,20.0,31324,1.0,1518,120,40302,3.0,1581,2.0,672,23,690
84,3/8/2021,2822,122345,1057,76500,1773,45846,261.0,25089,74.0,31398,49.0,1567,1639,41941,62.0,1643,23.0,695,124,814
85,3/9/2021,3175,125520,1649,78149,1542,47388,258.0,25347,96.0,31494,51.0,1618,1402,43343,64.0,1707,25.0,720,73,887
86,3/10/2021,2384,127904,1368,79517,1024,48412,300.0,25647,83.0,31577,54.0,1672,922,44265,32.0,1739,16.0,736,63,950
87,3/11/2021,4174,132078,2378,81895,1803,50215,400.0,26047,135.0,31712,63.0,1735,1653,45918,67.0,1806,20.0,756,77,1027
88,3/12/2021,3946,136024,2576,84471,1393,51608,198.0,26245,67.0,31779,67.0,1802,1240,47158,53.0,1859,33.0,789,69,1096
89,3/13/2021,214,136238,131,84602,99,51707,20.0,26265,7.0,31786,1.0,1803,92,47250,4.0,1863,2.0,791,30,1126
90,3/14/2021,100,136338,60,84662,39,51746,9.0,26274,0.0,31786,1.0,1804,36,47286,1.0,1864,1.0,792,2,1128
91,3/15/2021,896,137234,360,85022,536,52282,85.0,26359,15.0,31801,19.0,1823,493,47779,17.0,1881,7.0,799,19,1147
92,3/16/2021,3287,140521,2115,87137,1177,53459,227.0,26586,45.0,31846,64.0,1887,1050,48829,41.0,1922,22.0,821,30,1177
93,3/17/2021,2904,143425,1785,88922,1124,54583,238.0,26824,88.0,31934,40.0,1927,1030,49859,35.0,1957,19.0,840,31,1208
94,3/18/2021,4001,147426,2089,91011,1924,56507,338.0,27162,91.0,32025,97.0,2024,1742,51601,64.0,2021,21.0,861,21,1229
95,3/19/2021,3002,150428,1751,92762,1252,57759,220.0,27382,42.0,32067,60.0,2084,1127,52728,46.0,2067,19.0,880,16,1245
96,3/20/2021,3079,153507,1963,94725,1118,58877,313.0,27695,54.0,32121,37.0,2121,1006,53734,54.0,2121,21.0,901,36,1281
97,3/21/2021,660,154167,397,95122,265,59142,26.0,27721,5.0,32126,11.0,2132,236,53970,16.0,2137,2.0,903,18,1299
98,3/22/2021,3111,157278,2246,97368,864,60006,188.0,27909,56.0,32182,19.0,2151,795,54765,37.0,2174,13.0,916,26,1325
99,3/23/2021,4440,161718,3567,100935,1177,61183,193.0,28102,75.0,32257,41.0,2192,1048,55813,50.0,2224,38.0,954,484,1809
100,3/24/2021,3162,164880,2427,103362,749,61932,117.0,28219,37.0,32294,40.0,2232,669,56482,26.0,2250,14.0,968,33,1842
101,3/25/2021,5066,169946,3051,106413,2017,63949,313.0,28532,71.0,32365,68.0,2300,1849,58331,69.0,2319,31.0,999,15,1857
102,3/26/2021,4581,174527,2734,109147,1846,65795,328.0,28860,66.0,32431,119.0,2419,1583,59914,113.0,2432,31.0,1030,30,1887
103,3/27/2021,3340,177867,1911,111058,1424,67219,325.0,29185,21.0,32452,49.0,2468,1309,61223,46.0,2478,20.0,1050,5,1892
104,3/28/2021,1169,179036,809,111867,361,67580,92.0,29277,16.0,32468,12.0,2480,331,61554,16.0,2494,2.0,1052,4,1896
105,3/29/2021,3984,183020,2688,114555,1296,68876,229.0,29506,52.0,32520,39.0,2519,1217,62771,27.0,2521,13.0,1065,8,1904
106,3/30/2021,4370,187390,2755,117310,1645,70521,237.0,29743,74.0,32594,55.0,2574,1505,64276,67.0,2588,18.0,1083,45,1949
107,3/31/2021,3571,190961,2556,119866,1049,71570,167.0,29910,47.0,32641,41.0,2615,938,65214,50.0,2638,20.0,1103,29,1978
108,4/1/2021,5106,196067,3330,123196,1787,73357,148.0,30058,76.0,32717,73.0,2688,1635,66849,60.0,2698,19.0,1122,31,2009
109,4/2/2021,4706,200773,2523,125719,2184,75541,245.0,30303,49.0,32766,82.0,2770,1986,68835,91.0,2789,25.0,1147,27,2036
110,4/3/2021,4255,205028,3523,129242,765,76306,94.0,30397,40.0,32806,37.0,2807,679,69514,29.0,2818,20.0,1167,68,2104
111,4/4/2021,371,205399,257,129499,132,76438,6.0,30403,7.0,32813,3.0,2810,116,69630,11.0,2829,2.0,1169,33,2137
112,4/5/2021,4688,210087,3757,133256,955,77393,75.0,30478,47.0,32860,70.0,2880,816,70446,48.0,2877,21.0,1190,92,2229
113,4/6/2021,5163,215250,3033,136289,2319,79712,85.0,30563,58.0,32918,80.0,2960,2056,72502,125.0,3002,58.0,1248,270,2499
114,4/7/2021,4966,220216,3686,139975,2184,81896,59.0,30622,109.0,33027,118.0,3078,1857,74359,135.0,3137,74.0,1322,1153,3652
115,4/8/2021,6686,226902,4510,144485,2879,84775,137.0,30759,123.0,33150,136.0,3214,2526,76885,141.0,3278,76.0,1398,917,4569
116,4/9/2021,5725,232627,3266,147751,3239,88014,77.0,30836,71.0,33221,162.0,3376,2806,79691,182.0,3460,89.0,1487,803,5372
117,4/10/2021,4425,237052,3162,150913,1746,89760,51.0,30887,71.0,33292,99.0,3475,1475,81166,119.0,3579,53.0,1540,512,5884
118,4/11/2021,1037,238089,796,151709,286,90046,5.0,30892,11.0,33303,12.0,3487,239,81405,24.0,3603,11.0,1551,57,5941
119,4/12/2021,5034,243123,3635,155344,2023,92069,76.0,30968,96.0,33399,77.0,3564,1752,83157,133.0,3736,61.0,1612,501,6442
120,4/13/2021,5032,248155,3561,158905,1486,93555,55.0,31023,77.0,33476,70.0,3634,1296,84453,96.0,3832,24.0,1636,21,6463
121,4/14/2021,2956,251111,1439,160344,1511,95066,86.0,31109,26.0,33502,93.0,3727,1315,85768,70.0,3902,33.0,1669,2,6465
122,4/15/2021,4952,256063,2329,162673,2608,97674,102.0,31211,58.0,33560,218.0,3945,2169,87937,161.0,4063,60.0,1729,2,6467
123,4/16/2021,3908,259971,2078,164751,1819,99493,44.0,31255,34.0,33594,67.0,4012,1592,89529,126.0,4189,34.0,1763,4,6471
124,4/17/2021,4584,264555,2404,167155,2166,101659,39.0,31294,57.0,33651,98.0,4110,1884,91413,132.0,4321,52.0,1815,4,6475
125,4/18/2021,1038,265593,407,167562,624,102283,13.0,31307,11.0,33662,42.0,4152,519,91932,33.0,4354,30.0,1845,4,6479
126,4/19/2021,3862,269455,1410,168972,2428,104711,44.0,31351,40.0,33702,165.0,4317,2041,93973,162.0,4516,60.0,1905,5,6484
127,4/20/2021,4701,274156,1869,170841,2819,107530,47.0,31398,69.0,33771,160.0,4477,2401,96374,193.0,4709,65.0,1970,5,6489
128,4/21/2021,3165,277321,709,171550,2447,109977,35.0,31433,31.0,33802,146.0,4623,2059,98433,163.0,4872,79.0,2049,4,6493
129,4/22/2021,4656,281977,1773,173323,2870,112847,46.0,31479,62.0,33864,143.0,4766,2460,100893,193.0,5065,74.0,2123,3,6496
130,4/23/2021,3595,285572,1180,174503,2400,115247,41.0,31520,30.0,33894,73.0,4839,2116,103009,128.0,5193,83.0,2206,5,6501
131,4/24/2021,3360,288932,1119,175622,2235,117482,14.0,31534,21.0,33915,103.0,4942,1897,104906,194.0,5387,41.0,2247,6,6507
132,4/25/2021,796,289728,344,175966,451,117933,6.0,31540,6.0,33921,104.0,5046,268,105174,38.0,5425,41.0,2288,1,6508
133,4/26/2021,4357,294085,1114,177080,3236,121169,35.0,31575,30.0,33951,146.0,5192,2783,107957,214.0,5639,93.0,2381,4,6512
134,4/27/2021,3343,297428,1191,178271,2145,123314,37.0,31612,37.0,33988,80.0,5272,1888,109845,134.0,5773,43.0,2424,10,6522
135,4/28/2021,2989,300417,715,178986,2275,125589,45.0,31657,20.0,34008,166.0,5438,1844,111689,196.0,5969,69.0,2493,12,6534
136,4/29/2021,3967,304384,821,179807,3140,128729,67.0,31724,32.0,34040,227.0,5665,2580,114269,225.0,6194,108.0,2601,7,6541
137,4/30/2021,2867,307251,639,180446,2228,130957,44.0,31768,24.0,34064,73.0,5738,1894,116163,198.0,6392,63.0,2664,10,6551
138,5/1/2021,3640,310891,817,181263,2805,133762,35.0,31803,18.0,34082,282.0,6020,2184,118347,200.0,6592,139.0,2803,16,6567
139,5/2/2021,529,311420,233,181496,307,134069,7.0,31810,2.0,34084,11.0,6031,248,118595,38.0,6630,10.0,2813,10,6577
140,5/3/2021,3421,314841,635,182131,2785,136854,46.0,31856,34.0,34118,107.0,6138,2389,120984,212.0,6842,77.0,2890,12,6589
141,5/4/2021,4342,319183,696,182827,3666,140520,67.0,31923,27.0,34145,148.0,6286,3148,124132,258.0,7100,112.0,3002,27,6616
142,5/5/2021,2230,321413,478,183305,1788,142308,63.0,31986,24.0,34169,86.0,6372,1480,125612,141.0,7241,81.0,3083,13,6629
143,5/6/2021,3687,325100,820,184125,2985,145293,100.0,32086,40.0,34209,178.0,6550,2473,128085,198.0,7439,136.0,3219,45,6674
144,5/7/2021,2939,328039,543,184668,2489,147782,44.0,32130,11.0,34220,134.0,6684,2046,130131,211.0,7650,98.0,3317,37,6711
145,5/8/2021,2983,331022,553,185221,2534,150316,45.0,32175,16.0,34236,167.0,6851,2043,132174,194.0,7844,130.0,3447,46,6757
146,5/9/2021,365,331387,140,185361,238,150554,4.0,32179,2.0,34238,10.0,6861,198,132372,20.0,7864,10.0,3457,3,6760
147,5/10/2021,2424,333811,378,185739,2080,152634,60.0,32239,16.0,34254,87.0,6948,1692,134064,205.0,8069,96.0,3553,25,6785
148,5/11/2021,2718,336529,542,186281,2219,154853,92.0,32331,24.0,34278,190.0,7138,1728,135792,204.0,8273,97.0,3650,17,6802
149,5/12/2021,1226,337755,458,186739,820,155673,23.0,32354,14.0,34292,48.0,7186,650,136442,87.0,8360,35.0,3685,23,6825
150,5/13/2021,3250,341005,1030,187769,2236,157909,82.0,32436,25.0,34317,151.0,7337,1821,138263,159.0,8519,105.0,3790,16,6841
151,5/14/2021,2476,343481,1280,189049,1295,159204,51.0,32487,30.0,34347,64.0,7401,1074,139337,102.0,8621,55.0,3845,33,6874
152,5/15/2021,3019,346500,1509,190558,1596,160800,39.0,32526,15.0,34362,114.0,7515,1265,140602,143.0,8764,74.0,3919,24,6898
153,5/16/2021,946,347446,574,191132,405,161205,8.0,32534,8.0,34370,83.0,7598,252,140854,29.0,8793,41.0,3960,10,6908
154,5/17/2021,2447,349893,1210,192342,1308,162513,37.0,32571,27.0,34397,48.0,7646,1098,141952,101.0,8894,61.0,4021,21,6929
155,5/18/2021,2584,352477,1174,193516,1444,163957,44.0,32615,22.0,34419,73.0,7719,1211,143163,83.0,8977,77.0,4098,19,6948
156,5/19/2021,1876,354353,1155,194671,786,164743,24.0,32639,19.0,34438,42.0,7761,636,143799,69.0,9046,39.0,4137,15,6963
157,5/20/2021,1979,356332,923,195594,1100,165843,46.0,32685,27.0,34465,94.0,7855,875,144674,81.0,9127,50.0,4187,17,6980
158,5/21/2021,1627,357959,923,196517,785,166628,18.0,32703,16.0,34481,43.0,7898,627,145301,58.0,9185,57.0,4244,26,7006
159,5/22/2021,1684,359643,791,197308,922,167550,9.0,32712,13.0,34494,122.0,8020,640,145941,74.0,9259,86.0,4330,15,7021
160,5/23/2021,681,360324,343,197651,368,167918,2.0,32714,5.0,34499,68.0,8088,227,146168,18.0,9277,55.0,4385,3,7024
161,5/24/2021,1335,361659,537,198188,850,168768,36.0,32750,20.0,34519,43.0,8131,684,146852,82.0,9359,41.0,4426,19,7043
162,5/25/2021,1231,362890,508,198696,755,169523,22.0,32772,20.0,34539,57.0,8188,569,147421,64.0,9423,65.0,4491,18,7061
163,5/26/2021,966,363856,554,199250,528,170051,17.0,32789,25.0,34564,37.0,8225,416,147837,44.0,9467,31.0,4522,23,7084
164,5/27/2021,1269,365125,657,199907,677,170728,32.0,32821,19.0,34583,54.0,8279,546,148383,50.0,9517,27.0,4549,19,7103
165,5/28/2021,1031,366156,596,200503,479,171207,18.0,32839,22.0,34605,29.0,8308,373,148756,49.0,9566,28.0,4577,17,7120
166,5/29/2021,1018,367174,492,200995,563,171770,18.0,32857,8.0,34613,32.0,8340,443,149199,43.0,9609,45.0,4622,12,7132
167,5/30/2021,331,367505,220,201215,144,171914,5.0,32862,3.0,34616,13.0,8353,104,149303,17.0,9626,10.0,4632,8,7140
168,5/31/2021,339,367844,191,201406,174,172088,8.0,32870,6.0,34622,8.0,8361,139,149442,13.0,9639,14.0,4646,11,7151
169,6/1/2021,966,368810,394,201800,603,172691,27.0,32897,17.0,34639,49.0,8410,461,149903,46.0,9685,47.0,4693,24,7175
170,6/2/2021,719,369529,368,202168,407,173098,16.0,32913,8.0,34647,34.0,8444,322,150225,23.0,9708,28.0,4721,7,7182
171,6/3/2021,1306,370835,523,202691,834,173932,22.0,32935,12.0,34659,46.0,8490,689,150914,57.0,9765,42.0,4763,14,7196
172,6/4/2021,1503,372338,405,203096,1140,175072,16.0,32951,9.0,34668,71.0,8561,951,151865,70.0,9835,48.0,4811,4,7200
173,6/5/2021,1415,373753,357,203453,1086,176158,12.0,32963,6.0,34674,64.0,8625,890,152755,92.0,9927,40.0,4851,9,7209
174,6/6/2021,532,374285,142,203595,399,176557,5.0,32968,3.0,34677,43.0,8668,319,153074,25.0,9952,12.0,4863,10,7219
175,6/7/2021,1192,375477,334,203929,902,177459,14.0,32982,12.0,34689,67.0,8735,720,153794,83.0,10035,32.0,4895,18,7237
176,6/8/2021,1082,376559,252,204181,854,178313,18.0,33000,5.0,34694,57.0,8792,695,154489,67.0,10102,35.0,4930,4,7241
177,6/9/2021,1080,377639,283,204464,843,179156,15.0,33015,12.0,34706,78.0,8870,646,155135,72.0,10174,47.0,4977,12,7253
178,6/10/2021,1310,378949,334,204798,1013,180169,20.0,33035,4.0,34710,92.0,8962,799,155934,67.0,10241,55.0,5032,10,7263
179,6/11/2021,1112,380061,326,205124,829,180998,19.0,33054,13.0,34723,57.0,9019,650,156584,78.0,10319,44.0,5076,9,7272
180,6/12/2021,1042,381103,289,205413,795,181793,15.0,33069,9.0,34732,73.0,9092,615,157199,63.0,10382,44.0,5120,9,7281
181,6/13/2021,372,381475,98,205511,285,182078,4.0,33073,1.0,34733,37.0,9129,204,157403,25.0,10407,19.0,5139,6,7287
182,6/14/2021,830,382305,282,205793,592,182670,15.0,33088,4.0,34737,44.0,9173,449,157852,42.0,10449,57.0,5196,6,7293
183,6/15/2021,695,383000,238,206031,479,183149,20.0,33108,10.0,34747,40.0,9213,389,158241,34.0,10483,16.0,5212,2,7295
184,6/16/2021,622,383622,202,206233,446,183595,12.0,33120,4.0,34751,38.0,9251,339,158580,33.0,10516,36.0,5248,9,7304
185,6/17/2021,694,384316,251,206484,469,184064,13.0,33133,10.0,34761,41.0,9292,350,158930,49.0,10565,29.0,5277,3,7307
186,6/18/2021,1036,385352,380,206864,686,184750,23.0,33156,11.0,34772,52.0,9344,554,159484,51.0,10616,29.0,5306,7,7314
187,6/19/2021,633,385985,154,207018,494,185244,10.0,33166,6.0,34778,49.0,9393,365,159849,53.0,10669,27.0,5333,9,7323
188,6/20/2021,301,386286,114,207132,193,185437,3.0,33169,2.0,34780,36.0,9429,120,159969,15.0,10684,22.0,5355,5,7328
189,6/21/2021,515,386801,214,207346,327,185764,5.0,33174,8.0,34788,29.0,9458,241,160210,35.0,10719,22.0,5377,8,7336
190,6/22/2021,606,387407,249,207595,387,186151,12.0,33186,7.0,34795,31.0,9489,302,160512,25.0,10744,29.0,5406,5,7341
191,6/23/2021,512,387919,186,207781,353,186504,7.0,33193,10.0,34805,38.0,9527,256,160768,37.0,10781,22.0,5428,11,7352
192,6/24/2021,517,388436,210,207991,331,186835,12.0,33205,9.0,34814,30.0,9557,257,161025,23.0,10804,21.0,5449,1,7353
193,6/25/2021,687,389123,273,208264,436,187271,12.0,33217,8.0,34822,42.0,9599,323,161348,43.0,10847,28.0,5477,5,7358
194,6/26/2021,596,389719,165,208429,440,187711,9.0,33226,9.0,34831,77.0,9676,288,161636,43.0,10890,32.0,5509,4,7362
195,6/27/2021,183,389902,71,208500,113,187824,2.0,33228,3.0,34834,9.0,9685,82,161718,12.0,10902,10.0,5519,2,7364
196,6/28/2021,486,390388,209,208709,284,188108,7.0,33235,6.0,34840,39.0,9724,205,161923,24.0,10926,16.0,5535,2,7366
197,6/29/2021,556,390944,252,208961,325,188433,16.0,33251,11.0,34851,42.0,9766,235,162158,22.0,10948,26.0,5561,11,7377
198,6/30/2021,412,391356,207,209168,219,188652,8.0,33259,11.0,34862,19.0,9785,164,162322,16.0,10964,20.0,5581,12,7389
199,7/1/2021,485,391841,208,209376,295,188947,8.0,33267,7.0,34869,21.0,9806,221,162543,33.0,10997,20.0,5601,4,7393
200,7/2/2021,569,392410,273,209649,307,189254,5.0,33272,7.0,34876,26.0,9832,242,162785,23.0,11020,16.0,5617,3,7396
201,7/3/2021,308,392718,120,209769,195,189449,4.0,33276,3.0,34879,29.0,9861,126,162911,21.0,11041,19.0,5636,5,7401
202,7/4/2021,53,392771,18,209787,35,189484,1.0,33277,0.0,34879,4.0,9865,22,162933,1.0,11042,8.0,5644,0,7401
203,7/5/2021,316,393087,140,209927,174,189658,3.0,33280,1.0,34880,18.0,9883,120,163053,26.0,11068,10.0,5654,4,7405
204,7/6/2021,449,393536,188,210115,270,189928,4.0,33284,5.0,34885,45.0,9928,192,163245,18.0,11086,15.0,5669,1,7406
205,7/7/2021,370,393906,209,210324,175,190103,7.0,33291,6.0,34891,19.0,9947,129,163374,12.0,11098,15.0,5684,4,7410
206,7/8/2021,426,394332,201,210525,246,190349,10.0,33301,8.0,34899,23.0,9970,177,163551,23.0,11121,23.0,5707,3,7413
207,7/9/2021,482,394814,194,210719,294,190643,9.0,33310,2.0,34901,36.0,10006,216,163767,24.0,11145,18.0,5725,6,7419
208,7/10/2021,257,395071,145,210864,127,190770,5.0,33315,2.0,34903,5.0,10011,105,163872,10.0,11155,7.0,5732,2,7421
209,7/11/2021,225,395296,121,210985,122,190892,6.0,33321,6.0,34909,11.0,10022,88,163960,10.0,11165,13.0,5745,7,7428
210,7/12/2021,385,395681,202,211187,196,191088,7.0,33328,4.0,34913,25.0,10047,130,164090,24.0,11189,17.0,5762,4,7432
211,7/13/2021,438,396119,226,211413,226,191314,16.0,33344,10.0,34923,27.0,10074,176,164266,12.0,11201,11.0,5773,5,7437
212,7/14/2021,281,396400,149,211562,155,191469,8.0,33352,5.0,34928,19.0,10093,112,164378,9.0,11210,15.0,5788,7,7444
213,7/15/2021,360,396760,189,211751,182,191651,1.0,33353,4.0,34932,15.0,10108,137,164515,13.0,11223,17.0,5805,3,7447
214,7/16/2021,510,397270,244,211995,276,191927,8.0,33361,9.0,34941,24.0,10132,210,164725,22.0,11245,20.0,5825,5,7452
215,7/17/2021,277,397547,158,212153,129,192056,11.0,33372,5.0,34946,11.0,10143,97,164822,10.0,11255,11.0,5836,6,7458
216,7/18/2021,195,397742,118,212271,89,192145,4.0,33376,3.0,34949,13.0,10156,63,164885,6.0,11261,7.0,5843,4,7462
217,7/19/2021,405,398147,205,212476,206,192351,8.0,33384,8.0,34957,26.0,10182,150,165035,17.0,11278,13.0,5856,4,7466
218,7/20/2021,414,398561,208,212684,214,192565,6.0,33390,8.0,34965,12.0,10194,165,165200,23.0,11301,14.0,5870,5,7471
219,7/21/2021,335,398896,183,212867,172,192737,13.0,33403,14.0,34979,12.0,10206,129,165329,14.0,11315,17.0,5887,3,7474
220,7/22/2021,394,399290,234,213101,170,192907,8.0,33411,19.0,34998,18.0,10224,126,165455,18.0,11333,8.0,5895,6,7480
221,7/23/2021,549,399839,316,213417,236,193143,6.0,33417,10.0,35008,36.0,10260,162,165617,19.0,11352,19.0,5914,3,7483
222,7/24/2021,352,400191,215,213632,156,193299,8.0,33425,10.0,35018,19.0,10279,114,165731,9.0,11361,14.0,5928,5,7488
223,7/25/2021,199,400390,144,213776,63,193362,0.0,33425,4.0,35022,7.0,10286,45,165776,5.0,11366,6.0,5934,4,7492
224,7/26/2021,346,400736,200,213976,144,193506,1.0,33426,7.0,35029,11.0,10297,98,165874,18.0,11384,17.0,5951,4,7496
225,7/27/2021,422,401158,236,214212,173,193679,5.0,33431,16.0,35045,21.0,10318,122,165996,17.0,11401,13.0,5964,16,7512
226,7/28/2021,467,401625,284,214496,221,193900,3.0,33434,10.0,35055,28.0,10346,144,166140,16.0,11417,33.0,5997,5,7517
227,7/29/2021,511,402136,305,214801,236,194136,8.0,33442,6.0,35061,24.0,10370,180,166320,13.0,11430,19.0,6016,9,7526
228,7/30/2021,683,402819,474,215275,247,194383,10.0,33452,14.0,35075,25.0,10395,187,166507,16.0,11446,19.0,6035,5,7531
229,7/31/2021,334,403153,202,215477,135,194518,4.0,33456,1.0,35076,14.0,10409,107,166614,9.0,11455,5.0,6040,6,7537
230,8/1/2021,269,403422,170,215647,107,194625,0.0,33456,2.0,35078,15.0,10424,68,166682,8.0,11463,16.0,6056,8,7545
231,8/2/2021,444,403866,296,215943,172,194797,4.0,33460,13.0,35091,20.0,10444,119,166801,20.0,11483,13.0,6069,5,7550
232,8/3/2021,561,404427,347,216290,240,195037,6.0,33466,13.0,35104,37.0,10481,162,166963,15.0,11498,26.0,6095,4,7554
233,8/4/2021,390,404817,273,216563,138,195175,3.0,33469,14.0,35118,10.0,10491,105,167068,5.0,11503,18.0,6113,10,7564
234,8/5/2021,445,405262,287,216850,169,195344,5.0,33474,11.0,35129,19.0,10510,122,167190,17.0,11520,11.0,6124,4,7568
235,8/6/2021,679,405941,461,217311,264,195608,12.0,33486,16.0,35145,22.0,10532,200,167390,22.0,11542,20.0,6144,4,7572
236,8/7/2021,439,406380,305,217616,157,195765,4.0,33490,10.0,35155,12.0,10544,124,167514,5.0,11547,16.0,6160,5,7577
237,8/8/2021,217,406597,126,217742,98,195863,3.0,33493,5.0,35160,8.0,10552,72,167586,6.0,11553,12.0,6172,5,7582
238,8/9/2021,464,407061,281,218023,214,196077,4.0,33497,6.0,35166,22.0,10574,159,167745,11.0,11564,22.0,6194,7,7589
239,8/10/2021,503,407564,301,218324,227,196304,6.0,33503,14.0,35180,25.0,10599,179,167924,10.0,11574,13.0,6207,8,7597
240,8/11/2021,417,407981,265,218589,175,196479,11.0,33514,5.0,35185,16.0,10615,133,168057,14.0,11588,12.0,6219,3,7600
241,8/12/2021,542,408523,319,218908,259,196738,7.0,33521,13.0,35198,31.0,10646,182,168239,23.0,11611,23.0,6242,7,7607
242,8/13/2021,658,409181,379,219287,297,197035,11.0,33532,9.0,35207,31.0,10677,216,168455,19.0,11630,31.0,6273,6,7613
243,8/14/2021,502,409683,256,219543,249,197284,7.0,33539,9.0,35216,10.0,10687,213,168668,9.0,11639,17.0,6290,49,7662
244,8/15/2021,264,409947,129,219672,124,197408,2.0,33541,3.0,35219,11.0,10698,90,168758,6.0,11645,17.0,6307,19,7681
245,8/16/2021,538,410485,309,219981,168,197576,4.0,33545,11.0,35230,15.0,10713,128,168886,13.0,11658,12.0,6319,78,7759
246,8/17/2021,481,410966,227,220208,193,197769,20.0,33565,10.0,35240,17.0,10730,146,169032,10.0,11668,20.0,6339,81,7840
247,8/18/2021,591,411557,323,220531,255,198024,5.0,33570,15.0,35255,30.0,10760,172,169204,13.0,11681,40.0,6379,74,7914
248,8/19/2021,566,412123,278,220809,255,198279,7.0,33577,9.0,35264,21.0,10781,205,169409,17.0,11698,12.0,6391,78,7992
249,8/20/2021,841,412964,339,221148,453,198732,16.0,33593,11.0,35275,44.0,10825,359,169768,29.0,11727,21.0,6412,90,8082
250,8/21/2021,645,413609,210,221358,209,198941,4.0,33597,7.0,35282,14.0,10839,171,169939,13.0,11740,11.0,6423,197,8279
251,8/22/2021,317,413926,150,221508,144,199085,1.0,33598,2.0,35284,19.0,10858,102,170041,9.0,11749,14.0,6437,31,8310
252,8/23/2021,527,414453,262,221770,222,199307,10.0,33608,9.0,35293,19.0,10877,168,170209,12.0,11761,23.0,6460,62,8372
253,8/24/2021,570,415023,272,222042,277,199584,10.0,33618,8.0,35301,27.0,10904,217,170426,15.0,11776,18.0,6478,57,8429
254,8/25/2021,593,415616,320,222362,258,199842,12.0,33630,13.0,35314,19.0,10923,197,170623,9.0,11785,33.0,6511,48,8477
255,8/26/2021,535,416151,262,222624,252,200094,9.0,33639,14.0,35328,18.0,10941,194,170817,23.0,11808,17.0,6528,45,8522
256,8/27/2021,887,417038,351,222975,404,200498,15.0,33654,11.0,35339,37.0,10978,300,171117,22.0,11830,45.0,6573,157,8679
257,8/28/2021,1465,418503,202,223177,249,200747,7.0,33661,5.0,35344,23.0,11001,184,171301,14.0,11844,28.0,6601,995,9674
258,8/29/2021,1081,419584,161,223338,136,200883,4.0,33665,4.0,35348,8.0,11009,111,171412,12.0,11856,5.0,6606,773,10447
259,8/30/2021,618,420202,272,223610,282,201165,9.0,33674,13.0,35361,24.0,11033,217,171629,9.0,11865,32.0,6638,94,10541
260,8/31/2021,811,421013,235,223845,237,201402,7.0,33681,12.0,35373,18.0,11051,188,171817,18.0,11883,13.0,6651,343,10884
261,9/1/2021,950,421963,248,224093,221,201623,12.0,33693,15.0,35388,21.0,11072,168,171985,13.0,11896,19.0,6670,489,11373
262,9/2/2021,828,422791,184,224277,205,201828,13.0,33706,14.0,35402,19.0,11091,152,172137,16.0,11912,18.0,6688,461,11834
263,9/3/2021,855,423646,340,224617,372,202200,13.0,33719,12.0,35414,44.0,11135,272,172409,20.0,11932,36.0,6724,163,11997
264,9/4/2021,376,424022,164,224781,164,202364,6.0,33725,8.0,35422,13.0,11148,127,172536,11.0,11943,13.0,6737,58,12055
265,9/5/2021,251,424273,131,224912,108,202472,2.0,33727,4.0,35426,12.0,11160,77,172613,9.0,11952,10.0,6747,21,12076
266,9/6/2021,112,424385,47,224959,58,202530,1.0,33728,0.0,35426,4.0,11164,43,172656,8.0,11960,3.0,6750,12,12088
267,9/7/2021,952,425337,199,225158,272,202802,19.0,33747,12.0,35438,22.0,11186,208,172864,17.0,11977,25.0,6775,486,12574
268,9/8/2021,789,426126,219,225377,224,203026,11.0,33758,12.0,35450,24.0,11210,166,173030,10.0,11987,24.0,6799,371,12945
269,9/9/2021,403,426529,176,225553,195,203221,9.0,33767,8.0,35458,21.0,11231,143,173173,14.0,12001,17.0,6816,55,13000
270,9/10/2021,752,427281,340,225893,306,203527,9.0,33776,23.0,35481,28.0,11259,230,173403,20.0,12021,28.0,6844,147,13147
271,9/11/2021,1633,428914,162,226055,210,203737,10.0,33786,19.0,35500,18.0,11277,160,173563,15.0,12036,17.0,6861,1273,14420
272,9/12/2021,232,429146,101,226156,113,203850,1.0,33787,2.0,35502,11.0,11288,72,173635,10.0,12046,20.0,6881,16,14436
273,9/13/2021,492,429638,220,226376,245,204095,9.0,33796,8.0,35510,24.0,11312,184,173819,12.0,12058,25.0,6906,45,14481
274,9/14/2021,844,430482,204,226580,274,204369,14.0,33810,16.0,35526,17.0,11329,220,174039,14.0,12072,23.0,6929,401,14882
275,9/15/2021,830,431312,190,226770,266,204635,15.0,33825,15.0,35541,21.0,11350,196,174235,17.0,12089,32.0,6961,398,15280
276,9/16/2021,356,431668,134,226904,194,204829,9.0,33834,8.0,35549,32.0,11382,139,174374,11.0,12100,12.0,6973,43,15323
277,9/17/2021,746,432414,284,227188,387,205216,13.0,33847,13.0,35562,29.0,11411,289,174663,38.0,12138,31.0,7004,123,15446
278,9/18/2021,1839,434253,128,227316,171,205387,5.0,33852,20.0,35582,10.0,11421,126,174789,15.0,12153,20.0,7024,1543,16989
279,9/19/2021,181,434434,74,227390,106,205493,3.0,33855,2.0,35584,6.0,11427,82,174871,5.0,12158,13.0,7037,11,17000
280,9/20/2021,385,434819,143,227533,217,205710,8.0,33863,9.0,35593,27.0,11454,161,175032,10.0,12168,19.0,7056,55,17055
281,9/21/2021,771,435590,166,227699,199,205909,9.0,33872,14.0,35607,21.0,11475,153,175185,8.0,12176,17.0,7073,420,17475
282,9/22/2021,718,436308,164,227863,230,206139,6.0,33878,12.0,35619,15.0,11490,181,175366,16.0,12192,18.0,7091,362,17837
283,9/23/2021,348,436656,144,228007,179,206318,8.0,33886,3.0,35622,9.0,11499,132,175498,13.0,12205,25.0,7116,47,17884
284,9/24/2021,695,437351,208,228215,274,206592,16.0,33902,16.0,35638,20.0,11519,217,175715,11.0,12216,26.0,7142,232,18116
285,9/25/2021,1734,439085,136,228351,176,206768,11.0,33913,21.0,35659,15.0,11534,137,175852,12.0,12228,12.0,7154,1428,19544
286,9/26/2021,264,439349,65,228416,88,206856,3.0,33916,3.0,35662,11.0,11545,66,175918,4.0,12232,7.0,7161,110,19654
287,9/27/2021,566,439915,156,228572,124,206980,7.0,33923,11.0,35673,7.0,11552,96,176014,8.0,12240,13.0,7174,302,19956
288,9/28/2021,1127,441042,158,228730,203,207183,19.0,33942,23.0,35696,15.0,11567,154,176168,9.0,12249,25.0,7199,788,20744
289,9/29/2021,1142,442184,174,228904,171,207354,12.0,33954,19.0,35715,15.0,11582,127,176295,7.0,12256,22.0,7221,812,21556
290,9/30/2021,705,442889,161,229065,166,207520,15.0,33969,7.0,35722,11.0,11593,127,176422,10.0,12266,18.0,7239,408,21964
291,10/1/2021,1061,443950,175,229240,301,207821,20.0,33989,15.0,35737,20.0,11613,238,176660,21.0,12287,22.0,7261,601,22565
292,10/2/2021,1815,445765,118,229358,115,207936,12.0,34001,14.0,35751,9.0,11622,96,176756,5.0,12292,5.0,7266,1588,24153
293,10/3/2021,392,446157,64,229422,113,208049,1.0,34002,2.0,35753,18.0,11640,77,176833,7.0,12299,11.0,7277,227,24380
294,10/4/2021,795,446952,113,229535,156,208205,7.0,34009,12.0,35765,27.0,11667,102,176935,14.0,12313,13.0,7290,533,24913
295,10/5/2021,1116,448068,138,229673,135,208340,12.0,34021,17.0,35782,13.0,11680,103,177038,5.0,12318,14.0,7304,854,25767
296,10/6/2021,997,449065,106,229779,155,208495,8.0,34029,14.0,35796,11.0,11691,122,177160,5.0,12323,17.0,7321,753,26520
297,10/7/2021,783,449848,132,229911,107,208602,8.0,34037,14.0,35810,8.0,11699,83,177243,5.0,12328,11.0,7332,565,27085
298,10/8/2021,1037,450885,159,230070,239,208841,19.0,34056,13.0,35823,20.0,11719,186,177429,11.0,12339,22.0,7354,650,27735
299,10/9/2021,1676,452561,108,230178,131,208972,11.0,34067,8.0,35831,22.0,11741,98,177527,3.0,12342,8.0,7362,1439,29174
300,10/10/2021,243,452804,50,230228,63,209035,2.0,34069,2.0,35833,4.0,11745,49,177576,5.0,12347,5.0,7367,131,29305
301,10/11/2021,820,453624,123,230351,134,209169,16.0,34085,18.0,35851,3.0,11748,110,177686,10.0,12357,11.0,7378,574,29879
302,10/12/2021,1023,454647,118,230469,132,209301,8.0,34093,20.0,35871,16.0,11764,104,177790,4.0,12361,8.0,7386,783,30662
303,10/13/2021,970,455617,116,230585,150,209451,16.0,34109,8.0,35879,16.0,11780,114,177904,12.0,12373,8.0,7394,722,31384
304,10/14/2021,712,456329,102,230687,127,209578,14.0,34123,9.0,35888,20.0,11800,94,177998,8.0,12381,5.0,7399,490,31874
305,10/15/2021,1028,457357,177,230864,215,209793,11.0,34134,7.0,35895,15.0,11815,169,178167,13.0,12394,18.0,7417,671,32545
306,10/16/2021,803,458160,66,230930,80,209873,4.0,34138,3.0,35898,6.0,11821,69,178236,2.0,12396,3.0,7420,657,33202
307,10/17/2021,196,458356,48,230978,63,209936,1.0,34139,2.0,35900,4.0,11825,47,178283,3.0,12399,9.0,7429,83,33285
308,10/18/2021,652,459008,119,231097,135,210071,10.0,34149,4.0,35904,13.0,11838,106,178389,6.0,12405,10.0,7439,413,33698
309,10/19/2021,1050,460058,120,231217,134,210205,4.0,34153,11.0,35915,8.0,11846,108,178497,8.0,12413,10.0,7449,806,34504
310,10/20/2021,893,460951,121,231338,121,210326,6.0,34159,11.0,35926,9.0,11855,91,178588,7.0,12420,14.0,7463,665,35169
311,10/21/2021,534,461485,107,231445,128,210454,9.0,34168,8.0,35934,14.0,11869,86,178674,11.0,12431,17.0,7480,320,35489
312,10/22/2021,1480,462965,195,231640,230,210684,9.0,34177,13.0,35947,20.0,11889,171,178845,14.0,12445,25.0,7505,1076,36565
313,10/23/2021,1880,464845,88,231728,195,210879,14.0,34191,15.0,35962,4.0,11893,170,179015,11.0,12456,10.0,7515,1600,38165
314,10/24/2021,568,465413,81,231809,152,211031,8.0,34199,11.0,35973,12.0,11905,128,179143,7.0,12463,5.0,7520,348,38513
315,10/25/2021,1383,466796,137,231946,297,211328,27.0,34226,17.0,35990,12.0,11917,252,179395,21.0,12484,12.0,7532,962,39475
316,10/26/2021,2143,468939,177,232123,299,211627,14.0,34240,17.0,36007,19.0,11936,248,179643,18.0,12502,14.0,7546,1677,41152
317,10/27/2021,1971,470910,153,232276,274,211901,19.0,34259,19.0,36026,9.0,11945,242,179885,14.0,12516,9.0,7555,1552,42704
318,10/28/2021,1711,472621,139,232415,260,212161,11.0,34270,20.0,36046,11.0,11956,219,180104,17.0,12533,13.0,7568,1323,44027
319,10/29/2021,1656,474277,179,232594,278,212439,12.0,34282,15.0,36061,10.0,11966,243,180347,12.0,12545,13.0,7581,1210,45237
320,10/30/2021,1586,475863,79,232673,151,212590,13.0,34295,8.0,36069,6.0,11972,130,180477,9.0,12554,6.0,7587,1365,46602
321,10/31/2021,463,476326,48,232721,74,212664,2.0,34297,6.0,36075,6.0,11978,62,180539,4.0,12558,2.0,7589,340,46942
322,11/1/2021,1239,477565,136,232857,217,212881,10.0,34307,10.0,36085,10.0,11988,177,180716,12.0,12570,18.0,7607,894,47836
323,11/2/2021,1818,479383,131,232988,200,213081,8.0,34315,17.0,36102,14.0,12002,162,180878,13.0,12583,11.0,7618,1502,49338
324,11/3/2021,1743,481126,159,233147,229,213310,12.0,34327,17.0,36119,15.0,12017,181,181059,16.0,12599,17.0,7635,1371,50709
325,11/4/2021,1408,482534,145,233292,183,213493,4.0,34331,13.0,36132,1.0,12018,159,181218,12.0,12611,11.0,7646,1105,51814
326,11/5/2021,2015,484549,227,233519,298,213791,14.0,34345,12.0,36144,17.0,12035,249,181467,14.0,12625,18.0,7664,1522,53336
327,11/6/2021,1578,486127,215,233734,142,213933,4.0,34349,7.0,36151,6.0,12041,115,181582,15.0,12640,6.0,7670,1229,54565
328,11/7/2021,523,486650,119,233853,77,214010,1.0,34350,8.0,36159,5.0,12046,63,181645,3.0,12643,6.0,7676,328,54893
329,11/8/2021,1525,488175,386,234239,198,214208,7.0,34357,9.0,36168,11.0,12057,164,181809,9.0,12652,14.0,7690,962,55855
330,11/9/2021,2630,490805,944,235183,221,214429,10.0,34367,21.0,36189,15.0,12072,163,181972,16.0,12668,27.0,7717,1485,57340
331,11/10/2021,2486,493291,822,236005,222,214651,11.0,34378,18.0,36207,11.0,12083,176,182148,22.0,12690,13.0,7730,1465,58805
332,11/11/2021,2347,495638,966,236971,188,214839,17.0,34395,8.0,36215,13.0,12096,154,182302,13.0,12703,8.0,7738,1213,60018
333,11/12/2021,2553,498191,754,237725,240,215079,12.0,34407,19.0,36234,23.0,12119,191,182493,13.0,12716,13.0,7751,1570,61588
334,11/13/2021,1927,500118,405,238130,140,215219,4.0,34411,12.0,36246,7.0,12126,104,182597,15.0,12731,14.0,7765,1392,62980
335,11/14/2021,1481,501599,911,239041,107,215326,1.0,34412,2.0,36248,11.0,12137,72,182669,14.0,12745,10.0,7775,473,63453
336,11/15/2021,1954,503553,452,239493,199,215525,7.0,34419,11.0,36259,12.0,12149,159,182828,12.0,12757,16.0,7791,1324,64777
337,11/16/2021,2400,505953,455,239948,213,215738,5.0,34424,21.0,36280,26.0,12175,156,182984,17.0,12774,14.0,7805,1744,66521
338,11/17/2021,2721,508674,633,240581,269,216007,12.0,34436,16.0,36296,16.0,12191,222,183206,17.0,12791,14.0,7819,1850,68371
339,11/18/2021,1885,510559,378,240959,178,216185,7.0,34443,11.0,36307,15.0,12206,143,183349,15.0,12806,5.0,7824,1344,69715
340,11/19/2021,2562,513121,716,241675,281,216466,13.0,34456,14.0,36321,9.0,12215,235,183584,20.0,12826,17.0,7841,1585,71300
341,11/20/2021,1873,514994,531,242206,112,216578,6.0,34462,5.0,36326,8.0,12223,95,183679,4.0,12830,5.0,7846,1233,72533
342,11/21/2021,639,515633,123,242329,84,216662,0.0,34462,1.0,36327,3.0,12226,68,183747,8.0,12838,5.0,7851,433,72966
343,11/22/2021,1970,517603,427,242756,208,216870,11.0,34473,21.0,36348,10.0,12236,169,183916,11.0,12849,18.0,7869,1355,74321
344,11/23/2021,1836,519439,288,243044,184,217054,8.0,34481,15.0,36363,15.0,12251,148,184064,14.0,12863,7.0,7876,1373,75694
345,11/24/2021,1510,520949,216,243260,162,217216,6.0,34487,11.0,36374,14.0,12265,131,184195,11.0,12874,6.0,7882,1146,76840
346,11/25/2021,46,520995,9,243269,2,217218,0.0,34487,0.0,36374,0.0,12265,1,184196,1.0,12875,,7882,35,76875
347,11/26/2021,1256,522251,191,243460,202,217420,3.0,34490,4.0,36378,17.0,12282,163,184359,12.0,12887,10.0,7892,882,77757
348,11/27/2021,946,523197,137,243597,152,217572,2.0,34492,2.0,36380,7.0,12289,130,184489,8.0,12895,7.0,7899,659,78416
349,11/28/2021,539,523736,96,243693,104,217676,2.0,34494,2.0,36382,9.0,12298,83,184572,5.0,12900,7.0,7906,345,78761
350,11/29/2021,1839,525575,276,243969,407,218083,8.0,34502,14.0,36396,29.0,12327,338,184910,25.0,12925,15.0,7921,1177,79938
351,11/30/2021,2655,528230,340,244309,786,218869,8.0,34510,11.0,36407,51.0,12378,662,185572,61.0,12986,12.0,7933,1549,81487
352,12/1/2021,2428,530658,260,244569,746,219615,13.0,34523,10.0,36417,30.0,12408,656,186228,56.0,13042,4.0,7937,1433,82920
353,12/2/2021,2794,533452,346,244915,911,220526,9.0,34532,11.0,36428,69.0,12477,740,186968,73.0,13115,29.0,7966,1564,84484
354,12/3/2021,2580,536032,287,245202,755,221281,11.0,34543,4.0,36432,61.0,12538,596,187564,69.0,13184,29.0,7995,1558,86042
355,12/4/2021,2179,538211,161,245363,419,221700,4.0,34547,1.0,36433,24.0,12562,328,187892,36.0,13220,31.0,8026,1606,87648
356,12/5/2021,1377,539588,104,245467,840,222540,1.0,34548,0.0,36433,67.0,12629,667,188559,69.0,13289,37.0,8063,442,88090
357,12/6/2021,1914,541502,233,245700,467,223007,7.0,34555,5.0,36438,54.0,12683,363,188922,34.0,13323,16.0,8079,1227,89317
358,12/7/2021,2444,543946,307,246007,468,223475,10.0,34565,9.0,36447,49.0,12732,372,189294,31.0,13354,16.0,8095,1688,91005
359,12/8/2021,2226,546172,271,246278,512,223987,9.0,34574,12.0,36459,29.0,12761,429,189723,40.0,13394,14.0,8109,1465,92470
360,12/9/2021,2144,548316,304,246582,459,224446,6.0,34580,8.0,36467,27.0,12788,356,190079,43.0,13437,33.0,8142,1395,93865
361,12/10/2021,2084,550400,241,246823,403,224849,10.0,34590,9.0,36476,38.0,12826,313,190392,32.0,13469,20.0,8162,1450,95315
362,12/11/2021,1777,552177,135,246958,491,225340,6.0,34596,1.0,36477,59.0,12885,365,190757,41.0,13510,26.0,8188,1153,96468
363,12/12/2021,415,552592,55,247013,88,225428,1.0,34597,3.0,36480,4.0,12889,71,190828,7.0,13517,6.0,8194,275,96743
364,12/13/2021,1746,554338,298,247311,392,225820,9.0,34606,9.0,36489,26.0,12915,318,191146,35.0,13552,13.0,8207,1074,97817
365,12/14/2021,2176,556514,276,247587,365,226185,7.0,34613,5.0,36494,33.0,12948,299,191445,16.0,13568,17.0,8224,1560,99377
366,12/15/2021,1735,558249,202,247789,228,226413,6.0,34619,4.0,36498,9.0,12957,185,191630,19.0,13587,15.0,8239,1318,100695
367,12/16/2021,1760,560009,314,248103,246,226659,7.0,34626,7.0,36505,16.0,12973,206,191836,15.0,13602,9.0,8248,1218,101913
368,12/17/2021,2108,562117,308,248411,441,227100,6.0,34632,10.0,36515,28.0,13001,363,192199,39.0,13641,11.0,8259,1370,103283
369,12/18/2021,1800,563917,180,248591,240,227340,4.0,34636,4.0,36519,17.0,13018,205,192404,10.0,13651,8.0,8267,1381,104664
370,12/19/2021,437,564354,44,248635,80,227420,1.0,34637,3.0,36522,5.0,13023,66,192470,3.0,13654,6.0,8273,313,104977
371,12/20/2021,1548,565902,198,248833,241,227661,10.0,34647,9.0,36531,27.0,13050,191,192661,16.0,13670,7.0,8280,1114,106091
372,12/21/2021,2184,568086,310,249143,294,227955,10.0,34657,8.0,36539,28.0,13078,227,192888,25.0,13695,14.0,8294,1588,107679
373,12/22/2021,1869,569955,218,249361,284,228239,4.0,34661,9.0,36548,27.0,13105,227,193115,22.0,13717,8.0,8302,1370,109049
374,12/23/2021,1232,571187,217,249578,206,228445,5.0,34666,5.0,36553,23.0,13128,156,193271,16.0,13733,11.0,8313,822,109871
375,12/24/2021,319,571506,45,249623,63,228508,3.0,34669,2.0,36555,4.0,13132,54,193325,4.0,13737,1.0,8314,213,110084
376,12/25/2021,14,571520,4,249627,2,228510,0.0,34669,0.0,36555,,13132,1,193326,1.0,13738,,8314,8,110092
377,12/26/2021,353,571873,61,249688,68,228578,1.0,34670,0.0,36555,7.0,13139,53,193379,5.0,13743,3.0,8317,226,110318
378,12/27/2021,1249,573122,175,249863,222,228800,4.0,34674,5.0,36560,18.0,13157,176,193555,20.0,13763,8.0,8325,859,111177
379,12/28/2021,1888,575010,268,250131,296,229096,12.0,34686,12.0,36572,35.0,13192,231,193786,16.0,13779,14.0,8339,1328,112505
380,12/29/2021,1691,576701,211,250342,251,229347,5.0,34691,6.0,36578,27.0,13219,191,193977,22.0,13801,11.0,8350,1240,113745
381,12/30/2021,1365,578066,223,250565,239,229586,7.0,34698,9.0,36587,26.0,13245,186,194163,15.0,13816,12.0,8362,913,114658
382,12/31/2021,500,578566,97,250662,92,229678,0.0,34698,2.0,36589,7.0,13252,75,194238,5.0,13821,5.0,8367,314,114972
383,1/1/2022,93,578659,12,250674,16,229694,1.0,34699,1.0,36590,0.0,13252,13,194251,2.0,13823,1.0,8368,65,115037
384,1/2/2022,315,578974,45,250719,60,229754,1.0,34700,1.0,36591,7.0,13259,41,194292,9.0,13832,3.0,8371,211,115248
385,1/3/2022,1593,580567,330,251049,345,230099,4.0,34704,5.0,36596,34.0,13293,281,194573,20.0,13852,10.0,8381,928,116176
386,1/4/2022,1666,582233,264,251313,275,230374,10.0,34714,7.0,36603,30.0,13323,217,194790,17.0,13869,11.0,8392,1140,117316
387,1/5/2022,1332,583565,208,251521,200,230574,7.0,34721,8.0,36611,13.0,13336,163,194953,9.0,13878,15.0,8407,938,118254
388,1/6/2022,1224,584789,252,251773,232,230806,4.0,34725,4.0,36615,24.0,13360,173,195126,13.0,13891,22.0,8429,749,119003
389,1/7/2022,2053,586842,253,252026,340,231146,6.0,34731,9.0,36624,35.0,13395,262,195388,30.0,13921,13.0,8442,1472,120475
390,1/8/2022,1572,588414,125,252151,130,231276,0.0,34731,3.0,36627,7.0,13402,109,195497,7.0,13928,7.0,8449,1321,121796
391,1/9/2022,497,588911,92,252243,72,231348,0.0,34731,2.0,36629,14.0,13416,49,195546,3.0,13931,6.0,8455,334,122130
392,1/10/2022,1551,590462,288,252531,251,231599,3.0,34734,6.0,36635,19.0,13435,194,195740,27.0,13958,11.0,8466,1023,123153
393,1/11/2022,1557,592019,218,252749,274,231873,3.0,34737,4.0,36639,31.0,13466,209,195949,15.0,13973,19.0,8485,1077,124230
394,1/12/2022,1400,593419,179,252928,184,232057,6.0,34743,5.0,36644,28.0,13494,126,196075,20.0,13993,10.0,8495,1049,125279
395,1/13/2022,1098,594517,192,253120,178,232235,3.0,34746,2.0,36646,14.0,13508,132,196207,18.0,14011,14.0,8509,737,126016
396,1/14/2022,1615,596132,279,253399,214,232449,2.0,34748,9.0,36655,25.0,13533,156,196363,20.0,14031,13.0,8522,1137,127153
397,1/15/2022,1216,597348,137,253536,102,232551,1.0,34749,3.0,36658,11.0,13544,80,196443,9.0,14040,2.0,8524,978,128131
398,1/16/2022,289,597637,46,253582,35,232586,1.0,34750,0.0,36658,1.0,13545,31,196474,3.0,14043,0.0,8524,208,128339
399,1/17/2022,772,598409,159,253741,127,232713,4.0,34754,5.0,36663,12.0,13557,105,196579,8.0,14051,2.0,8526,488,128827
400,1/18/2022,887,599296,165,253906,165,232878,2.0,34756,6.0,36669,25.0,13582,126,196705,6.0,14057,8.0,8534,564,129391
401,1/19/2022,720,600016,122,254028,117,232995,4.0,34760,7.0,36676,9.0,13591,86,196791,10.0,14067,12.0,8546,493,129884
402,1/20/2022,780,600796,145,254173,147,233142,0.0,34760,10.0,36686,17.0,13608,111,196902,10.0,14077,9.0,8555,495,130379
403,1/21/2022,1173,601969,166,254339,172,233314,7.0,34767,2.0,36688,15.0,13623,133,197035,11.0,14088,13.0,8568,845,131224
404,1/22/2022,781,602750,87,254426,103,233417,0.0,34767,1.0,36689,14.0,13637,74,197109,6.0,14094,9.0,8577,594,131818
405,1/23/2022,209,602959,24,254450,53,233470,1.0,34768,0.0,36689,5.0,13642,41,197150,7.0,14101,0.0,8577,133,131951
406,1/24/2022,487,603446,75,254525,106,233576,1.0,34769,1.0,36690,14.0,13656,77,197227,8.0,14109,7.0,8584,309,132260
407,1/25/2022,662,604108,118,254643,142,233718,3.0,34772,2.0,36692,15.0,13671,100,197327,20.0,14129,7.0,8591,404,132664
408,1/26/2022,639,604747,99,254742,138,233856,7.0,34779,2.0,36694,12.0,13683,105,197432,13.0,14142,8.0,8599,411,133075
409,1/27/2022,613,605360,113,254855,170,234026,5.0,34784,1.0,36695,29.0,13712,125,197557,10.0,14152,6.0,8605,336,133411
410,1/28/2022,967,606327,164,255019,169,234195,6.0,34790,6.0,36701,20.0,13732,119,197676,14.0,14166,16.0,8621,639,134050
411,1/29/2022,556,606883,68,255087,83,234278,1.0,34791,4.0,36705,10.0,13742,60,197736,8.0,14174,5.0,8626,405,134455
412,1/30/2022,191,607074,33,255120,43,234321,1.0,34792,1.0,36706,13.0,13755,26,197762,1.0,14175,3.0,8629,117,134572
413,1/31/2022,553,607627,136,255256,120,234441,2.0,34794,2.0,36708,17.0,13772,79,197841,13.0,14188,11.0,8640,301,134873
414,2/1/2022,549,608176,98,255354,137,234578,0.0,34794,3.0,36711,19.0,13791,102,197943,11.0,14199,5.0,8645,316,135189
415,2/2/2022,126,608302,18,255372,45,234623,0.0,34794,1.0,36712,2.0,13793,41,197984,1.0,14200,1.0,8646,66,135255
416,2/3/2022,362,608664,75,255447,114,234737,0.0,34794,3.0,36715,24.0,13817,78,198062,6.0,14206,6.0,8652,178,135433
417,2/4/2022,634,609298,108,255555,143,234880,6.0,34800,3.0,36718,15.0,13832,113,198175,9.0,14215,6.0,8658,385,135818
418,2/5/2022,456,609754,57,255612,112,234992,2.0,34802,0.0,36718,7.0,13839,90,198265,6.0,14221,9.0,8667,289,136107
419,2/6/2022,122,609876,21,255633,33,235025,0.0,34802,1.0,36719,1.0,13840,23,198288,6.0,14227,3.0,8670,69,136176
420,2/7/2022,345,610221,58,255691,105,235130,0.0,34802,0.0,36719,11.0,13851,81,198369,5.0,14232,8.0,8678,184,136360
421,2/8/2022,302,610523,63,255754,67,235197,0.0,34802,3.0,36722,11.0,13862,50,198419,4.0,14236,2.0,8680,178,136538
