,Date,daily number of doses received by Larimer County residents,total number of doses recevied by residents,daily number of residents receiving first dose,total number of residents receiving first dose,daily number of residents vaccinated,total number of residents vaccinated,daily number of 70+ vaccinated,total number of 70+ vaccinated,daily number of 70+ at least one dose,total number of 70+ at least one dose,daily number of Latinx residents vaccinated,total of Latinx residents vaccinated,daily number of White non-Latinx residents vaccinated,total of White non-Latinx residents vaccinated,daily number of non-White non-Latinx residents vaccinated,total of non-White non-Latinx residents vaccinated,dailyUnknown,totalUnknown,daily_additional_doses,total_additional_doses,daily_second_booster ,total_second_boosters
0,12/14/2020,31,31,31,31,0,0,0.0,0,1.0,1,0.0,0,0,0,0.0,0,,0,0,0,0,0
1,12/15/2020,15,46,15,46,0,0,,0,,1,,0,0,0,0.0,0,,0,0,0,0,0
2,12/16/2020,308,354,308,354,0,0,0.0,0,1.0,2,0.0,0,0,0,0.0,0,0.0,0,0,0,0,0
3,12/17/2020,989,1343,989,1343,0,0,0.0,0,11.0,13,0.0,0,0,0,0.0,0,0.0,0,0,0,0,0
4,12/18/2020,1056,2399,1056,2399,0,0,0.0,0,15.0,28,0.0,0,0,0,0.0,0,0.0,0,0,0,0,0
5,12/19/2020,723,3122,723,3122,0,0,0.0,0,13.0,41,0.0,0,0,0,0.0,0,0.0,0,0,0,0,0
6,12/20/2020,266,3388,266,3388,0,0,0.0,0,4.0,45,0.0,0,0,0,0.0,0,0.0,0,0,0,0,0
7,12/21/2020,358,3746,358,3746,0,0,0.0,0,3.0,48,0.0,0,0,0,0.0,0,0.0,0,0,0,0,0
8,12/22/2020,359,4105,359,4105,0,0,0.0,0,7.0,55,0.0,0,0,0,0.0,0,0.0,0,0,0,0,0
9,12/23/2020,449,4554,449,4554,0,0,0.0,0,7.0,62,0.0,0,0,0,0.0,0,0.0,0,0,0,0,0
10,12/24/2020,107,4661,107,4661,0,0,0.0,0,3.0,65,0.0,0,0,0,0.0,0,0.0,0,0,0,0,0
11,12/25/2020,1,4662,1,4662,0,0,,0,,65,,0,0,0,,0,,0,0,0,0,0
12,12/26/2020,231,4893,231,4893,0,0,0.0,0,3.0,68,0.0,0,0,0,0.0,0,0.0,0,0,0,0,0
13,12/27/2020,277,5170,277,5170,0,0,0.0,0,195.0,263,0.0,0,0,0,0.0,0,,0,0,0,0,0
14,12/28/2020,720,5890,720,5890,0,0,0.0,0,388.0,651,0.0,0,0,0,0.0,0,0.0,0,0,0,0,0
15,12/29/2020,905,6795,904,6794,1,1,0.0,0,455.0,1106,0.0,0,1,1,0.0,0,0.0,0,0,0,0,0
16,12/30/2020,882,7677,881,7675,1,2,0.0,0,261.0,1367,0.0,0,1,2,0.0,0,0.0,0,0,0,0,0
17,12/31/2020,906,8583,904,8579,3,5,1.0,1,341.0,1708,0.0,0,3,5,0.0,0,0.0,0,0,0,0,0
18,1/1/2021,6,8589,5,8584,2,7,,1,,1708,,0,2,7,,0,,0,0,0,0,0
19,1/2/2021,386,8975,386,8970,0,7,0.0,1,138.0,1846,0.0,0,0,7,0.0,0,0.0,0,0,0,0,0
20,1/3/2021,131,9106,130,9100,2,9,0.0,1,58.0,1904,0.0,0,2,9,0.0,0,0.0,0,0,0,0,0
21,1/4/2021,599,9705,584,9684,15,24,0.0,1,319.0,2223,0.0,0,12,21,2.0,2,1.0,1,0,0,0,0
22,1/5/2021,647,10352,636,10320,11,35,0.0,1,406.0,2629,0.0,0,11,32,0.0,2,0.0,1,0,0,0,0
23,1/6/2021,1257,11609,939,11259,317,352,3.0,4,534.0,3163,18.0,18,278,310,17.0,19,4.0,5,1,1,0,0
24,1/7/2021,1670,13279,710,11969,959,1311,12.0,16,409.0,3572,34.0,52,867,1177,44.0,63,14.0,19,1,2,0,0
25,1/8/2021,2001,15280,993,12962,1007,2318,12.0,28,489.0,4061,48.0,100,895,2072,43.0,106,21.0,40,1,3,0,0
26,1/9/2021,1234,16514,539,13501,695,3013,16.0,44,309.0,4370,17.0,117,629,2701,35.0,141,14.0,54,0,3,0,0
27,1/10/2021,709,17223,432,13933,277,3290,4.0,48,266.0,4636,10.0,127,251,2952,13.0,154,3.0,57,0,3,0,0
28,1/11/2021,1144,18367,795,14728,349,3639,1.0,49,532.0,5168,10.0,137,316,3268,19.0,173,4.0,61,0,3,0,0
29,1/12/2021,1177,19544,880,15608,297,3936,8.0,57,513.0,5681,15.0,152,255,3523,19.0,192,8.0,69,0,3,0,0
30,1/13/2021,1078,20622,832,16440,246,4182,1.0,58,370.0,6051,23.0,175,200,3723,15.0,207,8.0,77,0,3,0,0
31,1/14/2021,873,21495,836,17276,37,4219,1.0,59,495.0,6546,2.0,177,32,3755,1.0,208,2.0,79,0,3,0,0
32,1/15/2021,1225,22720,1209,18485,16,4235,0.0,59,759.0,7305,0.0,177,16,3771,0.0,208,0.0,79,0,3,0,0
33,1/16/2021,985,23705,971,19456,14,4249,1.0,60,582.0,7887,0.0,177,13,3784,1.0,209,0.0,79,0,3,0,0
34,1/17/2021,62,23767,56,19512,6,4255,0.0,60,21.0,7908,0.0,177,4,3788,2.0,211,0.0,79,0,3,0,0
35,1/18/2021,1025,24792,818,20330,205,4460,48.0,108,599.0,8507,8.0,185,178,3966,13.0,224,6.0,85,2,5,0,0
36,1/19/2021,1259,26051,1113,21443,143,4603,9.0,117,729.0,9236,7.0,192,123,4089,6.0,230,7.0,92,2,7,1,1
37,1/20/2021,1431,27482,1210,22653,219,4822,15.0,132,571.0,9807,14.0,206,179,4268,9.0,239,17.0,109,1,8,1,2
38,1/21/2021,2267,29749,2046,24699,220,5042,10.0,142,1584.0,11391,14.0,220,183,4451,16.0,255,7.0,116,3,11,0,2
39,1/22/2021,1748,31497,1462,26161,286,5328,97.0,239,1091.0,12482,34.0,254,231,4682,14.0,269,7.0,123,0,11,0,2
40,1/23/2021,909,32406,575,26736,334,5662,56.0,295,429.0,12911,9.0,263,306,4988,13.0,282,6.0,129,0,11,0,2
41,1/24/2021,388,32794,102,26838,286,5948,207.0,502,60.0,12971,8.0,271,269,5257,9.0,291,,129,0,11,0,2
42,1/25/2021,1413,34207,791,27629,618,6566,371.0,873,553.0,13524,13.0,284,580,5837,16.0,307,9.0,138,4,15,0,2
43,1/26/2021,1623,35830,700,28329,920,7486,458.0,1331,438.0,13962,30.0,314,841,6678,38.0,345,11.0,149,2,17,1,3
44,1/27/2021,1847,37677,776,29105,1070,8556,533.0,1864,338.0,14300,41.0,355,973,7651,47.0,392,9.0,158,1,18,0,3
45,1/28/2021,1353,39030,548,29653,804,9360,353.0,2217,299.0,14599,25.0,380,739,8390,27.0,419,13.0,171,1,19,0,3
46,1/29/2021,1650,40680,1161,30814,487,9847,169.0,2386,823.0,15422,22.0,402,422,8812,33.0,452,10.0,181,2,21,0,3
47,1/30/2021,1221,41901,732,31546,487,10334,209.0,2595,595.0,16017,24.0,426,438,9250,19.0,471,6.0,187,2,23,0,3
48,1/31/2021,654,42555,425,31971,225,10559,76.0,2671,365.0,16382,5.0,431,199,9449,15.0,486,6.0,193,3,26,1,4
49,2/1/2021,1676,44231,956,32927,715,11274,469.0,3140,666.0,17048,20.0,451,657,10106,28.0,514,10.0,203,7,33,0,4
50,2/2/2021,1867,46098,734,33661,1133,12407,735.0,3875,579.0,17627,44.0,495,1043,11149,36.0,550,10.0,213,0,33,0,4
51,2/3/2021,1277,47375,593,34254,685,13092,323.0,4198,229.0,17856,48.0,543,580,11729,46.0,596,11.0,224,0,33,0,4
52,2/4/2021,2527,49902,1782,36036,744,13836,497.0,4695,1536.0,19392,31.0,574,665,12394,38.0,634,10.0,234,1,34,0,4
53,2/5/2021,2579,52481,1528,37564,1046,14882,687.0,5382,1303.0,20695,38.0,612,958,13352,31.0,665,19.0,253,6,40,0,4
54,2/6/2021,2226,54707,1601,39165,625,15507,453.0,5835,1236.0,21931,11.0,623,585,13937,21.0,686,8.0,261,0,40,0,4
55,2/7/2021,239,54946,91,39256,145,15652,98.0,5933,29.0,21960,7.0,630,130,14067,4.0,690,4.0,265,3,43,0,4
56,2/8/2021,2457,57403,1581,40837,877,16529,593.0,6526,1127.0,23087,26.0,656,807,14874,28.0,718,16.0,281,0,43,0,4
57,2/9/2021,2392,59795,1535,42372,856,17385,523.0,7049,986.0,24073,26.0,682,771,15645,38.0,756,21.0,302,2,45,0,4
58,2/10/2021,1595,61390,971,43343,615,18000,315.0,7364,288.0,24361,25.0,707,546,16191,29.0,785,15.0,317,9,54,0,4
59,2/11/2021,3530,64920,1998,45341,1531,19531,1053.0,8417,808.0,25169,55.0,762,1396,17587,54.0,839,26.0,343,3,57,0,4
60,2/12/2021,3278,68198,1820,47161,1454,20985,963.0,9380,800.0,25969,60.0,822,1336,18923,46.0,885,12.0,355,4,61,0,4
61,2/13/2021,2999,71197,2364,49525,633,21618,310.0,9690,671.0,26640,14.0,836,581,19504,26.0,911,12.0,367,2,63,0,4
62,2/14/2021,428,71625,350,49875,77,21695,54.0,9744,44.0,26684,2.0,838,70,19574,3.0,914,2.0,369,1,64,0,4
63,2/15/2021,2622,74247,2124,51999,498,22193,322.0,10066,258.0,26942,18.0,856,465,20039,12.0,926,3.0,372,0,64,0,4
64,2/16/2021,2747,76994,1906,53905,841,23034,495.0,10561,229.0,27171,36.0,892,766,20805,22.0,948,17.0,389,0,64,0,4
65,2/17/2021,1633,78627,650,54555,979,24013,480.0,11041,153.0,27324,31.0,923,892,21697,37.0,985,19.0,408,4,68,0,4
66,2/18/2021,2644,81271,1680,56235,960,24973,731.0,11772,277.0,27601,37.0,960,885,22582,31.0,1016,7.0,415,4,72,0,4
67,2/19/2021,2433,83704,1036,57271,1393,26366,1027.0,12799,161.0,27762,43.0,1003,1288,23870,47.0,1063,15.0,430,4,76,0,4
68,2/20/2021,1654,85358,681,57952,971,27337,791.0,13590,130.0,27892,23.0,1026,909,24779,30.0,1093,9.0,439,2,78,0,4
69,2/21/2021,117,85475,43,57995,72,27409,40.0,13630,8.0,27900,1.0,1027,68,24847,2.0,1095,1.0,440,2,80,0,4
70,2/22/2021,2035,87510,762,58757,1269,28678,932.0,14562,148.0,28048,38.0,1065,1180,26027,41.0,1136,10.0,450,4,84,0,4
71,2/23/2021,1229,88739,521,59278,707,29385,469.0,15031,160.0,28208,21.0,1086,635,26662,37.0,1173,14.0,464,1,85,0,4
72,2/24/2021,1420,90159,757,60035,661,30046,280.0,15311,139.0,28347,28.0,1114,610,27272,19.0,1192,4.0,468,2,87,0,4
73,2/25/2021,3868,94027,2070,62105,1795,31841,1503.0,16814,353.0,28700,48.0,1162,1694,28966,38.0,1230,15.0,483,2,89,1,5
74,2/26/2021,3272,97299,1156,63261,2113,33954,1740.0,18554,199.0,28899,33.0,1195,1991,30957,59.0,1289,30.0,513,3,92,0,5
75,2/27/2021,3492,100791,1663,64924,1825,35779,1558.0,20112,547.0,29446,35.0,1230,1703,32660,57.0,1346,30.0,543,4,96,0,5
76,2/28/2021,431,101222,359,65283,69,35848,42.0,20154,115.0,29561,2.0,1232,64,32724,1.0,1347,2.0,545,3,99,0,5
77,3/1/2021,2969,104191,1474,66757,1499,37347,1076.0,21230,300.0,29861,55.0,1287,1386,34110,46.0,1393,12.0,557,14,113,0,5
78,3/2/2021,3255,107446,1729,68486,1524,38871,1043.0,22273,385.0,30246,37.0,1324,1416,35526,44.0,1437,27.0,584,2,115,0,5
79,3/3/2021,1668,109114,1095,69581,578,39449,176.0,22449,207.0,30453,33.0,1357,513,36039,26.0,1463,6.0,590,0,115,0,5
80,3/4/2021,3015,112129,1591,71172,1457,40906,822.0,23271,171.0,30624,43.0,1400,1336,37375,58.0,1521,20.0,610,2,117,0,5
81,3/5/2021,3500,115629,2068,73240,1478,42384,822.0,24093,425.0,31049,42.0,1442,1369,38744,43.0,1564,24.0,634,3,120,0,5
82,3/6/2021,4123,119752,2338,75578,2708,45092,862.0,24955,270.0,31319,171.0,1613,2375,41119,127.0,1691,35.0,669,3,123,1,6
83,3/7/2021,431,120183,314,75892,153,45245,37.0,24992,23.0,31342,4.0,1617,144,41263,2.0,1693,3.0,672,0,123,0,6
84,3/8/2021,2826,123009,1064,76956,1919,47164,274.0,25266,76.0,31418,54.0,1671,1776,43039,66.0,1759,23.0,695,3,126,0,6
85,3/9/2021,3202,126211,1665,78621,1641,48805,265.0,25531,95.0,31513,54.0,1725,1493,44532,70.0,1829,24.0,719,13,139,0,6
86,3/10/2021,2405,128616,1389,80010,1098,49903,307.0,25838,86.0,31599,56.0,1781,989,45521,36.0,1865,17.0,736,3,142,0,6
87,3/11/2021,4190,132806,2387,82397,1908,51811,402.0,26240,134.0,31733,64.0,1845,1754,47275,70.0,1935,20.0,756,6,148,0,6
88,3/12/2021,3960,136766,2580,84977,1482,53293,206.0,26446,67.0,31800,94.0,1939,1298,48573,59.0,1994,31.0,787,7,155,0,6
89,3/13/2021,221,136987,137,85114,135,53428,21.0,26467,6.0,31806,1.0,1940,127,48700,5.0,1999,2.0,789,1,156,0,6
90,3/14/2021,103,137090,61,85175,42,53470,9.0,26476,0.0,31806,1.0,1941,39,48739,1.0,2000,1.0,790,1,157,0,6
91,3/15/2021,919,138009,376,85551,567,54037,90.0,26566,15.0,31821,20.0,1961,521,49260,17.0,2017,9.0,799,3,160,0,6
92,3/16/2021,3303,141312,2126,87677,1222,55259,229.0,26795,46.0,31867,68.0,2029,1092,50352,45.0,2062,17.0,816,1,161,0,6
93,3/17/2021,2920,144232,1788,89465,1182,56441,237.0,27032,87.0,31954,41.0,2070,1083,51435,41.0,2103,17.0,833,8,169,0,6
94,3/18/2021,4025,148257,2086,91551,1961,58402,342.0,27374,90.0,32044,99.0,2169,1777,53212,65.0,2168,20.0,853,15,184,0,6
95,3/19/2021,3016,151273,1748,93299,1281,59683,222.0,27596,43.0,32087,64.0,2233,1152,54364,46.0,2214,19.0,872,14,198,1,7
96,3/20/2021,3082,154355,1962,95261,1163,60846,317.0,27913,52.0,32139,36.0,2269,1042,55406,62.0,2276,23.0,895,7,205,0,7
97,3/21/2021,683,155038,409,95670,291,61137,26.0,27939,5.0,32144,13.0,2282,259,55665,18.0,2294,1.0,896,6,211,0,7
98,3/22/2021,3125,158163,2248,97918,900,62037,192.0,28131,57.0,32201,19.0,2301,830,56495,38.0,2332,13.0,909,9,220,0,7
99,3/23/2021,4466,162629,3569,101487,1752,63789,203.0,28334,74.0,32275,67.0,2368,1526,58021,107.0,2439,52.0,961,2,222,0,7
100,3/24/2021,3173,165802,2431,103918,799,64588,122.0,28456,37.0,32312,46.0,2414,706,58727,29.0,2468,18.0,979,6,228,0,7
101,3/25/2021,5069,170871,3046,106964,2039,66627,313.0,28769,69.0,32381,67.0,2481,1864,60591,74.0,2542,34.0,1013,11,239,3,10
102,3/26/2021,4593,175464,2720,109684,1907,68534,328.0,29097,66.0,32447,122.0,2603,1640,62231,114.0,2656,31.0,1044,12,251,0,10
103,3/27/2021,3350,178814,1908,111592,1446,69980,330.0,29427,20.0,32467,49.0,2652,1329,63560,48.0,2704,20.0,1064,4,255,0,10
104,3/28/2021,1188,180002,825,112417,365,70345,93.0,29520,17.0,32484,12.0,2664,336,63896,15.0,2719,2.0,1066,1,256,0,10
105,3/29/2021,4006,184008,2696,115113,1328,71673,233.0,29753,54.0,32538,42.0,2706,1242,65138,32.0,2751,12.0,1078,4,260,0,10
106,3/30/2021,4384,188392,2752,117865,1712,73385,249.0,30002,75.0,32613,57.0,2763,1557,66695,77.0,2828,21.0,1099,7,267,0,10
107,3/31/2021,3617,192009,2581,120446,1103,74488,173.0,30175,48.0,32661,47.0,2810,982,67677,51.0,2879,23.0,1122,8,275,0,10
108,4/1/2021,5191,197200,3369,123815,1866,76354,152.0,30327,78.0,32739,77.0,2887,1697,69374,68.0,2947,24.0,1146,24,299,1,11
109,4/2/2021,4732,201932,2531,126346,2244,78598,244.0,30571,51.0,32790,82.0,2969,2036,71410,96.0,3043,30.0,1176,6,305,1,12
110,4/3/2021,4278,206210,3526,129872,868,79466,99.0,30670,41.0,32831,38.0,3007,776,72186,36.0,3079,18.0,1194,6,311,0,12
111,4/4/2021,387,206597,268,130140,172,79638,6.0,30676,7.0,32838,3.0,3010,154,72340,13.0,3092,2.0,1196,2,313,0,12
112,4/5/2021,4734,211331,3791,133931,1085,80723,79.0,30755,46.0,32884,71.0,3081,936,73276,55.0,3147,23.0,1219,3,316,0,12
113,4/6/2021,5189,216520,3046,136977,2665,83388,92.0,30847,62.0,32946,91.0,3172,2339,75615,170.0,3317,65.0,1284,10,326,1,13
114,4/7/2021,5009,221529,3695,140672,3527,86915,83.0,30930,109.0,33055,155.0,3327,3030,78645,250.0,3567,92.0,1376,13,339,0,13
115,4/8/2021,6695,228224,4507,145179,4005,90920,165.0,31095,121.0,33176,170.0,3497,3526,82171,219.0,3786,90.0,1466,18,357,0,13
116,4/9/2021,5735,233959,3278,148457,4181,95101,95.0,31190,69.0,33245,196.0,3693,3638,85809,243.0,4029,104.0,1570,14,371,2,15
117,4/10/2021,4445,238404,3173,151630,2370,97471,70.0,31260,70.0,33315,131.0,3824,2007,87816,165.0,4194,67.0,1637,5,376,0,15
118,4/11/2021,1050,239454,797,152427,366,97837,7.0,31267,11.0,33326,16.0,3840,300,88116,38.0,4232,12.0,1649,0,376,0,15
119,4/12/2021,5053,244507,3635,156062,2672,100509,98.0,31365,97.0,33423,102.0,3942,2326,90442,175.0,4407,69.0,1718,12,388,0,15
120,4/13/2021,5051,249558,3567,159629,1516,102025,56.0,31421,77.0,33500,70.0,4012,1320,91762,101.0,4508,25.0,1743,10,398,0,15
121,4/14/2021,2973,252531,1433,161062,1528,103553,85.0,31506,25.0,33525,93.0,4105,1331,93093,74.0,4582,30.0,1773,12,410,0,15
122,4/15/2021,4963,257494,2326,163388,2622,106175,101.0,31607,61.0,33586,219.0,4324,2180,95273,164.0,4746,59.0,1832,16,426,1,16
123,4/16/2021,3927,261421,2080,165468,1830,108005,45.0,31652,35.0,33621,65.0,4389,1598,96871,131.0,4877,36.0,1868,16,442,1,17
124,4/17/2021,4597,266018,2399,167867,2188,110193,38.0,31690,57.0,33678,104.0,4493,1905,98776,133.0,5010,46.0,1914,10,452,1,18
125,4/18/2021,1057,267075,403,168270,647,110840,14.0,31704,10.0,33688,46.0,4539,538,99314,34.0,5044,29.0,1943,6,458,1,19
126,4/19/2021,3869,270944,1409,169679,2446,113286,44.0,31748,39.0,33727,168.0,4707,2055,101369,165.0,5209,58.0,2001,13,471,1,20
127,4/20/2021,4710,275654,1852,171531,2831,116117,46.0,31794,69.0,33796,159.0,4866,2411,103780,197.0,5406,64.0,2065,23,494,4,24
128,4/21/2021,3211,278865,718,172249,2472,118589,36.0,31830,33.0,33829,150.0,5016,2079,105859,166.0,5572,77.0,2142,23,517,0,24
129,4/22/2021,4661,283526,1777,174026,2865,121454,46.0,31876,62.0,33891,144.0,5160,2460,108319,193.0,5765,68.0,2210,19,536,0,24
130,4/23/2021,3597,287123,1175,175201,2411,123865,41.0,31917,31.0,33922,74.0,5234,2124,110443,131.0,5896,82.0,2292,13,549,0,24
131,4/24/2021,3360,290483,1117,176318,2232,126097,14.0,31931,20.0,33942,108.0,5342,1894,112337,191.0,6087,39.0,2331,11,560,0,24
132,4/25/2021,830,291313,364,176682,464,126561,6.0,31937,8.0,33950,107.0,5449,280,112617,39.0,6126,38.0,2369,3,563,0,24
133,4/26/2021,4385,295698,1110,177792,3265,129826,37.0,31974,30.0,33980,151.0,5600,2807,115424,214.0,6340,93.0,2462,12,575,0,24
134,4/27/2021,3366,299064,1189,178981,2182,132008,41.0,32015,38.0,34018,80.0,5680,1920,117344,139.0,6479,43.0,2505,14,589,1,25
135,4/28/2021,3007,302071,716,179697,2302,134310,46.0,32061,21.0,34039,169.0,5849,1864,119208,204.0,6683,65.0,2570,19,608,1,26
136,4/29/2021,3986,306057,822,180519,3172,137482,72.0,32133,32.0,34071,230.0,6079,2599,121807,234.0,6917,109.0,2679,10,618,0,26
137,4/30/2021,2907,308964,645,181164,2269,139751,50.0,32183,24.0,34095,76.0,6155,1927,123734,203.0,7120,63.0,2742,24,642,0,26
138,5/1/2021,3691,312655,819,181983,2847,142598,36.0,32219,19.0,34114,283.0,6438,2222,125956,204.0,7324,138.0,2880,39,681,1,27
139,5/2/2021,548,313203,242,182225,323,142921,7.0,32226,2.0,34116,12.0,6450,259,126215,42.0,7366,10.0,2890,5,686,0,27
140,5/3/2021,3437,316640,639,182864,2809,145730,48.0,32274,33.0,34149,111.0,6561,2410,128625,215.0,7581,73.0,2963,14,700,0,27
141,5/4/2021,4370,321010,693,183557,3729,149459,72.0,32346,27.0,34176,149.0,6710,3202,131827,260.0,7841,118.0,3081,10,710,2,29
142,5/5/2021,2236,323246,476,184033,1812,151271,63.0,32409,24.0,34200,87.0,6797,1502,133329,145.0,7986,78.0,3159,8,718,2,31
143,5/6/2021,3694,326940,820,184853,3044,154315,101.0,32510,39.0,34239,178.0,6975,2531,135860,202.0,8188,133.0,3292,9,727,5,36
144,5/7/2021,2949,329889,538,185391,2546,156861,45.0,32555,11.0,34250,136.0,7111,2096,137956,214.0,8402,100.0,3392,15,742,1,37
145,5/8/2021,3004,332893,562,185953,2608,159469,47.0,32602,16.0,34266,168.0,7279,2115,140071,194.0,8596,131.0,3523,10,752,0,37
146,5/9/2021,377,333270,144,186097,247,159716,4.0,32606,2.0,34268,11.0,7290,206,140277,21.0,8617,9.0,3532,3,755,0,37
147,5/10/2021,2450,335720,382,186479,2128,161844,65.0,32671,16.0,34284,92.0,7382,1732,142009,205.0,8822,99.0,3631,8,763,3,40
148,5/11/2021,2729,338449,535,187014,2247,164091,95.0,32766,23.0,34307,192.0,7574,1754,143763,205.0,9027,96.0,3727,16,779,1,41
149,5/12/2021,1247,339696,463,187477,868,164959,28.0,32794,14.0,34321,53.0,7627,691,144454,86.0,9113,38.0,3765,7,786,0,41
150,5/13/2021,3273,342969,1032,188509,2270,167229,86.0,32880,25.0,34346,149.0,7776,1850,146304,165.0,9278,106.0,3871,11,797,4,45
151,5/14/2021,2480,345449,1282,189791,1331,168560,58.0,32938,30.0,34376,66.0,7842,1112,147416,100.0,9378,53.0,3924,12,809,2,47
152,5/15/2021,3039,348488,1511,191302,1656,170216,44.0,32982,17.0,34393,118.0,7960,1316,148732,148.0,9526,74.0,3998,6,815,3,50
153,5/16/2021,945,349433,546,191848,443,170659,11.0,32993,5.0,34398,87.0,8047,282,149014,32.0,9558,42.0,4040,1,816,2,52
154,5/17/2021,2439,351872,1206,193054,1331,171990,36.0,33029,27.0,34425,51.0,8098,1114,150128,107.0,9665,59.0,4099,5,821,1,53
155,5/18/2021,2581,354453,1168,194222,1455,173445,45.0,33074,22.0,34447,72.0,8170,1232,151360,85.0,9750,66.0,4165,8,829,4,57
156,5/19/2021,1891,356344,1155,195377,816,174261,28.0,33102,20.0,34467,43.0,8213,663,152023,70.0,9820,40.0,4205,4,833,1,58
157,5/20/2021,1990,358334,935,196312,1112,175373,45.0,33147,28.0,34495,95.0,8308,890,152913,79.0,9899,48.0,4253,9,842,2,60
158,5/21/2021,1658,359992,925,197237,833,176206,21.0,33168,15.0,34510,44.0,8352,666,153579,65.0,9964,58.0,4311,17,859,3,63
159,5/22/2021,1698,361690,798,198035,939,177145,9.0,33177,13.0,34523,123.0,8475,656,154235,76.0,10040,84.0,4395,9,868,3,66
160,5/23/2021,685,362375,341,198376,375,177520,2.0,33179,5.0,34528,67.0,8542,232,154467,21.0,10061,55.0,4450,1,869,0,66
161,5/24/2021,1348,363723,539,198915,882,178402,36.0,33215,20.0,34548,41.0,8583,712,155179,85.0,10146,44.0,4494,12,881,2,68
162,5/25/2021,1233,364956,509,199424,767,179169,24.0,33239,19.0,34567,57.0,8640,579,155758,66.0,10212,65.0,4559,8,889,0,68
163,5/26/2021,969,365925,548,199972,560,179729,20.0,33259,25.0,34592,41.0,8681,443,156201,45.0,10257,31.0,4590,3,892,1,69
164,5/27/2021,1315,367240,670,200642,730,180459,32.0,33291,21.0,34613,58.0,8739,587,156788,55.0,10312,30.0,4620,6,898,1,70
165,5/28/2021,1048,368288,605,201247,505,180964,20.0,33311,22.0,34635,34.0,8773,392,157180,52.0,10364,27.0,4647,11,909,0,70
166,5/29/2021,1021,369309,492,201739,574,181538,19.0,33330,8.0,34643,33.0,8806,456,157636,44.0,10408,41.0,4688,6,915,0,70
167,5/30/2021,334,369643,218,201957,152,181690,5.0,33335,3.0,34646,14.0,8820,109,157745,18.0,10426,11.0,4699,3,918,2,72
168,5/31/2021,343,369986,192,202149,178,181868,8.0,33343,6.0,34652,7.0,8827,149,157894,11.0,10437,11.0,4710,11,929,1,73
169,6/1/2021,1020,371006,410,202559,634,182502,29.0,33372,18.0,34670,51.0,8878,489,158383,47.0,10484,47.0,4757,37,966,1,74
170,6/2/2021,722,371728,369,202928,419,182921,16.0,33388,8.0,34678,35.0,8913,334,158717,24.0,10508,26.0,4783,3,969,1,75
171,6/3/2021,1318,373046,524,203452,860,183781,23.0,33411,12.0,34690,51.0,8964,709,159426,60.0,10568,40.0,4823,4,973,0,75
172,6/4/2021,1503,374549,400,203852,1156,184937,15.0,33426,10.0,34700,71.0,9035,970,160396,69.0,10637,46.0,4869,3,976,1,76
173,6/5/2021,1426,375975,364,204216,1092,186029,12.0,33438,6.0,34706,63.0,9098,891,161287,96.0,10733,42.0,4911,10,986,1,77
174,6/6/2021,563,376538,147,204363,436,186465,5.0,33443,3.0,34709,50.0,9148,345,161632,28.0,10761,13.0,4924,1,987,0,77
175,6/7/2021,1199,377737,342,204705,916,187381,16.0,33459,12.0,34721,67.0,9215,734,162366,82.0,10843,33.0,4957,7,994,1,78
176,6/8/2021,1097,378834,252,204957,875,188256,18.0,33477,5.0,34726,59.0,9274,712,163078,71.0,10914,33.0,4990,7,1001,0,78
177,6/9/2021,1085,379919,282,205239,858,189114,15.0,33492,11.0,34737,77.0,9351,663,163741,75.0,10989,43.0,5033,4,1005,1,79
178,6/10/2021,1334,381253,344,205583,1036,190150,21.0,33513,4.0,34741,95.0,9446,815,164556,71.0,11060,55.0,5088,11,1016,1,80
179,6/11/2021,1112,382365,321,205904,845,190995,20.0,33533,13.0,34754,60.0,9506,659,165215,81.0,11141,45.0,5133,2,1018,1,81
180,6/12/2021,1052,383417,288,206192,815,191810,16.0,33549,9.0,34763,72.0,9578,633,165848,68.0,11209,42.0,5175,1,1019,0,81
181,6/13/2021,370,383787,97,206289,291,192101,4.0,33553,1.0,34764,35.0,9613,211,166059,25.0,11234,20.0,5195,3,1022,0,81
182,6/14/2021,844,384631,290,206579,610,192711,15.0,33568,4.0,34768,47.0,9660,463,166522,44.0,11278,56.0,5251,3,1025,0,81
183,6/15/2021,706,385337,243,206822,488,193199,21.0,33589,10.0,34778,43.0,9703,393,166915,34.0,11312,18.0,5269,1,1026,1,82
184,6/16/2021,640,385977,208,207030,468,193667,13.0,33602,5.0,34783,40.0,9743,350,167265,39.0,11351,39.0,5308,4,1030,0,82
185,6/17/2021,703,386680,255,207285,475,194142,15.0,33617,9.0,34792,44.0,9787,351,167616,51.0,11402,29.0,5337,7,1037,1,83
186,6/18/2021,1046,387726,378,207663,704,194846,22.0,33639,11.0,34803,55.0,9842,562,168178,57.0,11459,30.0,5367,12,1049,0,83
187,6/19/2021,642,388368,153,207816,510,195356,10.0,33649,6.0,34809,51.0,9893,378,168556,54.0,11513,27.0,5394,4,1053,0,83
188,6/20/2021,296,388664,111,207927,193,195549,3.0,33652,2.0,34811,37.0,9930,119,168675,15.0,11528,22.0,5416,5,1058,0,83
189,6/21/2021,522,389186,217,208144,339,195888,5.0,33657,7.0,34818,30.0,9960,253,168928,34.0,11562,22.0,5438,4,1062,0,83
190,6/22/2021,617,389803,253,208397,402,196290,12.0,33669,8.0,34826,32.0,9992,314,169242,28.0,11590,28.0,5466,2,1064,0,83
191,6/23/2021,513,390316,185,208582,353,196643,8.0,33677,10.0,34836,42.0,10034,254,169496,34.0,11624,23.0,5489,11,1075,1,84
192,6/24/2021,536,390852,208,208790,355,196998,13.0,33690,9.0,34845,35.0,10069,274,169770,24.0,11648,22.0,5511,2,1077,0,84
193,6/25/2021,692,391544,274,209064,442,197440,13.0,33703,9.0,34854,44.0,10113,330,170100,42.0,11690,26.0,5537,3,1080,0,84
194,6/26/2021,605,392149,164,209228,455,197895,9.0,33712,9.0,34863,79.0,10192,300,170400,47.0,11737,29.0,5566,3,1083,1,85
195,6/27/2021,183,392332,67,209295,118,198013,2.0,33714,3.0,34866,10.0,10202,86,170486,12.0,11749,10.0,5576,2,1085,0,85
196,6/28/2021,489,392821,206,209501,290,198303,7.0,33721,6.0,34872,40.0,10242,206,170692,26.0,11775,18.0,5594,8,1093,0,85
197,6/29/2021,564,393385,254,209755,341,198644,17.0,33738,11.0,34883,43.0,10285,250,170942,23.0,11798,25.0,5619,8,1101,2,87
198,6/30/2021,422,393807,206,209961,230,198874,8.0,33746,11.0,34894,20.0,10305,173,171115,17.0,11815,20.0,5639,7,1108,2,89
199,7/1/2021,511,394318,215,210176,309,199183,9.0,33755,7.0,34901,23.0,10328,231,171346,34.0,11849,21.0,5660,13,1121,2,91
200,7/2/2021,570,394888,272,210448,311,199494,7.0,33762,7.0,34908,28.0,10356,244,171590,24.0,11873,15.0,5675,6,1127,0,91
201,7/3/2021,306,395194,120,210568,193,199687,4.0,33766,3.0,34911,28.0,10384,126,171716,20.0,11893,19.0,5694,5,1132,0,91
202,7/4/2021,55,395249,20,210588,35,199722,1.0,33767,0.0,34911,4.0,10388,22,171738,1.0,11894,8.0,5702,0,1132,0,91
203,7/5/2021,320,395569,141,210729,176,199898,3.0,33770,1.0,34912,18.0,10406,122,171860,26.0,11920,10.0,5712,9,1141,0,91
204,7/6/2021,468,396037,191,210920,288,200186,4.0,33774,5.0,34917,46.0,10452,207,172067,21.0,11941,14.0,5726,3,1144,0,91
205,7/7/2021,384,396421,214,211134,188,200374,8.0,33782,6.0,34923,23.0,10475,136,172203,13.0,11954,16.0,5742,5,1149,0,91
206,7/8/2021,432,396853,203,211337,253,200627,9.0,33791,8.0,34931,25.0,10500,177,172380,26.0,11980,25.0,5767,3,1152,1,92
207,7/9/2021,479,397332,193,211530,297,200924,10.0,33801,2.0,34933,39.0,10539,216,172596,24.0,12004,18.0,5785,2,1154,2,94
208,7/10/2021,266,397598,153,211683,133,201057,5.0,33806,2.0,34935,5.0,10544,110,172706,10.0,12014,8.0,5793,2,1156,0,94
209,7/11/2021,223,397821,120,211803,125,201182,6.0,33812,7.0,34942,11.0,10555,93,172799,9.0,12023,12.0,5805,8,1164,2,96
210,7/12/2021,390,398211,204,212007,199,201381,6.0,33818,4.0,34946,27.0,10582,133,172932,22.0,12045,17.0,5822,4,1168,0,96
211,7/13/2021,437,398648,225,212232,233,201614,17.0,33835,9.0,34955,28.0,10610,181,173113,12.0,12057,12.0,5834,4,1172,0,96
212,7/14/2021,290,398938,156,212388,161,201775,8.0,33843,5.0,34960,19.0,10629,118,173231,9.0,12066,15.0,5849,4,1176,1,97
213,7/15/2021,367,399305,189,212577,186,201961,1.0,33844,4.0,34964,16.0,10645,139,173370,14.0,12080,17.0,5866,6,1182,0,97
214,7/16/2021,511,399816,245,212822,282,202243,8.0,33852,9.0,34973,24.0,10669,214,173584,22.0,12102,22.0,5888,1,1183,0,97
215,7/17/2021,273,400089,156,212978,136,202379,12.0,33864,4.0,34977,13.0,10682,105,173689,8.0,12110,10.0,5898,3,1186,0,97
216,7/18/2021,195,400284,117,213095,94,202473,4.0,33868,3.0,34980,13.0,10695,67,173756,7.0,12117,7.0,5905,3,1189,0,97
217,7/19/2021,407,400691,206,213301,209,202682,9.0,33877,8.0,34988,26.0,10721,153,173909,18.0,12135,12.0,5917,3,1192,2,99
218,7/20/2021,426,401117,215,213516,220,202902,6.0,33883,8.0,34996,13.0,10734,169,174078,24.0,12159,14.0,5931,6,1198,1,100
219,7/21/2021,343,401460,187,213703,176,203078,14.0,33897,14.0,35010,13.0,10747,132,174210,14.0,12173,17.0,5948,4,1202,1,101
220,7/22/2021,403,401863,235,213938,178,203256,7.0,33904,17.0,35027,21.0,10768,131,174341,18.0,12191,8.0,5956,6,1208,1,102
221,7/23/2021,555,402418,324,214262,239,203495,7.0,33911,10.0,35037,37.0,10805,165,174506,19.0,12210,18.0,5974,6,1214,0,102
222,7/24/2021,351,402769,213,214475,160,203655,9.0,33920,9.0,35046,20.0,10825,117,174623,9.0,12219,14.0,5988,3,1217,1,103
223,7/25/2021,192,402961,139,214614,65,203720,0.0,33920,4.0,35050,7.0,10832,47,174670,5.0,12224,6.0,5994,4,1221,0,103
224,7/26/2021,356,403317,207,214821,151,203871,2.0,33922,6.0,35056,11.0,10843,103,174773,18.0,12242,19.0,6013,10,1231,0,103
225,7/27/2021,430,403747,235,215056,182,204053,5.0,33927,16.0,35072,23.0,10866,126,174899,20.0,12262,13.0,6026,27,1258,0,103
226,7/28/2021,473,404220,284,215340,227,204280,4.0,33931,10.0,35082,30.0,10896,149,175048,17.0,12279,31.0,6057,4,1262,2,105
227,7/29/2021,516,404736,312,215652,235,204515,8.0,33939,7.0,35089,25.0,10921,179,175227,13.0,12292,18.0,6075,13,1275,1,106
228,7/30/2021,701,405437,485,216137,254,204769,10.0,33949,14.0,35103,29.0,10950,190,175417,17.0,12309,18.0,6093,9,1284,1,107
229,7/31/2021,338,405775,200,216337,139,204908,4.0,33953,1.0,35104,16.0,10966,110,175527,8.0,12317,5.0,6098,11,1295,0,107
230,8/1/2021,301,406076,177,216514,106,205014,0.0,33953,2.0,35106,14.0,10980,67,175594,9.0,12326,16.0,6114,33,1328,3,110
231,8/2/2021,450,406526,297,216811,182,205196,5.0,33958,14.0,35120,23.0,11003,126,175720,19.0,12345,14.0,6128,7,1335,2,112
232,8/3/2021,564,407090,346,217157,247,205443,6.0,33964,14.0,35134,40.0,11043,165,175885,15.0,12360,27.0,6155,5,1340,1,113
233,8/4/2021,400,407490,278,217435,154,205597,6.0,33970,14.0,35148,11.0,11054,115,176000,8.0,12368,20.0,6175,2,1342,1,114
234,8/5/2021,449,407939,289,217724,173,205770,6.0,33976,11.0,35159,21.0,11075,126,176126,16.0,12384,10.0,6185,8,1350,0,114
235,8/6/2021,687,408626,462,218186,277,206047,13.0,33989,16.0,35175,23.0,11098,207,176333,24.0,12408,23.0,6208,8,1358,0,114
236,8/7/2021,446,409072,311,218497,159,206206,4.0,33993,11.0,35186,12.0,11110,128,176461,5.0,12413,14.0,6222,5,1363,1,115
237,8/8/2021,218,409290,125,218622,100,206306,3.0,33996,5.0,35191,8.0,11118,71,176532,9.0,12422,12.0,6234,5,1368,3,118
238,8/9/2021,464,409754,276,218898,222,206528,4.0,34000,6.0,35197,21.0,11139,167,176699,11.0,12433,23.0,6257,6,1374,2,120
239,8/10/2021,502,410256,295,219193,232,206760,6.0,34006,13.0,35210,26.0,11165,179,176878,13.0,12446,14.0,6271,5,1379,4,124
240,8/11/2021,417,410673,261,219454,182,206942,11.0,34017,5.0,35215,18.0,11183,137,177015,14.0,12460,13.0,6284,3,1382,0,124
241,8/12/2021,542,411215,319,219773,266,207208,7.0,34024,15.0,35230,32.0,11215,188,177203,22.0,12482,24.0,6308,8,1390,2,126
242,8/13/2021,659,411874,376,220149,303,207511,10.0,34034,10.0,35240,30.0,11245,223,177426,19.0,12501,31.0,6339,7,1397,1,127
243,8/14/2021,511,412385,259,220408,258,207769,7.0,34041,8.0,35248,11.0,11256,219,177645,10.0,12511,18.0,6357,53,1450,2,129
244,8/15/2021,268,412653,131,220539,123,207892,2.0,34043,2.0,35250,11.0,11267,89,177734,6.0,12517,17.0,6374,22,1472,0,129
245,8/16/2021,541,413194,311,220850,179,208071,4.0,34047,11.0,35261,15.0,11282,140,177874,12.0,12529,12.0,6386,81,1553,3,132
246,8/17/2021,488,413682,229,221079,196,208267,17.0,34064,10.0,35271,17.0,11299,147,178021,11.0,12540,21.0,6407,89,1642,0,132
247,8/18/2021,593,414275,324,221403,272,208539,6.0,34070,14.0,35285,32.0,11331,184,178205,14.0,12554,42.0,6449,73,1715,4,136
248,8/19/2021,573,414848,281,221684,268,208807,7.0,34077,9.0,35294,21.0,11352,210,178415,22.0,12576,15.0,6464,84,1799,1,137
249,8/20/2021,851,415699,335,222019,473,209280,16.0,34093,12.0,35306,46.0,11398,374,178789,30.0,12606,23.0,6487,97,1896,1,138
250,8/21/2021,647,416346,211,222230,213,209493,6.0,34099,7.0,35313,15.0,11413,175,178964,13.0,12619,10.0,6497,234,2130,0,138
251,8/22/2021,311,416657,149,222379,138,209631,1.0,34100,2.0,35315,19.0,11432,98,179062,9.0,12628,12.0,6509,32,2162,2,140
252,8/23/2021,529,417186,261,222640,225,209856,11.0,34111,10.0,35325,20.0,11452,169,179231,13.0,12641,23.0,6532,66,2228,1,141
253,8/24/2021,574,417760,276,222916,283,210139,12.0,34123,8.0,35333,29.0,11481,223,179454,14.0,12655,17.0,6549,58,2286,2,143
254,8/25/2021,607,418367,326,223242,269,210408,13.0,34136,13.0,35346,22.0,11503,204,179658,10.0,12665,33.0,6582,55,2341,2,145
255,8/26/2021,545,418912,260,223502,261,210669,10.0,34146,13.0,35359,18.0,11521,202,179860,23.0,12688,18.0,6600,56,2397,0,145
256,8/27/2021,900,419812,355,223857,406,211075,15.0,34161,11.0,35370,38.0,11559,299,180159,25.0,12713,44.0,6644,177,2574,6,151
257,8/28/2021,1455,421267,200,224057,248,211323,8.0,34169,5.0,35375,23.0,11582,185,180344,13.0,12726,27.0,6671,1000,3574,13,164
258,8/29/2021,1075,422342,159,224216,140,211463,4.0,34173,4.0,35379,9.0,11591,114,180458,12.0,12738,5.0,6676,771,4345,10,174
259,8/30/2021,620,422962,269,224485,285,211748,10.0,34183,13.0,35392,24.0,11615,220,180678,8.0,12746,33.0,6709,97,4442,5,179
260,8/31/2021,804,423766,232,224717,230,211978,7.0,34190,12.0,35404,20.0,11635,181,180859,17.0,12763,12.0,6721,346,4788,8,187
261,9/1/2021,986,424752,254,224971,228,212206,13.0,34203,16.0,35420,21.0,11656,175,181034,14.0,12777,18.0,6739,523,5311,3,190
262,9/2/2021,826,425578,183,225154,205,212411,14.0,34217,13.0,35433,19.0,11675,151,181185,17.0,12794,18.0,6757,460,5771,4,194
263,9/3/2021,850,426428,335,225489,373,212784,14.0,34231,11.0,35444,44.0,11719,274,181459,21.0,12815,34.0,6791,163,5934,2,196
264,9/4/2021,376,426804,161,225650,175,212959,7.0,34238,8.0,35452,14.0,11733,138,181597,11.0,12826,12.0,6803,48,5982,2,198
265,9/5/2021,250,427054,130,225780,108,213067,2.0,34240,4.0,35456,13.0,11746,79,181676,8.0,12834,8.0,6811,23,6005,0,198
266,9/6/2021,113,427167,44,225824,61,213128,1.0,34241,0.0,35456,4.0,11750,45,181721,8.0,12842,4.0,6815,13,6018,0,198
267,9/7/2021,949,428116,199,226023,279,213407,18.0,34259,12.0,35468,22.0,11772,216,181937,17.0,12859,24.0,6839,481,6499,4,202
268,9/8/2021,784,428900,220,226243,228,213635,11.0,34270,12.0,35480,25.0,11797,170,182107,11.0,12870,22.0,6861,358,6857,4,206
269,9/9/2021,407,429307,178,226421,196,213831,10.0,34280,8.0,35488,23.0,11820,144,182251,14.0,12884,15.0,6876,55,6912,1,207
270,9/10/2021,767,430074,347,226768,319,214150,9.0,34289,23.0,35511,28.0,11848,241,182492,21.0,12905,29.0,6905,141,7053,4,211
271,9/11/2021,1615,431689,160,226928,205,214355,11.0,34300,18.0,35529,17.0,11865,156,182648,16.0,12921,16.0,6921,1258,8311,7,218
272,9/12/2021,233,431922,102,227030,113,214468,0.0,34300,2.0,35531,11.0,11876,73,182721,10.0,12931,19.0,6940,16,8327,2,220
273,9/13/2021,502,432424,218,227248,255,214723,9.0,34309,8.0,35539,25.0,11901,191,182912,12.0,12943,27.0,6967,50,8377,0,220
274,9/14/2021,848,433272,205,227453,278,215001,13.0,34322,14.0,35553,17.0,11918,225,183137,14.0,12957,22.0,6989,397,8774,3,223
275,9/15/2021,829,434101,189,227642,271,215272,15.0,34337,14.0,35567,21.0,11939,200,183337,17.0,12974,33.0,7022,394,9168,3,226
276,9/16/2021,370,434471,138,227780,201,215473,9.0,34346,8.0,35575,33.0,11972,145,183482,12.0,12986,11.0,7033,47,9215,0,226
277,9/17/2021,751,435222,288,228068,396,215869,15.0,34361,13.0,35588,29.0,12001,297,183779,40.0,13026,30.0,7063,119,9334,2,228
278,9/18/2021,1806,437028,127,228195,171,216040,5.0,34366,19.0,35607,11.0,12012,127,183906,16.0,13042,17.0,7080,1508,10842,10,238
279,9/19/2021,187,437215,79,228274,107,216147,3.0,34369,2.0,35609,7.0,12019,83,183989,5.0,13047,12.0,7092,14,10856,0,238
280,9/20/2021,388,437603,143,228417,222,216369,8.0,34377,9.0,35618,28.0,12047,163,184152,11.0,13058,20.0,7112,55,10911,0,238
281,9/21/2021,779,438382,164,228581,206,216575,8.0,34385,13.0,35631,22.0,12069,156,184308,12.0,13070,16.0,7128,422,11333,3,241
282,9/22/2021,724,439106,163,228744,234,216809,5.0,34390,11.0,35642,14.0,12083,187,184495,16.0,13086,17.0,7145,361,11694,6,247
283,9/23/2021,353,439459,146,228890,179,216988,8.0,34398,4.0,35646,9.0,12092,132,184627,14.0,13100,24.0,7169,48,11742,2,249
284,9/24/2021,692,440151,204,229094,278,217266,16.0,34414,15.0,35661,20.0,12112,219,184846,12.0,13112,27.0,7196,232,11974,2,251
285,9/25/2021,1711,441862,132,229226,177,217443,11.0,34425,21.0,35682,15.0,12127,139,184985,11.0,13123,12.0,7208,1407,13381,4,255
286,9/26/2021,258,442120,66,229292,84,217527,3.0,34428,3.0,35685,11.0,12138,62,185047,4.0,13127,7.0,7215,106,13487,2,257
287,9/27/2021,568,442688,155,229447,121,217648,7.0,34435,10.0,35695,7.0,12145,93,185140,8.0,13135,13.0,7228,308,13795,1,258
288,9/28/2021,1140,443828,158,229605,203,217851,19.0,34454,23.0,35718,14.0,12159,154,185294,10.0,13145,25.0,7253,798,14593,4,262
289,9/29/2021,1133,444961,173,229778,168,218019,10.0,34464,21.0,35739,15.0,12174,126,185420,8.0,13153,19.0,7272,804,15397,5,267
290,9/30/2021,710,445671,161,229939,171,218190,15.0,34479,7.0,35746,11.0,12185,132,185552,11.0,13164,17.0,7289,402,15799,8,275
291,10/1/2021,1186,446857,176,230115,311,218501,20.0,34499,15.0,35761,25.0,12210,243,185795,21.0,13185,22.0,7311,709,16508,11,286
292,10/2/2021,1801,448658,113,230228,112,218613,10.0,34509,13.0,35774,9.0,12219,92,185887,6.0,13191,5.0,7316,1572,18080,8,294
293,10/3/2021,398,449056,64,230292,113,218726,1.0,34510,2.0,35776,19.0,12238,77,185964,7.0,13198,10.0,7326,234,18314,0,294
294,10/4/2021,802,449858,114,230406,159,218885,7.0,34517,13.0,35789,27.0,12265,102,186066,17.0,13215,13.0,7339,534,18848,4,298
295,10/5/2021,1130,450988,138,230544,138,219023,11.0,34528,18.0,35807,13.0,12278,103,186169,9.0,13224,13.0,7352,868,19716,1,299
296,10/6/2021,1014,452002,111,230655,155,219178,7.0,34535,16.0,35823,11.0,12289,124,186293,5.0,13229,15.0,7367,763,20479,4,303
297,10/7/2021,827,452829,139,230794,113,219291,8.0,34543,17.0,35840,8.0,12297,89,186382,6.0,13235,10.0,7377,596,21075,1,304
298,10/8/2021,1039,453868,160,230954,247,219538,19.0,34562,10.0,35850,22.0,12319,192,186574,11.0,13246,22.0,7399,649,21724,0,304
299,10/9/2021,1678,455546,108,231062,132,219670,11.0,34573,6.0,35856,22.0,12341,98,186672,4.0,13250,8.0,7407,1434,23158,8,312
300,10/10/2021,244,455790,51,231113,65,219735,1.0,34574,3.0,35859,5.0,12346,51,186723,4.0,13254,5.0,7412,127,23285,2,314
301,10/11/2021,822,456612,118,231231,136,219871,16.0,34590,19.0,35878,3.0,12349,112,186835,9.0,13263,12.0,7424,574,23859,5,319
302,10/12/2021,1025,457637,112,231343,134,220005,8.0,34598,16.0,35894,17.0,12366,105,186940,4.0,13267,8.0,7432,789,24648,3,322
303,10/13/2021,974,458611,123,231466,152,220157,16.0,34614,10.0,35904,16.0,12382,113,187053,14.0,13281,9.0,7441,714,25362,9,331
304,10/14/2021,716,459327,99,231565,125,220282,14.0,34628,8.0,35912,20.0,12402,92,187145,8.0,13289,5.0,7446,498,25860,5,336
305,10/15/2021,1033,460360,177,231742,214,220496,12.0,34640,8.0,35920,15.0,12417,168,187313,12.0,13301,19.0,7465,671,26531,8,344
306,10/16/2021,806,461166,67,231809,81,220577,4.0,34644,3.0,35923,7.0,12424,69,187382,2.0,13303,3.0,7468,654,27185,7,351
307,10/17/2021,194,461360,47,231856,62,220639,1.0,34645,2.0,35925,4.0,12428,47,187429,2.0,13305,9.0,7477,83,27268,2,353
308,10/18/2021,661,462021,117,231973,136,220775,10.0,34655,3.0,35928,13.0,12441,106,187535,7.0,13312,10.0,7487,422,27690,4,357
309,10/19/2021,1058,463079,127,232100,133,220908,3.0,34658,12.0,35940,8.0,12449,107,187642,8.0,13320,10.0,7497,809,28499,3,360
310,10/20/2021,898,463977,122,232222,121,221029,7.0,34665,13.0,35953,9.0,12458,90,187732,7.0,13327,15.0,7512,666,29165,8,368
311,10/21/2021,542,464519,109,232331,127,221156,10.0,34675,7.0,35960,13.0,12471,85,187817,11.0,13338,18.0,7530,326,29491,5,373
312,10/22/2021,1490,466009,194,232525,161,221317,7.0,34682,13.0,35973,18.0,12489,109,187926,8.0,13346,26.0,7556,1151,30642,9,382
313,10/23/2021,1858,467867,87,232612,76,221393,9.0,34691,14.0,35987,1.0,12490,64,187990,4.0,13350,7.0,7563,1689,32331,11,393
314,10/24/2021,594,468461,81,232693,73,221466,6.0,34697,9.0,35996,7.0,12497,57,188047,4.0,13354,5.0,7568,446,32777,5,398
315,10/25/2021,1476,469937,142,232835,113,221579,19.0,34716,19.0,36015,8.0,12505,90,188137,7.0,13361,8.0,7576,1224,34001,12,410
316,10/26/2021,2129,472066,174,233009,135,221714,7.0,34723,17.0,36032,15.0,12520,101,188238,8.0,13369,11.0,7587,1813,35814,20,430
317,10/27/2021,1974,474040,148,233157,110,221824,6.0,34729,17.0,36049,5.0,12525,88,188326,10.0,13379,7.0,7594,1723,37537,9,439
318,10/28/2021,1791,475831,140,233297,114,221938,4.0,34733,23.0,36072,6.0,12531,92,188418,4.0,13383,12.0,7606,1530,39067,16,455
319,10/29/2021,1728,477559,179,233476,132,222070,4.0,34737,15.0,36087,8.0,12539,107,188525,5.0,13388,12.0,7618,1415,40482,14,469
320,10/30/2021,1582,479141,79,233555,80,222150,5.0,34742,8.0,36095,6.0,12545,62,188587,7.0,13395,5.0,7623,1415,41897,17,486
321,10/31/2021,461,479602,48,233603,37,222187,1.0,34743,6.0,36101,7.0,12552,27,188614,1.0,13396,2.0,7625,372,42269,4,490
322,11/1/2021,1343,480945,147,233750,114,222301,3.0,34746,12.0,36113,10.0,12562,79,188693,7.0,13403,18.0,7643,1079,43348,15,505
323,11/2/2021,1848,482793,128,233878,104,222405,8.0,34754,16.0,36129,11.0,12573,76,188769,7.0,13410,10.0,7653,1613,44961,18,523
324,11/3/2021,1754,484547,159,234037,119,222524,9.0,34763,20.0,36149,10.0,12583,84,188853,6.0,13416,19.0,7672,1476,46437,19,542
325,11/4/2021,1418,485965,145,234182,92,222616,4.0,34767,13.0,36162,1.0,12584,75,188928,5.0,13421,11.0,7683,1201,47638,9,551
326,11/5/2021,2044,488009,225,234407,171,222787,12.0,34779,11.0,36173,11.0,12595,139,189067,8.0,13429,13.0,7696,1666,49304,15,566
327,11/6/2021,1585,489594,217,234624,76,222863,2.0,34781,8.0,36181,5.0,12600,62,189129,4.0,13433,5.0,7701,1282,50586,18,584
328,11/7/2021,530,490124,125,234749,41,222904,1.0,34782,8.0,36189,4.0,12604,31,189160,0.0,13433,6.0,7707,358,50944,7,591
329,11/8/2021,1524,491648,385,235134,108,223012,6.0,34788,9.0,36198,8.0,12612,87,189247,2.0,13435,11.0,7718,1042,51986,8,599
330,11/9/2021,2660,494308,942,236076,132,223144,5.0,34793,19.0,36217,11.0,12623,87,189334,9.0,13444,25.0,7743,1594,53580,14,613
331,11/10/2021,2521,496829,822,236898,114,223258,7.0,34800,16.0,36233,9.0,12632,85,189419,10.0,13454,10.0,7753,1585,55165,20,633
332,11/11/2021,2352,499181,959,237857,98,223356,6.0,34806,8.0,36241,11.0,12643,70,189489,11.0,13465,6.0,7759,1296,56461,21,654
333,11/12/2021,2586,501767,752,238609,141,223497,9.0,34815,19.0,36260,14.0,12657,107,189596,9.0,13474,11.0,7770,1682,58143,25,679
334,11/13/2021,1933,503700,404,239013,69,223566,2.0,34817,10.0,36270,4.0,12661,46,189642,7.0,13481,12.0,7782,1458,59601,11,690
335,11/14/2021,1493,505193,910,239923,57,223623,1.0,34818,2.0,36272,7.0,12668,35,189677,6.0,13487,9.0,7791,534,60135,2,692
336,11/15/2021,1990,507183,442,240365,101,223724,5.0,34823,11.0,36283,12.0,12680,69,189746,7.0,13494,13.0,7804,1451,61586,10,702
337,11/16/2021,2438,509621,448,240813,106,223830,3.0,34826,18.0,36301,16.0,12696,73,189819,7.0,13501,10.0,7814,1870,63456,27,729
338,11/17/2021,2753,512374,635,241448,130,223960,7.0,34833,19.0,36320,9.0,12705,105,189924,6.0,13507,10.0,7824,1977,65433,34,763
339,11/18/2021,2034,514408,384,241832,108,224068,6.0,34839,11.0,36331,10.0,12715,81,190005,11.0,13518,6.0,7830,1530,66963,28,791
340,11/19/2021,2592,517000,720,242552,157,224225,3.0,34842,16.0,36347,11.0,12726,126,190131,10.0,13528,10.0,7840,1708,68671,27,818
341,11/20/2021,1894,518894,538,243090,46,224271,2.0,34844,5.0,36352,4.0,12730,36,190167,2.0,13530,4.0,7844,1296,69967,18,836
342,11/21/2021,660,519554,122,243212,43,224314,0.0,34844,1.0,36353,2.0,12732,31,190198,3.0,13533,7.0,7851,491,70458,6,842
343,11/22/2021,2011,521565,425,243637,113,224427,8.0,34852,20.0,36373,1.0,12733,91,190289,7.0,13540,14.0,7865,1466,71924,26,868
344,11/23/2021,1875,523440,286,243923,93,224520,4.0,34856,16.0,36389,9.0,12742,69,190358,9.0,13549,6.0,7871,1493,73417,13,881
345,11/24/2021,1541,524981,215,244138,94,224614,4.0,34860,11.0,36400,10.0,12752,73,190431,5.0,13554,6.0,7877,1239,74656,8,889
346,11/25/2021,49,525030,9,244147,0,224614,0.0,34860,0.0,36400,0.0,12752,0,190431,0.0,13554,,7877,38,74694,2,891
347,11/26/2021,1276,526306,192,244339,145,224759,2.0,34862,4.0,36404,14.0,12766,114,190545,11.0,13565,6.0,7883,952,75646,5,896
348,11/27/2021,973,527279,135,244474,124,224883,2.0,34864,2.0,36406,9.0,12775,102,190647,6.0,13571,7.0,7890,712,76358,7,903
349,11/28/2021,550,527829,92,244566,84,224967,2.0,34866,1.0,36407,6.0,12781,66,190713,5.0,13576,7.0,7897,373,76731,5,908
350,11/29/2021,1885,529714,260,244826,334,225301,7.0,34873,13.0,36420,25.0,12806,274,190987,23.0,13599,12.0,7909,1283,78014,19,927
351,11/30/2021,2717,532431,340,245166,717,226018,2.0,34875,12.0,36432,46.0,12852,608,191595,50.0,13649,13.0,7922,1643,79657,34,961
352,12/1/2021,2543,534974,268,245434,658,226676,6.0,34881,11.0,36443,28.0,12880,574,192169,52.0,13701,4.0,7926,1600,81257,30,991
353,12/2/2021,2864,537838,355,245789,837,227513,6.0,34887,14.0,36457,64.0,12944,679,192848,70.0,13771,24.0,7950,1658,82915,33,1024
354,12/3/2021,2624,540462,279,246068,678,228191,9.0,34896,4.0,36461,58.0,13002,532,193380,64.0,13835,24.0,7974,1669,84584,14,1038
355,12/4/2021,2204,542666,159,246227,357,228548,3.0,34899,1.0,36462,18.0,13020,278,193658,30.0,13865,31.0,8005,1682,86266,11,1049
356,12/5/2021,1392,544058,98,246325,817,229365,1.0,34900,0.0,36462,66.0,13086,648,194306,72.0,13937,31.0,8036,480,86746,4,1053
357,12/6/2021,1964,546022,236,246561,388,229753,5.0,34905,6.0,36468,49.0,13135,294,194600,30.0,13967,15.0,8051,1340,88086,12,1065
358,12/7/2021,2480,548502,304,246865,374,230127,6.0,34911,8.0,36476,42.0,13177,293,194893,23.0,13990,16.0,8067,1799,89885,20,1085
359,12/8/2021,2258,550760,267,247132,437,230564,5.0,34916,12.0,36488,32.0,13209,359,195252,35.0,14025,11.0,8078,1558,91443,13,1098
360,12/9/2021,2193,552953,302,247434,397,230961,1.0,34917,8.0,36496,24.0,13233,305,195557,35.0,14060,33.0,8111,1491,92934,13,1111
361,12/10/2021,2108,555061,233,247667,330,231291,7.0,34924,8.0,36504,34.0,13267,246,195803,27.0,14087,23.0,8134,1535,94469,18,1129
362,12/11/2021,1798,556859,134,247801,457,231748,3.0,34927,1.0,36505,60.0,13327,336,196139,37.0,14124,24.0,8158,1199,95668,8,1137
363,12/12/2021,426,557285,54,247855,63,231811,1.0,34928,3.0,36508,4.0,13331,46,196185,7.0,14131,6.0,8164,309,95977,2,1139
364,12/13/2021,1773,559058,292,248147,345,232156,3.0,34931,7.0,36515,26.0,13357,274,196459,33.0,14164,12.0,8176,1144,97121,10,1149
365,12/14/2021,2218,561276,272,248419,257,232413,5.0,34936,3.0,36518,26.0,13383,203,196662,13.0,14177,15.0,8191,1690,98811,21,1170
366,12/15/2021,1764,563040,202,248621,153,232566,2.0,34938,4.0,36522,8.0,13391,119,196781,14.0,14191,12.0,8203,1411,100222,12,1182
367,12/16/2021,1836,564876,321,248942,171,232737,3.0,34941,7.0,36529,17.0,13408,139,196920,9.0,14200,6.0,8209,1338,101560,21,1203
368,12/17/2021,2136,567012,304,249246,351,233088,3.0,34944,9.0,36538,26.0,13434,279,197199,36.0,14236,10.0,8219,1474,103034,17,1220
369,12/18/2021,1824,568836,175,249421,179,233267,3.0,34947,4.0,36542,17.0,13451,149,197348,6.0,14242,7.0,8226,1448,104482,22,1242
370,12/19/2021,444,569280,42,249463,49,233316,1.0,34948,3.0,36545,5.0,13456,37,197385,3.0,14245,4.0,8230,351,104833,2,1244
371,12/20/2021,1595,570875,201,249664,175,233491,2.0,34950,9.0,36554,27.0,13483,129,197514,9.0,14254,10.0,8240,1212,106045,14,1258
372,12/21/2021,2231,573106,312,249976,174,233665,6.0,34956,9.0,36563,27.0,13510,119,197633,15.0,14269,13.0,8253,1740,107785,16,1274
373,12/22/2021,1915,575021,220,250196,198,233863,4.0,34960,9.0,36572,26.0,13536,148,197781,17.0,14286,7.0,8260,1485,109270,17,1291
374,12/23/2021,1269,576290,217,250413,145,234008,2.0,34962,4.0,36576,21.0,13557,98,197879,12.0,14298,14.0,8274,908,110178,11,1302
375,12/24/2021,323,576613,43,250456,49,234057,2.0,34964,2.0,36578,3.0,13560,41,197920,4.0,14302,1.0,8275,232,110410,1,1303
376,12/25/2021,15,576628,4,250460,1,234058,0.0,34964,0.0,36578,,13560,1,197921,0.0,14302,,8275,10,110420,0,1303
377,12/26/2021,361,576989,60,250520,57,234115,1.0,34965,0.0,36578,8.0,13568,41,197962,5.0,14307,3.0,8278,243,110663,4,1307
378,12/27/2021,1296,578285,180,250700,162,234277,4.0,34969,5.0,36583,17.0,13585,123,198085,15.0,14322,7.0,8285,946,111609,15,1322
379,12/28/2021,1930,580215,274,250974,200,234477,6.0,34975,12.0,36595,30.0,13615,140,198225,15.0,14337,15.0,8300,1440,113049,21,1343
380,12/29/2021,1727,581942,211,251185,174,234651,3.0,34978,7.0,36602,27.0,13642,124,198349,14.0,14351,9.0,8309,1338,114387,16,1359
381,12/30/2021,1400,583342,223,251408,169,234820,3.0,34981,8.0,36610,22.0,13664,126,198475,12.0,14363,9.0,8318,1002,115389,13,1372
382,12/31/2021,519,583861,95,251503,54,234874,0.0,34981,2.0,36612,7.0,13671,40,198515,3.0,14366,4.0,8322,361,115750,10,1382
383,1/1/2022,94,583955,11,251514,12,234886,0.0,34981,0.0,36612,0.0,13671,10,198525,1.0,14367,1.0,8323,66,115816,3,1385
384,1/2/2022,322,584277,46,251560,38,234924,0.0,34981,1.0,36613,7.0,13678,24,198549,7.0,14374,0.0,8323,237,116053,2,1387
385,1/3/2022,1621,585898,325,251885,291,235215,3.0,34984,5.0,36618,30.0,13708,233,198782,19.0,14393,9.0,8332,997,117050,16,1403
386,1/4/2022,1704,587602,262,252147,196,235411,7.0,34991,6.0,36624,27.0,13735,147,198929,13.0,14406,9.0,8341,1240,118290,17,1420
387,1/5/2022,1343,588945,203,252350,113,235524,2.0,34993,8.0,36632,8.0,13743,88,199017,5.0,14411,12.0,8353,1025,119315,13,1433
388,1/6/2022,1250,590195,258,252608,175,235699,2.0,34995,5.0,36637,24.0,13767,124,199141,6.0,14417,21.0,8374,813,120128,12,1445
389,1/7/2022,2065,592260,252,252860,242,235941,5.0,35000,8.0,36645,30.0,13797,181,199322,21.0,14438,10.0,8384,1568,121696,14,1459
390,1/8/2022,1591,593851,122,252982,88,236029,1.0,35001,3.0,36648,6.0,13803,69,199391,6.0,14444,7.0,8391,1364,123060,17,1476
391,1/9/2022,505,594356,91,253073,57,236086,0.0,35001,2.0,36650,13.0,13816,35,199426,3.0,14447,6.0,8397,352,123412,5,1481
392,1/10/2022,1570,595926,291,253364,132,236218,2.0,35003,6.0,36656,14.0,13830,98,199524,12.0,14459,8.0,8405,1146,124558,11,1492
393,1/11/2022,1585,597511,224,253588,200,236418,2.0,35005,4.0,36660,28.0,13858,149,199673,8.0,14467,15.0,8420,1157,125715,18,1510
394,1/12/2022,1407,598918,174,253762,106,236524,1.0,35006,5.0,36665,21.0,13879,66,199739,14.0,14481,5.0,8425,1120,126835,15,1525
395,1/13/2022,1111,600029,197,253959,125,236649,3.0,35009,3.0,36668,10.0,13889,87,199826,15.0,14496,13.0,8438,787,127622,8,1533
396,1/14/2022,1642,601671,272,254231,135,236784,1.0,35010,8.0,36676,20.0,13909,91,199917,17.0,14513,7.0,8445,1227,128849,20,1553
397,1/15/2022,1226,602897,139,254370,66,236850,0.0,35010,2.0,36678,6.0,13915,52,199969,7.0,14520,1.0,8446,1005,129854,16,1569
398,1/16/2022,291,603188,46,254416,25,236875,1.0,35011,0.0,36678,1.0,13916,20,199989,4.0,14524,0.0,8446,217,130071,2,1571
399,1/17/2022,801,603989,161,254577,90,236965,2.0,35013,5.0,36683,11.0,13927,68,200057,8.0,14532,3.0,8449,540,130611,12,1583
400,1/18/2022,890,604879,156,254733,113,237078,2.0,35015,5.0,36688,22.0,13949,81,200138,4.0,14536,6.0,8455,611,131222,17,1600
401,1/19/2022,766,605645,124,254857,93,237171,4.0,35019,7.0,36695,9.0,13958,67,200205,6.0,14542,11.0,8466,549,131771,10,1610
402,1/20/2022,839,606484,152,255009,126,237297,0.0,35019,11.0,36706,16.0,13974,90,200295,9.0,14551,11.0,8477,559,132330,8,1618
403,1/21/2022,1228,607712,175,255184,106,237403,2.0,35021,2.0,36708,11.0,13985,76,200371,7.0,14558,12.0,8489,942,133272,10,1628
404,1/22/2022,826,608538,93,255277,71,237474,0.0,35021,1.0,36709,12.0,13997,48,200419,4.0,14562,7.0,8496,636,133908,23,1651
405,1/23/2022,237,608775,29,255306,38,237512,1.0,35022,0.0,36709,4.0,14001,27,200446,7.0,14569,0.0,8496,170,134078,1,1652
406,1/24/2022,540,609315,85,255391,95,237607,1.0,35023,1.0,36710,14.0,14015,67,200513,7.0,14576,7.0,8503,355,134433,8,1660
407,1/25/2022,674,609989,117,255508,118,237725,3.0,35026,2.0,36712,11.0,14026,80,200593,20.0,14596,7.0,8510,421,134854,18,1678
408,1/26/2022,654,610643,104,255612,109,237834,5.0,35031,3.0,36715,11.0,14037,79,200672,11.0,14607,8.0,8518,438,135292,8,1686
409,1/27/2022,629,611272,115,255727,145,237979,3.0,35034,1.0,36716,26.0,14063,105,200777,7.0,14614,7.0,8525,359,135651,14,1700
410,1/28/2022,983,612255,161,255888,128,238107,4.0,35038,6.0,36722,18.0,14081,79,200856,13.0,14627,18.0,8543,675,136326,24,1724
411,1/29/2022,562,612817,64,255952,71,238178,1.0,35039,3.0,36725,9.0,14090,51,200907,8.0,14635,3.0,8546,417,136743,9,1733
412,1/30/2022,196,613013,33,255985,42,238220,1.0,35040,1.0,36726,15.0,14105,23,200930,1.0,14636,3.0,8549,121,136864,2,1735
413,1/31/2022,564,613577,134,256119,95,238315,3.0,35043,1.0,36727,15.0,14120,62,200992,9.0,14645,9.0,8558,325,137189,13,1748
414,2/1/2022,571,614148,100,256219,116,238431,1.0,35044,4.0,36731,22.0,14142,81,201073,10.0,14655,3.0,8561,331,137520,24,1772
415,2/2/2022,134,614282,20,256239,37,238468,0.0,35044,1.0,36732,2.0,14144,31,201104,2.0,14657,2.0,8563,77,137597,3,1775
416,2/3/2022,381,614663,77,256316,110,238578,1.0,35045,3.0,36735,23.0,14167,75,201179,6.0,14663,6.0,8569,192,137789,6,1781
417,2/4/2022,647,615310,113,256429,133,238711,7.0,35052,5.0,36740,18.0,14185,105,201284,4.0,14667,6.0,8575,360,138149,43,1824
418,2/5/2022,459,615769,59,256488,99,238810,2.0,35054,0.0,36740,7.0,14192,78,201362,5.0,14672,9.0,8584,281,138430,21,1845
419,2/6/2022,123,615892,20,256508,22,238832,0.0,35054,1.0,36741,1.0,14193,12,201374,6.0,14678,3.0,8587,77,138507,4,1849
420,2/7/2022,364,616256,62,256570,92,238924,1.0,35055,0.0,36741,10.0,14203,71,201445,4.0,14682,7.0,8594,204,138711,8,1857
421,2/8/2022,452,616708,86,256656,103,239027,2.0,35057,3.0,36744,19.0,14222,72,201517,5.0,14687,7.0,8601,232,138943,39,1896
422,2/9/2022,356,617064,61,256717,78,239105,3.0,35060,1.0,36745,16.0,14238,48,201565,2.0,14689,12.0,8613,204,139147,15,1911
423,2/10/2022,385,617449,86,256803,77,239182,2.0,35062,4.0,36749,15.0,14253,50,201615,6.0,14695,6.0,8619,212,139359,9,1920
424,2/11/2022,555,618004,83,256886,150,239332,3.0,35065,1.0,36750,27.0,14280,99,201714,9.0,14704,15.0,8634,294,139653,33,1953
425,2/12/2022,254,618258,41,256927,45,239377,0.0,35065,0.0,36750,5.0,14285,33,201747,5.0,14709,2.0,8636,153,139806,17,1970
426,2/13/2022,80,618338,19,256946,19,239396,0.0,35065,1.0,36751,0.0,14285,13,201760,4.0,14713,2.0,8638,39,139845,5,1975
427,2/14/2022,240,618578,38,256984,45,239441,2.0,35067,2.0,36753,10.0,14295,29,201789,2.0,14715,4.0,8642,149,139994,9,1984
428,2/15/2022,315,618893,48,257032,85,239526,0.0,35067,0.0,36753,15.0,14310,56,201845,6.0,14721,8.0,8650,151,140145,34,2018
429,2/16/2022,229,619122,41,257073,60,239586,3.0,35070,1.0,36754,12.0,14322,40,201885,5.0,14726,3.0,8653,107,140252,24,2042
430,2/17/2022,172,619294,30,257103,41,239627,0.0,35070,0.0,36754,8.0,14330,28,201913,4.0,14730,1.0,8654,90,140342,12,2054
431,2/18/2022,495,619789,105,257208,97,239724,1.0,35071,3.0,36757,14.0,14344,58,201971,14.0,14744,11.0,8665,265,140607,27,2081
432,2/19/2022,216,620005,26,257234,53,239777,0.0,35071,0.0,36757,9.0,14353,36,202007,2.0,14746,6.0,8671,120,140727,18,2099
433,2/20/2022,74,620079,17,257251,16,239793,0.0,35071,0.0,36757,0.0,14353,14,202021,0.0,14746,2.0,8673,37,140764,4,2103
434,2/21/2022,252,620331,56,257307,71,239864,2.0,35073,1.0,36758,17.0,14370,45,202066,4.0,14750,5.0,8678,118,140882,10,2113
435,2/22/2022,269,620600,49,257356,75,239939,5.0,35078,0.0,36758,6.0,14376,56,202122,5.0,14755,8.0,8686,121,141003,28,2141
436,2/23/2022,216,620816,45,257401,41,239980,1.0,35079,0.0,36758,4.0,14380,29,202151,4.0,14759,4.0,8690,118,141121,12,2153
437,2/24/2022,202,621018,30,257431,43,240023,0.0,35079,1.0,36759,8.0,14388,28,202179,1.0,14760,6.0,8696,117,141238,13,2166
438,2/25/2022,319,621337,55,257486,96,240119,2.0,35081,1.0,36760,13.0,14401,63,202242,12.0,14772,8.0,8704,147,141385,23,2189
439,2/26/2022,187,621524,26,257512,41,240160,1.0,35082,1.0,36761,2.0,14403,29,202271,6.0,14778,4.0,8708,107,141492,13,2202
440,2/27/2022,74,621598,16,257528,13,240173,0.0,35082,1.0,36762,0.0,14403,11,202282,1.0,14779,1.0,8709,43,141535,2,2204
441,2/28/2022,177,621775,48,257576,38,240211,0.0,35082,0.0,36762,8.0,14411,19,202301,5.0,14784,6.0,8715,82,141617,9,2213
442,3/1/2022,210,621985,32,257608,48,240259,4.0,35086,2.0,36764,3.0,14414,43,202344,2.0,14786,0.0,8715,104,141721,30,2243
443,3/2/2022,150,622135,27,257635,36,240295,2.0,35088,0.0,36764,4.0,14418,21,202365,6.0,14792,5.0,8720,77,141798,12,2255
444,3/3/2022,176,622311,36,257671,42,240337,3.0,35091,2.0,36766,10.0,14428,27,202392,3.0,14795,2.0,8722,90,141888,9,2264
445,3/4/2022,341,622652,52,257723,72,240409,4.0,35095,5.0,36771,13.0,14441,50,202442,4.0,14799,5.0,8727,180,142068,42,2306
446,3/5/2022,125,622777,22,257745,19,240428,0.0,35095,0.0,36771,5.0,14446,13,202455,1.0,14800,0.0,8727,72,142140,12,2318
447,3/6/2022,75,622852,28,257773,20,240448,0.0,35095,0.0,36771,2.0,14448,15,202470,1.0,14801,2.0,8729,25,142165,2,2320
448,3/7/2022,150,623002,26,257799,27,240475,1.0,35096,0.0,36771,9.0,14457,14,202484,2.0,14803,2.0,8731,88,142253,9,2329
449,3/8/2022,212,623214,32,257831,36,240511,0.0,35096,2.0,36773,5.0,14462,23,202507,3.0,14806,5.0,8736,106,142359,37,2366
450,3/9/2022,97,623311,12,257843,19,240530,2.0,35098,3.0,36776,3.0,14465,15,202522,0.0,14806,1.0,8737,62,142421,5,2371
451,3/10/2022,100,623411,26,257869,25,240555,1.0,35099,0.0,36776,2.0,14467,19,202541,1.0,14807,3.0,8740,47,142468,3,2374
452,3/11/2022,240,623651,39,257908,77,240632,5.0,35104,1.0,36777,15.0,14482,48,202589,8.0,14815,6.0,8746,89,142557,37,2411
453,3/12/2022,131,623782,26,257934,31,240663,1.0,35105,1.0,36778,3.0,14485,25,202614,1.0,14816,2.0,8748,61,142618,13,2424
454,3/13/2022,46,623828,6,257940,8,240671,0.0,35105,0.0,36778,0.0,14485,6,202620,2.0,14818,0.0,8748,30,142648,3,2427
455,3/14/2022,126,623954,14,257954,39,240710,0.0,35105,0.0,36778,7.0,14492,23,202643,8.0,14826,1.0,8749,65,142713,8,2435
456,3/15/2022,163,624117,30,257984,21,240731,0.0,35105,2.0,36780,4.0,14496,11,202654,4.0,14830,2.0,8751,75,142788,39,2474
457,3/16/2022,135,624252,30,258014,29,240760,0.0,35105,1.0,36781,2.0,14498,21,202675,3.0,14833,3.0,8754,68,142856,11,2485
458,3/17/2022,101,624353,20,258034,11,240771,0.0,35105,0.0,36781,1.0,14499,7,202682,2.0,14835,1.0,8755,61,142917,8,2493
459,3/18/2022,264,624617,21,258055,38,240809,1.0,35106,1.0,36782,2.0,14501,28,202710,6.0,14841,2.0,8757,118,143035,87,2580
460,3/19/2022,111,624728,6,258061,17,240826,1.0,35107,0.0,36782,3.0,14504,10,202720,2.0,14843,2.0,8759,58,143093,30,2610
461,3/20/2022,46,624774,5,258066,8,240834,0.0,35107,0.0,36782,,14504,8,202728,0.0,14843,0.0,8759,24,143117,9,2619
462,3/21/2022,111,624885,11,258077,33,240867,0.0,35107,1.0,36783,5.0,14509,16,202744,7.0,14850,5.0,8764,62,143179,7,2626
463,3/22/2022,163,625048,16,258093,21,240888,2.0,35109,2.0,36785,1.0,14510,18,202762,1.0,14851,1.0,8765,63,143242,64,2690
464,3/23/2022,108,625156,7,258100,25,240913,0.0,35109,0.0,36785,4.0,14514,15,202777,4.0,14855,2.0,8767,62,143304,15,2705
465,3/24/2022,116,625272,18,258118,24,240937,0.0,35109,2.0,36787,4.0,14518,18,202795,1.0,14856,1.0,8768,68,143372,7,2712
466,3/25/2022,212,625484,26,258144,32,240969,0.0,35109,1.0,36788,6.0,14524,20,202815,2.0,14858,4.0,8772,105,143477,49,2761
467,3/26/2022,98,625582,6,258150,13,240982,0.0,35109,0.0,36788,0.0,14524,12,202827,1.0,14859,0.0,8772,41,143518,36,2797
468,3/27/2022,32,625614,8,258158,4,240986,0.0,35109,0.0,36788,0.0,14524,3,202830,0.0,14859,1.0,8773,17,143535,3,2800
469,3/28/2022,88,625702,13,258171,15,241001,0.0,35109,0.0,36788,1.0,14525,12,202842,2.0,14861,0.0,8773,49,143584,11,2811
470,3/29/2022,240,625942,17,258188,20,241021,2.0,35111,0.0,36788,1.0,14526,14,202856,0.0,14861,5.0,8778,67,143651,137,2948
471,3/30/2022,374,626316,24,258212,23,241044,4.0,35115,2.0,36790,3.0,14529,17,202873,2.0,14863,1.0,8779,64,143715,262,3210
472,3/31/2022,594,626910,30,258242,42,241086,4.0,35119,1.0,36791,4.0,14533,33,202906,2.0,14865,3.0,8782,89,143804,434,3644
473,4/1/2022,851,627761,36,258278,36,241122,3.0,35122,3.0,36794,5.0,14538,26,202932,2.0,14867,3.0,8785,92,143896,683,4327
474,4/2/2022,649,628410,15,258293,25,241147,4.0,35126,1.0,36795,1.0,14539,21,202953,0.0,14867,3.0,8788,61,143957,548,4875
475,4/3/2022,143,628553,6,258299,5,241152,0.0,35126,1.0,36796,0.0,14539,3,202956,2.0,14869,0.0,8788,18,143975,114,4989
476,4/4/2022,485,629038,19,258318,24,241176,6.0,35132,2.0,36798,2.0,14541,21,202977,1.0,14870,0.0,8788,65,144040,377,5366
477,4/5/2022,866,629904,37,258355,30,241206,2.0,35134,5.0,36803,4.0,14545,23,203000,1.0,14871,2.0,8790,58,144098,741,6107
478,4/6/2022,506,630410,24,258379,31,241237,6.0,35140,5.0,36808,0.0,14545,28,203028,1.0,14872,2.0,8792,46,144144,408,6515
479,4/7/2022,641,631051,30,258409,22,241259,3.0,35143,7.0,36815,2.0,14547,13,203041,3.0,14875,4.0,8796,59,144203,532,7047
480,4/8/2022,1132,632183,47,258456,40,241299,6.0,35149,8.0,36823,5.0,14552,30,203071,3.0,14878,2.0,8798,97,144300,942,7989
481,4/9/2022,677,632860,35,258491,16,241315,4.0,35153,4.0,36827,3.0,14555,10,203081,2.0,14880,1.0,8799,41,144341,583,8572
482,4/10/2022,187,633047,15,258506,5,241320,1.0,35154,2.0,36829,0.0,14555,5,203086,0.0,14880,0.0,8799,33,144374,134,8706
483,4/11/2022,631,633678,21,258527,28,241348,2.0,35156,3.0,36832,3.0,14558,20,203106,2.0,14882,3.0,8802,54,144428,526,9232
484,4/12/2022,855,634533,30,258557,27,241375,9.0,35165,5.0,36837,4.0,14562,20,203126,3.0,14885,0.0,8802,61,144489,735,9967
485,4/13/2022,665,635198,32,258589,23,241398,5.0,35170,6.0,36843,0.0,14562,21,203147,1.0,14886,1.0,8803,63,144552,546,10513
486,4/14/2022,592,635790,26,258615,23,241421,4.0,35174,0.0,36843,4.0,14566,13,203160,2.0,14888,4.0,8807,91,144643,456,10969
487,4/15/2022,921,636711,40,258655,45,241466,5.0,35179,4.0,36847,10.0,14576,31,203191,3.0,14891,1.0,8808,88,144731,746,11715
488,4/16/2022,497,637208,20,258675,17,241483,2.0,35181,0.0,36847,2.0,14578,13,203204,2.0,14893,0.0,8808,37,144768,423,12138
489,4/17/2022,70,637278,8,258683,5,241488,2.0,35183,1.0,36848,0.0,14578,4,203208,0.0,14893,1.0,8809,12,144780,45,12183
490,4/18/2022,561,637839,39,258722,26,241514,9.0,35192,5.0,36853,3.0,14581,21,203229,1.0,14894,1.0,8810,59,144839,438,12621
491,4/19/2022,801,638640,43,258765,32,241546,10.0,35202,9.0,36862,2.0,14583,26,203255,3.0,14897,1.0,8811,80,144919,649,13270
492,4/20/2022,474,639114,22,258787,24,241570,3.0,35205,3.0,36865,6.0,14589,17,203272,1.0,14898,0.0,8811,47,144966,382,13652
493,4/21/2022,467,639581,22,258809,31,241601,8.0,35213,2.0,36867,2.0,14591,25,203297,3.0,14901,1.0,8812,43,145009,374,14026
494,4/22/2022,700,640281,25,258834,37,241638,1.0,35214,3.0,36870,4.0,14595,30,203327,3.0,14904,0.0,8812,66,145075,571,14597
495,4/23/2022,622,640903,20,258854,25,241663,9.0,35223,3.0,36873,1.0,14596,20,203347,2.0,14906,2.0,8814,61,145136,517,15114
496,4/24/2022,110,641013,8,258862,7,241670,0.0,35223,2.0,36875,0.0,14596,6,203353,0.0,14906,1.0,8815,20,145156,75,15189
497,4/25/2022,385,641398,28,258890,15,241685,3.0,35226,4.0,36879,4.0,14600,10,203363,0.0,14906,1.0,8816,46,145202,296,15485
498,4/26/2022,553,641951,26,258916,25,241710,3.0,35229,2.0,36881,3.0,14603,17,203380,2.0,14908,3.0,8819,73,145275,428,15913
499,4/27/2022,468,642419,21,258937,22,241732,8.0,35237,4.0,36885,2.0,14605,14,203394,2.0,14910,4.0,8823,64,145339,361,16274
500,4/28/2022,466,642885,32,258969,27,241759,7.0,35244,4.0,36889,3.0,14608,18,203412,2.0,14912,4.0,8827,44,145383,365,16639
501,4/29/2022,760,643645,29,258998,34,241793,4.0,35248,2.0,36891,6.0,14614,24,203436,2.0,14914,2.0,8829,70,145453,624,17263
502,4/30/2022,390,644035,6,259004,19,241812,1.0,35249,0.0,36891,1.0,14615,18,203454,0.0,14914,0.0,8829,45,145498,320,17583
503,5/1/2022,100,644135,12,259016,12,241824,0.0,35249,2.0,36893,1.0,14616,9,203463,0.0,14914,2.0,8831,16,145514,60,17643
504,5/2/2022,374,644509,20,259036,19,241843,0.0,35249,5.0,36898,2.0,14618,12,203475,3.0,14917,2.0,8833,55,145569,282,17925
505,5/3/2022,650,645159,29,259065,30,241873,5.0,35254,5.0,36903,3.0,14621,25,203500,2.0,14919,0.0,8833,74,145643,520,18445
506,5/4/2022,518,645677,25,259090,27,241900,4.0,35258,5.0,36908,4.0,14625,19,203519,2.0,14921,2.0,8835,65,145708,396,18841
507,5/5/2022,407,646084,19,259109,20,241920,3.0,35261,3.0,36911,2.0,14627,14,203533,3.0,14924,1.0,8836,50,145758,318,19159
508,5/6/2022,621,646705,35,259144,36,241956,3.0,35264,3.0,36914,5.0,14632,28,203561,2.0,14926,1.0,8837,65,145823,482,19641
509,5/7/2022,371,647076,17,259161,22,241978,1.0,35265,1.0,36915,2.0,14634,17,203578,1.0,14927,2.0,8839,41,145864,290,19931
510,5/8/2022,72,647148,4,259165,7,241985,0.0,35265,0.0,36915,0.0,14634,4,203582,1.0,14928,2.0,8841,13,145877,48,19979
511,5/9/2022,403,647551,26,259191,16,242001,3.0,35268,1.0,36916,1.0,14635,11,203593,2.0,14930,2.0,8843,54,145931,306,20285
512,5/10/2022,600,648151,28,259219,34,242035,13.0,35281,4.0,36920,3.0,14638,25,203618,2.0,14932,4.0,8847,82,146013,453,20738
513,5/11/2022,397,648548,28,259247,26,242061,8.0,35289,4.0,36924,6.0,14644,13,203631,3.0,14935,4.0,8851,32,146045,311,21049
514,5/12/2022,329,648877,19,259266,20,242081,3.0,35292,2.0,36926,0.0,14644,18,203649,2.0,14937,0.0,8851,47,146092,242,21291
515,5/13/2022,649,649526,23,259289,39,242120,6.0,35298,3.0,36929,4.0,14648,27,203676,2.0,14939,6.0,8857,86,146178,498,21789
516,5/14/2022,381,649907,16,259305,12,242132,1.0,35299,2.0,36931,1.0,14649,10,203686,1.0,14940,0.0,8857,33,146211,319,22108
517,5/15/2022,126,650033,6,259311,4,242136,0.0,35299,0.0,36931,0.0,14649,4,203690,0.0,14940,0.0,8857,17,146228,98,22206
518,5/16/2022,450,650483,25,259336,24,242160,0.0,35299,1.0,36932,5.0,14654,16,203706,1.0,14941,2.0,8859,73,146301,325,22531
519,5/17/2022,516,650999,27,259363,23,242183,6.0,35305,4.0,36936,0.0,14654,19,203725,0.0,14941,4.0,8863,64,146365,401,22932
520,5/18/2022,319,651318,11,259374,16,242199,4.0,35309,0.0,36936,4.0,14658,11,203736,0.0,14941,1.0,8864,41,146406,248,23180
521,5/19/2022,475,651793,25,259399,24,242223,3.0,35312,3.0,36939,5.0,14663,18,203754,0.0,14941,1.0,8865,55,146461,367,23547
522,5/20/2022,723,652516,22,259421,33,242256,5.0,35317,4.0,36943,3.0,14666,27,203781,2.0,14943,1.0,8866,110,146571,557,24104
523,5/21/2022,482,652998,19,259440,14,242270,3.0,35320,4.0,36947,0.0,14666,13,203794,1.0,14944,0.0,8866,69,146640,379,24483
524,5/22/2022,171,653169,6,259446,5,242275,1.0,35321,0.0,36947,0.0,14666,3,203797,2.0,14946,0.0,8866,36,146676,122,24605
525,5/23/2022,530,653699,23,259469,18,242293,1.0,35322,2.0,36949,1.0,14667,15,203812,0.0,14946,2.0,8868,112,146788,377,24982
526,5/24/2022,602,654301,49,259518,25,242318,5.0,35327,6.0,36955,2.0,14669,16,203828,0.0,14946,7.0,8875,81,146869,450,25432
527,5/25/2022,423,654724,23,259541,20,242338,3.0,35330,6.0,36961,0.0,14669,13,203841,6.0,14952,1.0,8876,71,146940,306,25738
528,5/26/2022,428,655152,20,259561,23,242361,4.0,35334,6.0,36967,2.0,14671,17,203858,1.0,14953,3.0,8879,99,147039,287,26025
529,5/27/2022,883,656035,25,259586,39,242400,7.0,35341,3.0,36970,5.0,14676,29,203887,3.0,14956,2.0,8881,165,147204,651,26676
530,5/28/2022,309,656344,10,259596,11,242411,1.0,35342,0.0,36970,0.0,14676,10,203897,0.0,14956,1.0,8882,29,147233,256,26932
531,5/29/2022,140,656484,4,259600,7,242418,0.0,35342,2.0,36972,1.0,14677,6,203903,0.0,14956,0.0,8882,40,147273,87,27019
532,5/30/2022,31,656515,1,259601,0,242418,0.0,35342,0.0,36972,0.0,14677,0,203903,0.0,14956,,8882,3,147276,27,27046
533,5/31/2022,806,657321,30,259631,28,242446,8.0,35350,6.0,36978,2.0,14679,22,203925,3.0,14959,1.0,8883,115,147391,632,27678
534,6/1/2022,588,657909,28,259659,22,242468,6.0,35356,3.0,36981,1.0,14680,18,203943,2.0,14961,1.0,8884,83,147474,454,28132
535,6/2/2022,679,658588,20,259679,29,242497,4.0,35360,0.0,36981,4.0,14684,21,203964,2.0,14963,2.0,8886,79,147553,549,28681
536,6/3/2022,968,659556,30,259709,26,242523,6.0,35366,6.0,36987,3.0,14687,21,203985,2.0,14965,0.0,8886,117,147670,793,29474
537,6/4/2022,693,660249,18,259727,26,242549,5.0,35371,1.0,36988,1.0,14688,25,204010,0.0,14965,0.0,8886,69,147739,576,30050
538,6/5/2022,131,660380,4,259731,5,242554,0.0,35371,0.0,36988,1.0,14689,3,204013,1.0,14966,0.0,8886,19,147758,103,30153
539,6/6/2022,574,660954,23,259754,25,242579,2.0,35373,1.0,36989,5.0,14694,19,204032,0.0,14966,1.0,8887,66,147824,456,30609
540,6/7/2022,773,661727,31,259785,39,242618,5.0,35378,3.0,36992,5.0,14699,32,204064,1.0,14967,1.0,8888,121,147945,577,31186
541,6/8/2022,379,662106,26,259811,18,242636,2.0,35380,3.0,36995,1.0,14700,14,204078,0.0,14967,3.0,8891,54,147999,279,31465
542,6/9/2022,432,662538,14,259825,15,242651,4.0,35384,1.0,36996,3.0,14703,12,204090,0.0,14967,0.0,8891,67,148066,336,31801
543,6/10/2022,709,663247,25,259850,35,242686,1.0,35385,1.0,36997,3.0,14706,28,204118,2.0,14969,2.0,8893,103,148169,545,32346
544,6/11/2022,368,663615,11,259861,15,242701,2.0,35387,2.0,36999,0.0,14706,11,204129,2.0,14971,2.0,8895,58,148227,283,32629
545,6/12/2022,123,663738,4,259865,3,242704,1.0,35388,0.0,36999,1.0,14707,2,204131,0.0,14971,0.0,8895,28,148255,87,32716
546,6/13/2022,344,664082,13,259878,28,242732,3.0,35391,1.0,37000,2.0,14709,22,204153,2.0,14973,2.0,8897,50,148305,250,32966
547,6/14/2022,77,664159,4,259882,5,242737,1.0,35392,0.0,37000,0.0,14709,5,204158,0.0,14973,,8897,15,148320,53,33019
