,Date,daily number of doses received by Larimer County residents,total number of doses recevied by residents,daily number of residents receiving first dose,total number of residents receiving first dose,daily number of residents vaccinated,total number of residents vaccinated,daily number of 70+ vaccinated,total number of 70+ vaccinated,daily number of 70+ at least one dose,total number of 70+ at least one dose,daily number of Latinx residents vaccinated,total of Latinx residents vaccinated,daily number of White non-Latinx residents vaccinated,total of White non-Latinx residents vaccinated,daily number of non-White non-Latinx residents vaccinated,total of non-White non-Latinx residents vaccinated,dailyUnknown,totalUnknown,daily_additional_doses,total_additional_doses
0,12/14/2020,32,32,32,32,1,1,0.0,0,1.0,1,0.0,0,1,1,0.0,0,,0,0,0
1,12/15/2020,14,46,14,46,0,1,,0,,1,,0,0,1,0.0,0,,0,0,0
2,12/16/2020,304,350,304,350,0,1,0.0,0,2.0,3,0.0,0,0,1,0.0,0,0.0,0,0,0
3,12/17/2020,990,1340,990,1340,0,1,0.0,0,11.0,14,0.0,0,0,1,0.0,0,0.0,0,0,0
4,12/18/2020,1055,2395,1055,2395,2,3,0.0,0,15.0,29,0.0,0,2,3,0.0,0,0.0,0,0,0
5,12/19/2020,721,3116,721,3116,0,3,0.0,0,14.0,43,0.0,0,0,3,0.0,0,0.0,0,0,0
6,12/20/2020,266,3382,266,3382,0,3,0.0,0,4.0,47,0.0,0,0,3,0.0,0,0.0,0,0,0
7,12/21/2020,358,3740,358,3740,3,6,0.0,0,3.0,50,0.0,0,3,6,0.0,0,0.0,0,0,0
8,12/22/2020,364,4104,364,4104,0,6,0.0,0,7.0,57,0.0,0,0,6,0.0,0,0.0,0,0,0
9,12/23/2020,440,4544,440,4544,0,6,0.0,0,6.0,63,0.0,0,0,6,0.0,0,0.0,0,0,0
10,12/24/2020,105,4649,105,4649,0,6,0.0,0,3.0,66,0.0,0,0,6,0.0,0,0.0,0,0,0
11,12/25/2020,1,4650,1,4650,0,6,,0,,66,,0,0,6,,0,,0,0,0
12,12/26/2020,228,4878,228,4878,1,7,0.0,0,3.0,69,0.0,0,1,7,0.0,0,0.0,0,0,0
13,12/27/2020,278,5156,278,5156,0,7,0.0,0,197.0,266,0.0,0,0,7,0.0,0,,0,0,0
14,12/28/2020,707,5863,707,5863,0,7,0.0,0,385.0,651,0.0,0,0,7,0.0,0,0.0,0,0,0
15,12/29/2020,913,6776,912,6775,1,8,0.0,0,461.0,1112,0.0,0,1,8,0.0,0,0.0,0,0,0
16,12/30/2020,882,7658,882,7657,0,8,0.0,0,273.0,1385,0.0,0,0,8,0.0,0,0.0,0,0,0
17,12/31/2020,895,8553,895,8552,0,8,0.0,0,343.0,1728,0.0,0,0,8,0.0,0,0.0,0,0,0
18,1/1/2021,4,8557,3,8555,1,9,,0,,1728,,0,1,9,,0,,0,0,0
19,1/2/2021,394,8951,394,8949,1,10,0.0,0,141.0,1869,0.0,0,1,10,0.0,0,0.0,0,0,0
20,1/3/2021,123,9074,123,9072,0,10,0.0,0,52.0,1921,0.0,0,0,10,0.0,0,0.0,0,0,0
21,1/4/2021,588,9662,575,9647,12,22,0.0,0,320.0,2241,0.0,0,10,20,2.0,2,0.0,0,0,0
22,1/5/2021,646,10308,637,10284,10,32,0.0,0,409.0,2650,0.0,0,9,29,1.0,3,0.0,0,0,0
23,1/6/2021,1232,11540,914,11198,313,345,4.0,4,515.0,3165,18.0,18,274,303,17.0,20,4.0,4,0,0
24,1/7/2021,1657,13197,702,11900,939,1284,12.0,16,406.0,3571,34.0,52,849,1152,41.0,61,15.0,19,0,0
25,1/8/2021,1989,15186,980,12880,995,2279,11.0,27,478.0,4049,48.0,100,884,2036,44.0,105,19.0,38,1,1
26,1/9/2021,1227,16413,527,13407,687,2966,14.0,41,302.0,4351,16.0,116,622,2658,37.0,142,12.0,50,0,1
27,1/10/2021,702,17115,427,13834,272,3238,4.0,45,260.0,4611,10.0,126,245,2903,14.0,156,3.0,53,0,1
28,1/11/2021,1149,18264,798,14632,348,3586,1.0,46,536.0,5147,10.0,136,316,3219,19.0,175,3.0,56,0,1
29,1/12/2021,1177,19441,879,15511,297,3883,8.0,54,517.0,5664,14.0,150,257,3476,18.0,193,8.0,64,1,2
30,1/13/2021,1078,20519,832,16343,244,4127,1.0,55,376.0,6040,23.0,173,198,3674,15.0,208,8.0,72,0,2
31,1/14/2021,870,21389,835,17178,35,4162,1.0,56,494.0,6534,2.0,175,31,3705,1.0,209,1.0,73,0,2
32,1/15/2021,1219,22608,1207,18385,12,4174,0.0,56,760.0,7294,0.0,175,12,3717,0.0,209,0.0,73,0,2
33,1/16/2021,986,23594,972,19357,14,4188,1.0,57,585.0,7879,0.0,175,13,3730,1.0,210,0.0,73,0,2
34,1/17/2021,52,23646,48,19405,4,4192,0.0,57,19.0,7898,0.0,175,2,3732,2.0,212,0.0,73,0,2
35,1/18/2021,1016,24662,814,20219,200,4392,48.0,105,600.0,8498,8.0,183,174,3906,13.0,225,5.0,78,2,4
36,1/19/2021,1255,25917,1115,21334,138,4530,8.0,113,736.0,9234,7.0,190,118,4024,6.0,231,7.0,85,0,4
37,1/20/2021,1422,27339,1202,22536,218,4748,17.0,130,569.0,9803,15.0,205,177,4201,9.0,240,17.0,102,1,5
38,1/21/2021,2249,29588,2040,24576,209,4957,7.0,137,1587.0,11390,13.0,218,174,4375,15.0,255,7.0,109,0,5
39,1/22/2021,1738,31326,1462,26038,275,5232,90.0,227,1092.0,12482,34.0,252,222,4597,13.0,268,6.0,115,0,5
40,1/23/2021,896,32222,560,26598,335,5567,58.0,285,416.0,12898,8.0,260,306,4903,13.0,281,8.0,123,0,5
41,1/24/2021,393,32615,104,26702,286,5853,206.0,491,61.0,12959,8.0,268,269,5172,9.0,290,,123,0,5
42,1/25/2021,1404,34019,784,27486,611,6464,361.0,852,554.0,13513,14.0,282,570,5742,15.0,305,12.0,135,0,5
43,1/26/2021,1622,35641,691,28177,919,7383,454.0,1306,441.0,13954,30.0,312,844,6586,32.0,337,13.0,148,0,5
44,1/27/2021,1839,37480,771,28948,1064,8447,537.0,1843,334.0,14288,40.0,352,969,7555,45.0,382,10.0,158,0,5
45,1/28/2021,1343,38823,537,29485,803,9250,356.0,2199,294.0,14582,25.0,377,735,8290,28.0,410,15.0,173,2,7
46,1/29/2021,1632,40455,1154,30639,475,9725,157.0,2356,825.0,15407,21.0,398,412,8702,32.0,442,10.0,183,0,7
47,1/30/2021,1230,41685,735,31374,491,10216,213.0,2569,599.0,16006,24.0,422,441,9143,20.0,462,6.0,189,0,7
48,1/31/2021,622,42307,398,31772,223,10439,76.0,2645,353.0,16359,5.0,427,197,9340,15.0,477,6.0,195,1,8
49,2/1/2021,1605,43912,901,32673,704,11143,469.0,3114,655.0,17014,17.0,444,650,9990,27.0,504,10.0,205,1,9
50,2/2/2021,1863,45775,729,33402,1133,12276,737.0,3851,582.0,17596,43.0,487,1045,11035,34.0,538,11.0,216,0,9
51,2/3/2021,1263,47038,583,33985,677,12953,320.0,4171,226.0,17822,48.0,535,577,11612,41.0,579,11.0,227,0,9
52,2/4/2021,2532,49570,1791,35776,736,13689,493.0,4664,1549.0,19371,29.0,564,660,12272,37.0,616,10.0,237,1,10
53,2/5/2021,2577,52147,1531,37307,1035,14724,683.0,5347,1305.0,20676,38.0,602,950,13222,29.0,645,18.0,255,2,12
54,2/6/2021,2217,54364,1597,38904,614,15338,443.0,5790,1241.0,21917,7.0,609,583,13805,22.0,667,2.0,257,0,12
55,2/7/2021,232,54596,89,38993,141,15479,94.0,5884,26.0,21943,7.0,616,125,13930,4.0,671,5.0,262,1,13
56,2/8/2021,2485,57081,1597,40590,884,16363,599.0,6483,1139.0,23082,26.0,642,813,14743,28.0,699,17.0,279,0,13
57,2/9/2021,2389,59470,1544,42134,842,17205,513.0,6996,996.0,24078,25.0,667,757,15500,32.0,731,28.0,307,0,13
58,2/10/2021,1586,61056,967,43101,615,17820,321.0,7317,288.0,24366,26.0,693,547,16047,26.0,757,16.0,323,4,17
59,2/11/2021,3529,64585,1997,45098,1525,19345,1055.0,8372,808.0,25174,55.0,748,1395,17442,49.0,806,26.0,349,1,18
60,2/12/2021,3263,67848,1810,46908,1443,20788,954.0,9326,800.0,25974,62.0,810,1326,18768,42.0,848,13.0,362,0,18
61,2/13/2021,2997,70845,2363,49271,628,21416,309.0,9635,672.0,26646,14.0,824,580,19348,23.0,871,11.0,373,1,19
62,2/14/2021,421,71266,350,49621,71,21487,49.0,9684,45.0,26691,2.0,826,64,19412,3.0,874,2.0,375,0,19
63,2/15/2021,2622,73888,2129,51750,491,21978,325.0,10009,256.0,26947,17.0,843,460,19872,12.0,886,2.0,377,0,19
64,2/16/2021,2747,76635,1917,53667,825,22803,499.0,10508,231.0,27178,35.0,878,750,20622,24.0,910,16.0,393,0,19
65,2/17/2021,1634,78269,657,54324,973,23776,480.0,10988,155.0,27333,29.0,907,888,21510,36.0,946,20.0,413,0,19
66,2/18/2021,2639,80908,1673,55997,956,24732,733.0,11721,275.0,27608,37.0,944,881,22391,30.0,976,8.0,421,1,20
67,2/19/2021,2424,83332,1030,57027,1378,26110,1018.0,12739,155.0,27763,45.0,989,1275,23666,43.0,1019,15.0,436,3,23
68,2/20/2021,1650,84982,687,57714,960,27070,785.0,13524,134.0,27897,22.0,1011,900,24566,28.0,1047,10.0,446,1,24
69,2/21/2021,108,85090,40,57754,67,27137,37.0,13561,8.0,27905,1.0,1012,64,24630,2.0,1049,0.0,446,0,24
70,2/22/2021,2022,87112,762,58516,1249,28386,925.0,14486,146.0,28051,37.0,1049,1165,25795,37.0,1086,10.0,456,1,25
71,2/23/2021,1220,88332,516,59032,704,29090,471.0,14957,160.0,28211,20.0,1069,636,26431,35.0,1121,13.0,469,0,25
72,2/24/2021,1408,89740,752,59784,649,29739,276.0,15233,135.0,28346,31.0,1100,594,27025,19.0,1140,5.0,474,1,26
73,2/25/2021,3863,93603,2070,61854,1789,31528,1508.0,16741,351.0,28697,47.0,1147,1689,28714,36.0,1176,17.0,491,0,26
74,2/26/2021,3269,96872,1157,63011,2106,33634,1744.0,18485,201.0,28898,33.0,1180,1985,30699,59.0,1235,29.0,520,2,28
75,2/27/2021,3494,100366,1662,64673,1824,35458,1562.0,20047,544.0,29442,36.0,1216,1710,32409,52.0,1287,26.0,546,1,29
76,2/28/2021,426,100792,357,65030,68,35526,42.0,20089,114.0,29556,2.0,1218,62,32471,2.0,1289,2.0,548,0,29
77,3/1/2021,2817,103609,1342,66372,1469,36995,1078.0,21167,300.0,29856,53.0,1271,1358,33829,46.0,1335,12.0,560,5,34
78,3/2/2021,3257,106866,1728,68100,1522,38517,1052.0,22219,383.0,30239,38.0,1309,1413,35242,44.0,1379,27.0,587,1,35
79,3/3/2021,1658,108524,1092,69192,564,39081,176.0,22395,203.0,30442,32.0,1341,504,35746,24.0,1403,4.0,591,0,35
80,3/4/2021,3000,111524,1580,70772,1421,40502,815.0,23210,170.0,30612,43.0,1384,1305,37051,53.0,1456,20.0,611,25,60
81,3/5/2021,3481,115005,2053,72825,1436,41938,814.0,24024,426.0,31038,39.0,1423,1331,38382,43.0,1499,23.0,634,25,85
82,3/6/2021,4102,119107,2320,75145,1996,43934,757.0,24781,268.0,31306,96.0,1519,1788,40170,78.0,1577,34.0,668,581,666
83,3/7/2021,416,119523,300,75445,125,44059,37.0,24818,20.0,31326,1.0,1520,119,40289,3.0,1580,2.0,670,23,689
84,3/8/2021,2823,122346,1057,76502,1774,45833,261.0,25079,74.0,31400,49.0,1569,1640,41929,62.0,1642,23.0,693,124,813
85,3/9/2021,3178,125524,1649,78151,1545,47378,261.0,25340,96.0,31496,51.0,1620,1405,43334,64.0,1706,25.0,718,73,886
86,3/10/2021,2384,127908,1368,79519,1024,48402,300.0,25640,83.0,31579,54.0,1674,922,44256,32.0,1738,16.0,734,63,949
87,3/11/2021,4175,132083,2379,81898,1803,50205,400.0,26040,135.0,31714,63.0,1737,1653,45909,67.0,1805,20.0,754,77,1026
88,3/12/2021,3946,136029,2576,84474,1393,51598,198.0,26238,67.0,31781,67.0,1804,1240,47149,53.0,1858,33.0,787,69,1095
89,3/13/2021,214,136243,131,84605,99,51697,20.0,26258,7.0,31788,1.0,1805,92,47241,4.0,1862,2.0,789,30,1125
90,3/14/2021,100,136343,60,84665,39,51736,9.0,26267,0.0,31788,1.0,1806,36,47277,1.0,1863,1.0,790,2,1127
91,3/15/2021,896,137239,360,85025,536,52272,85.0,26352,15.0,31803,19.0,1825,493,47770,17.0,1880,7.0,797,19,1146
92,3/16/2021,3286,140525,2114,87139,1176,53448,227.0,26579,45.0,31848,64.0,1889,1049,48819,41.0,1921,22.0,819,30,1176
93,3/17/2021,2904,143429,1785,88924,1124,54572,238.0,26817,88.0,31936,40.0,1929,1030,49849,35.0,1956,19.0,838,31,1207
94,3/18/2021,4001,147430,2089,91013,1924,56496,338.0,27155,91.0,32027,97.0,2026,1742,51591,64.0,2020,21.0,859,21,1228
95,3/19/2021,3001,150431,1750,92763,1253,57749,221.0,27376,42.0,32069,60.0,2086,1128,52719,46.0,2066,19.0,878,15,1243
96,3/20/2021,3080,153511,1964,94727,1118,58867,313.0,27689,54.0,32123,37.0,2123,1006,53725,54.0,2120,21.0,899,36,1279
97,3/21/2021,659,154170,396,95123,265,59132,26.0,27715,5.0,32128,11.0,2134,236,53961,16.0,2136,2.0,901,18,1297
98,3/22/2021,3112,157282,2246,97369,865,59997,188.0,27903,56.0,32184,19.0,2153,796,54757,37.0,2173,13.0,914,26,1323
99,3/23/2021,4439,161721,3566,100935,1176,61173,193.0,28096,75.0,32259,40.0,2193,1048,55805,50.0,2223,38.0,952,485,1808
100,3/24/2021,3162,164883,2427,103362,748,61921,117.0,28213,37.0,32296,40.0,2233,668,56473,26.0,2249,14.0,966,33,1841
101,3/25/2021,5066,169949,3052,106414,2015,63936,312.0,28525,71.0,32367,68.0,2301,1847,58320,69.0,2318,31.0,997,15,1856
102,3/26/2021,4581,174530,2734,109148,1846,65782,328.0,28853,66.0,32433,119.0,2420,1583,59903,113.0,2431,31.0,1028,30,1886
103,3/27/2021,3339,177869,1910,111058,1424,67206,325.0,29178,21.0,32454,49.0,2469,1309,61212,46.0,2477,20.0,1048,5,1891
104,3/28/2021,1169,179038,809,111867,361,67567,92.0,29270,16.0,32470,12.0,2481,331,61543,16.0,2493,2.0,1050,4,1895
105,3/29/2021,3983,183021,2687,114554,1295,68862,229.0,29499,52.0,32522,39.0,2520,1216,62759,27.0,2520,13.0,1063,8,1903
106,3/30/2021,4372,187393,2756,117310,1645,70507,237.0,29736,74.0,32596,55.0,2575,1504,64263,68.0,2588,18.0,1081,45,1948
107,3/31/2021,3572,190965,2558,119868,1048,71555,167.0,29903,47.0,32643,41.0,2616,937,65200,50.0,2638,20.0,1101,29,1977
108,4/1/2021,5108,196073,3331,123199,1788,73343,148.0,30051,76.0,32719,73.0,2689,1636,66836,60.0,2698,19.0,1120,31,2008
109,4/2/2021,4706,200779,2523,125722,2184,75527,245.0,30296,49.0,32768,82.0,2771,1986,68822,91.0,2789,25.0,1145,27,2035
110,4/3/2021,4255,205034,3523,129245,765,76292,94.0,30390,40.0,32808,37.0,2808,679,69501,29.0,2818,20.0,1165,68,2103
111,4/4/2021,371,205405,257,129502,132,76424,6.0,30396,7.0,32815,3.0,2811,116,69617,11.0,2829,2.0,1167,33,2136
112,4/5/2021,4688,210093,3757,133259,955,77379,75.0,30471,47.0,32862,70.0,2881,816,70433,49.0,2878,20.0,1187,92,2228
113,4/6/2021,5163,215256,3033,136292,2319,79698,85.0,30556,58.0,32920,80.0,2961,2056,72489,125.0,3003,58.0,1245,270,2498
114,4/7/2021,4965,220221,3685,139977,2179,81877,59.0,30615,109.0,33029,118.0,3079,1852,74341,135.0,3138,74.0,1319,1157,3655
115,4/8/2021,6686,226907,4510,144487,2876,84753,137.0,30752,123.0,33152,136.0,3215,2523,76864,141.0,3279,76.0,1395,920,4575
116,4/9/2021,5724,232631,3265,147752,3239,87992,77.0,30829,71.0,33223,162.0,3377,2806,79670,182.0,3461,89.0,1484,803,5378
117,4/10/2021,4427,237058,3163,150915,1747,89739,51.0,30880,71.0,33294,99.0,3476,1476,81146,119.0,3580,53.0,1537,512,5890
118,4/11/2021,1037,238095,796,151711,286,90025,5.0,30885,11.0,33305,12.0,3488,239,81385,24.0,3604,11.0,1548,57,5947
119,4/12/2021,5035,243130,3636,155347,2022,92047,76.0,30961,96.0,33401,77.0,3565,1751,83136,133.0,3737,61.0,1609,503,6450
120,4/13/2021,5032,248162,3562,158909,1485,93532,55.0,31016,77.0,33478,70.0,3635,1295,84431,96.0,3833,24.0,1633,21,6471
121,4/14/2021,2956,251118,1439,160348,1511,95043,86.0,31102,26.0,33504,93.0,3728,1315,85746,70.0,3903,33.0,1666,2,6473
122,4/15/2021,4952,256070,2329,162677,2608,97651,102.0,31204,58.0,33562,218.0,3946,2168,87914,161.0,4064,61.0,1727,2,6475
123,4/16/2021,3907,259977,2078,164755,1818,99469,44.0,31248,34.0,33596,67.0,4013,1591,89505,126.0,4190,34.0,1761,4,6479
124,4/17/2021,4582,264559,2402,167157,2166,101635,39.0,31287,57.0,33653,98.0,4111,1884,91389,132.0,4322,52.0,1813,4,6483
125,4/18/2021,1037,265596,407,167564,623,102258,13.0,31300,11.0,33664,42.0,4153,518,91907,33.0,4355,30.0,1843,4,6487
126,4/19/2021,3862,269458,1410,168974,2428,104686,44.0,31344,40.0,33704,165.0,4318,2041,93948,162.0,4517,60.0,1903,5,6492
127,4/20/2021,4699,274157,1867,170841,2819,107505,47.0,31391,69.0,33773,160.0,4478,2401,96349,193.0,4710,65.0,1968,5,6497
128,4/21/2021,3166,277323,709,171550,2448,109953,35.0,31426,31.0,33804,146.0,4624,2060,98409,163.0,4873,79.0,2047,4,6501
129,4/22/2021,4657,281980,1772,173322,2872,112825,46.0,31472,62.0,33866,143.0,4767,2462,100871,193.0,5066,74.0,2121,3,6504
130,4/23/2021,3594,285574,1180,174502,2399,115224,41.0,31513,30.0,33896,73.0,4840,2115,102986,128.0,5194,83.0,2204,5,6509
131,4/24/2021,3359,288933,1119,175621,2234,117458,14.0,31527,21.0,33917,103.0,4943,1896,104882,194.0,5388,41.0,2245,6,6515
132,4/25/2021,796,289729,344,175965,451,117909,6.0,31533,6.0,33923,104.0,5047,268,105150,38.0,5426,41.0,2286,1,6516
133,4/26/2021,4356,294085,1114,177079,3235,121144,35.0,31568,30.0,33953,146.0,5193,2782,107932,214.0,5640,93.0,2379,4,6520
134,4/27/2021,3343,297428,1190,178269,2146,123290,37.0,31605,37.0,33990,80.0,5273,1889,109821,134.0,5774,43.0,2422,10,6530
135,4/28/2021,2989,300417,715,178984,2273,125563,45.0,31650,20.0,34010,166.0,5439,1844,111665,196.0,5970,67.0,2489,14,6544
136,4/29/2021,3967,304384,820,179804,3141,128704,67.0,31717,32.0,34042,227.0,5666,2582,114247,224.0,6194,108.0,2597,7,6551
137,4/30/2021,2864,307248,637,180441,2227,130931,44.0,31761,24.0,34066,73.0,5739,1893,116140,198.0,6392,63.0,2660,10,6561
138,5/1/2021,3641,310889,817,181258,2806,133737,35.0,31796,18.0,34084,282.0,6021,2185,118325,200.0,6592,139.0,2799,16,6577
139,5/2/2021,529,311418,233,181491,307,134044,7.0,31803,2.0,34086,11.0,6032,248,118573,38.0,6630,10.0,2809,10,6587
140,5/3/2021,3422,314840,636,182127,2785,136829,46.0,31849,34.0,34120,107.0,6139,2389,120962,212.0,6842,77.0,2886,12,6599
141,5/4/2021,4341,319181,696,182823,3665,140494,67.0,31916,27.0,34147,148.0,6287,3148,124110,258.0,7100,111.0,2997,27,6626
142,5/5/2021,2230,321411,478,183301,1788,142282,63.0,31979,24.0,34171,86.0,6373,1481,125591,141.0,7241,80.0,3077,13,6639
143,5/6/2021,3688,325099,821,184122,2985,145267,100.0,32079,40.0,34211,178.0,6551,2473,128064,198.0,7439,136.0,3213,45,6684
144,5/7/2021,2940,328039,544,184666,2489,147756,44.0,32123,11.0,34222,134.0,6685,2046,130110,211.0,7650,98.0,3311,37,6721
145,5/8/2021,2983,331022,553,185219,2533,150289,45.0,32168,16.0,34238,167.0,6852,2042,132152,194.0,7844,130.0,3441,46,6767
146,5/9/2021,365,331387,140,185359,238,150527,4.0,32172,2.0,34240,10.0,6862,198,132350,20.0,7864,10.0,3451,3,6770
147,5/10/2021,2424,333811,378,185737,2080,152607,60.0,32232,16.0,34256,87.0,6949,1692,134042,205.0,8069,96.0,3547,25,6795
148,5/11/2021,2718,336529,542,186279,2219,154826,92.0,32324,24.0,34280,190.0,7139,1728,135770,204.0,8273,97.0,3644,17,6812
149,5/12/2021,1226,337755,458,186737,820,155646,23.0,32347,14.0,34294,48.0,7187,650,136420,87.0,8360,35.0,3679,23,6835
150,5/13/2021,3250,341005,1030,187767,2236,157882,82.0,32429,25.0,34319,151.0,7338,1821,138241,159.0,8519,105.0,3784,16,6851
151,5/14/2021,2476,343481,1280,189047,1295,159177,51.0,32480,30.0,34349,64.0,7402,1074,139315,102.0,8621,55.0,3839,33,6884
152,5/15/2021,3017,346498,1508,190555,1595,160772,39.0,32519,15.0,34364,114.0,7516,1264,140579,143.0,8764,74.0,3913,24,6908
153,5/16/2021,946,347444,574,191129,405,161177,8.0,32527,8.0,34372,83.0,7599,252,140831,29.0,8793,41.0,3954,10,6918
154,5/17/2021,2447,349891,1210,192339,1308,162485,37.0,32564,27.0,34399,48.0,7647,1098,141929,101.0,8894,61.0,4015,21,6939
155,5/18/2021,2583,352474,1176,193515,1441,163926,44.0,32608,22.0,34421,72.0,7719,1209,143138,83.0,8977,77.0,4092,19,6958
156,5/19/2021,1876,354350,1155,194670,786,164712,24.0,32632,19.0,34440,42.0,7761,636,143774,69.0,9046,39.0,4131,15,6973
157,5/20/2021,1981,356331,924,195594,1101,165813,46.0,32678,27.0,34467,94.0,7855,876,144650,81.0,9127,50.0,4181,17,6990
158,5/21/2021,1626,357957,923,196517,784,166597,18.0,32696,16.0,34483,43.0,7898,626,145276,58.0,9185,57.0,4238,26,7016
159,5/22/2021,1684,359641,791,197308,922,167519,9.0,32705,13.0,34496,122.0,8020,640,145916,74.0,9259,86.0,4324,15,7031
160,5/23/2021,681,360322,343,197651,368,167887,2.0,32707,5.0,34501,68.0,8088,227,146143,18.0,9277,55.0,4379,3,7034
161,5/24/2021,1336,361658,537,198188,851,168738,36.0,32743,20.0,34521,43.0,8131,684,146827,83.0,9360,41.0,4420,19,7053
162,5/25/2021,1231,362889,508,198696,755,169493,22.0,32765,20.0,34541,57.0,8188,569,147396,64.0,9424,65.0,4485,18,7071
163,5/26/2021,967,363856,554,199250,527,170020,17.0,32782,25.0,34566,37.0,8225,415,147811,44.0,9468,31.0,4516,24,7095
164,5/27/2021,1270,365126,657,199907,678,170698,32.0,32814,19.0,34585,54.0,8279,547,148358,50.0,9518,27.0,4543,19,7114
165,5/28/2021,1030,366156,596,200503,479,171177,18.0,32832,22.0,34607,29.0,8308,373,148731,49.0,9567,28.0,4571,16,7130
166,5/29/2021,1018,367174,492,200995,563,171740,18.0,32850,8.0,34615,32.0,8340,443,149174,43.0,9610,45.0,4616,12,7142
167,5/30/2021,331,367505,220,201215,144,171884,5.0,32855,3.0,34618,13.0,8353,104,149278,17.0,9627,10.0,4626,8,7150
168,5/31/2021,339,367844,191,201406,174,172058,8.0,32863,6.0,34624,8.0,8361,139,149417,13.0,9640,14.0,4640,11,7161
169,6/1/2021,966,368810,394,201800,603,172661,27.0,32890,17.0,34641,49.0,8410,461,149878,46.0,9686,47.0,4687,24,7185
170,6/2/2021,719,369529,368,202168,406,173067,16.0,32906,8.0,34649,34.0,8444,321,150199,23.0,9709,28.0,4715,8,7193
171,6/3/2021,1306,370835,523,202691,833,173900,22.0,32928,12.0,34661,46.0,8490,688,150887,57.0,9766,42.0,4757,15,7208
172,6/4/2021,1503,372338,405,203096,1140,175040,16.0,32944,9.0,34670,71.0,8561,951,151838,70.0,9836,48.0,4805,4,7212
173,6/5/2021,1414,373752,357,203453,1085,176125,12.0,32956,6.0,34676,64.0,8625,889,152727,92.0,9928,40.0,4845,9,7221
174,6/6/2021,532,374284,142,203595,399,176524,5.0,32961,3.0,34679,43.0,8668,319,153046,25.0,9953,12.0,4857,10,7231
175,6/7/2021,1192,375476,334,203929,902,177426,14.0,32975,12.0,34691,67.0,8735,720,153766,83.0,10036,32.0,4889,18,7249
176,6/8/2021,1083,376559,252,204181,855,178281,18.0,32993,5.0,34696,57.0,8792,695,154461,68.0,10104,35.0,4924,4,7253
177,6/9/2021,1080,377639,283,204464,843,179124,15.0,33008,12.0,34708,78.0,8870,646,155107,72.0,10176,47.0,4971,12,7265
178,6/10/2021,1310,378949,334,204798,1013,180137,20.0,33028,4.0,34712,92.0,8962,799,155906,67.0,10243,55.0,5026,10,7275
179,6/11/2021,1112,380061,326,205124,829,180966,19.0,33047,13.0,34725,57.0,9019,650,156556,78.0,10321,44.0,5070,9,7284
180,6/12/2021,1042,381103,289,205413,795,181761,15.0,33062,9.0,34734,73.0,9092,615,157171,63.0,10384,44.0,5114,9,7293
181,6/13/2021,372,381475,98,205511,285,182046,4.0,33066,1.0,34735,37.0,9129,204,157375,25.0,10409,19.0,5133,6,7299
182,6/14/2021,830,382305,282,205793,592,182638,15.0,33081,4.0,34739,44.0,9173,449,157824,42.0,10451,57.0,5190,6,7305
183,6/15/2021,695,383000,238,206031,479,183117,20.0,33101,10.0,34749,40.0,9213,389,158213,34.0,10485,16.0,5206,2,7307
184,6/16/2021,622,383622,202,206233,446,183563,12.0,33113,4.0,34753,38.0,9251,339,158552,33.0,10518,36.0,5242,9,7316
185,6/17/2021,694,384316,251,206484,469,184032,13.0,33126,10.0,34763,41.0,9292,350,158902,49.0,10567,29.0,5271,3,7319
186,6/18/2021,1036,385352,380,206864,686,184718,23.0,33149,11.0,34774,52.0,9344,554,159456,51.0,10618,29.0,5300,7,7326
187,6/19/2021,633,385985,154,207018,494,185212,10.0,33159,6.0,34780,49.0,9393,365,159821,53.0,10671,27.0,5327,9,7335
188,6/20/2021,301,386286,114,207132,193,185405,3.0,33162,2.0,34782,36.0,9429,120,159941,15.0,10686,22.0,5349,5,7340
189,6/21/2021,515,386801,214,207346,327,185732,5.0,33167,8.0,34790,29.0,9458,242,160183,35.0,10721,21.0,5370,8,7348
190,6/22/2021,606,387407,249,207595,387,186119,12.0,33179,7.0,34797,31.0,9489,302,160485,25.0,10746,29.0,5399,5,7353
191,6/23/2021,512,387919,186,207781,353,186472,7.0,33186,10.0,34807,38.0,9527,256,160741,37.0,10783,22.0,5421,11,7364
192,6/24/2021,517,388436,210,207991,331,186803,12.0,33198,9.0,34816,30.0,9557,257,160998,23.0,10806,21.0,5442,1,7365
193,6/25/2021,687,389123,273,208264,436,187239,12.0,33210,8.0,34824,42.0,9599,323,161321,43.0,10849,28.0,5470,5,7370
194,6/26/2021,596,389719,165,208429,440,187679,9.0,33219,9.0,34833,77.0,9676,288,161609,43.0,10892,32.0,5502,4,7374
195,6/27/2021,183,389902,71,208500,113,187792,2.0,33221,3.0,34836,9.0,9685,82,161691,12.0,10904,10.0,5512,2,7376
196,6/28/2021,487,390389,209,208709,284,188076,7.0,33228,6.0,34842,39.0,9724,205,161896,24.0,10928,16.0,5528,2,7378
197,6/29/2021,556,390945,252,208961,325,188401,16.0,33244,11.0,34853,42.0,9766,235,162131,22.0,10950,26.0,5554,11,7389
198,6/30/2021,412,391357,207,209168,219,188620,8.0,33252,11.0,34864,19.0,9785,164,162295,16.0,10966,20.0,5574,12,7401
199,7/1/2021,485,391842,208,209376,295,188915,8.0,33260,7.0,34871,21.0,9806,221,162516,33.0,10999,20.0,5594,4,7405
200,7/2/2021,569,392411,273,209649,307,189222,5.0,33265,7.0,34878,26.0,9832,242,162758,23.0,11022,16.0,5610,3,7408
201,7/3/2021,308,392719,120,209769,195,189417,4.0,33269,3.0,34881,29.0,9861,126,162884,21.0,11043,19.0,5629,5,7413
202,7/4/2021,53,392772,18,209787,35,189452,1.0,33270,0.0,34881,4.0,9865,22,162906,1.0,11044,8.0,5637,0,7413
203,7/5/2021,316,393088,140,209927,174,189626,3.0,33273,1.0,34882,18.0,9883,120,163026,26.0,11070,10.0,5647,4,7417
204,7/6/2021,449,393537,187,210114,271,189897,4.0,33277,5.0,34887,45.0,9928,192,163218,19.0,11089,15.0,5662,1,7418
205,7/7/2021,370,393907,209,210323,175,190072,7.0,33284,6.0,34893,19.0,9947,129,163347,12.0,11101,15.0,5677,4,7422
206,7/8/2021,426,394333,201,210524,246,190318,10.0,33294,8.0,34901,23.0,9970,177,163524,23.0,11124,23.0,5700,3,7425
207,7/9/2021,482,394815,194,210718,294,190612,9.0,33303,2.0,34903,36.0,10006,216,163740,24.0,11148,18.0,5718,6,7431
208,7/10/2021,258,395073,146,210864,127,190739,5.0,33308,2.0,34905,5.0,10011,105,163845,10.0,11158,7.0,5725,2,7433
209,7/11/2021,225,395298,121,210985,122,190861,6.0,33314,6.0,34911,11.0,10022,88,163933,10.0,11168,13.0,5738,7,7440
210,7/12/2021,385,395683,202,211187,196,191057,7.0,33321,4.0,34915,25.0,10047,130,164063,24.0,11192,17.0,5755,4,7444
211,7/13/2021,438,396121,226,211413,226,191283,16.0,33337,10.0,34925,27.0,10074,176,164239,12.0,11204,11.0,5766,5,7449
212,7/14/2021,281,396402,149,211562,155,191438,8.0,33345,5.0,34930,19.0,10093,112,164351,9.0,11213,15.0,5781,7,7456
213,7/15/2021,360,396762,189,211751,182,191620,1.0,33346,4.0,34934,15.0,10108,137,164488,13.0,11226,17.0,5798,3,7459
214,7/16/2021,510,397272,244,211995,276,191896,8.0,33354,9.0,34943,24.0,10132,210,164698,22.0,11248,20.0,5818,5,7464
215,7/17/2021,277,397549,158,212153,129,192025,11.0,33365,5.0,34948,11.0,10143,97,164795,10.0,11258,11.0,5829,6,7470
216,7/18/2021,195,397744,118,212271,89,192114,4.0,33369,3.0,34951,13.0,10156,63,164858,6.0,11264,7.0,5836,4,7474
217,7/19/2021,405,398149,205,212476,206,192320,8.0,33377,8.0,34959,26.0,10182,150,165008,17.0,11281,13.0,5849,4,7478
218,7/20/2021,414,398563,208,212684,214,192534,6.0,33383,8.0,34967,12.0,10194,165,165173,23.0,11304,14.0,5863,5,7483
219,7/21/2021,335,398898,183,212867,172,192706,13.0,33396,14.0,34981,12.0,10206,129,165302,14.0,11318,17.0,5880,3,7486
220,7/22/2021,394,399292,234,213101,170,192876,8.0,33404,19.0,35000,18.0,10224,126,165428,18.0,11336,8.0,5888,6,7492
221,7/23/2021,549,399841,316,213417,236,193112,6.0,33410,10.0,35010,36.0,10260,162,165590,19.0,11355,19.0,5907,3,7495
222,7/24/2021,352,400193,215,213632,156,193268,8.0,33418,10.0,35020,19.0,10279,114,165704,9.0,11364,14.0,5921,5,7500
223,7/25/2021,199,400392,144,213776,63,193331,0.0,33418,4.0,35024,7.0,10286,45,165749,5.0,11369,6.0,5927,4,7504
224,7/26/2021,346,400738,200,213976,144,193475,1.0,33419,7.0,35031,11.0,10297,98,165847,18.0,11387,17.0,5944,4,7508
225,7/27/2021,422,401160,236,214212,173,193648,5.0,33424,16.0,35047,21.0,10318,122,165969,17.0,11404,13.0,5957,16,7524
226,7/28/2021,467,401627,284,214496,221,193869,3.0,33427,10.0,35057,28.0,10346,144,166113,16.0,11420,33.0,5990,5,7529
227,7/29/2021,511,402138,305,214801,236,194105,8.0,33435,6.0,35063,24.0,10370,180,166293,13.0,11433,19.0,6009,9,7538
228,7/30/2021,683,402821,474,215275,247,194352,10.0,33445,14.0,35077,25.0,10395,187,166480,16.0,11449,19.0,6028,5,7543
229,7/31/2021,334,403155,202,215477,136,194488,4.0,33449,1.0,35078,15.0,10410,107,166587,9.0,11458,5.0,6033,5,7548
230,8/1/2021,269,403424,170,215647,107,194595,0.0,33449,2.0,35080,15.0,10425,68,166655,8.0,11466,16.0,6049,8,7556
231,8/2/2021,444,403868,296,215943,172,194767,4.0,33453,13.0,35093,20.0,10445,119,166774,20.0,11486,13.0,6062,5,7561
232,8/3/2021,561,404429,347,216290,240,195007,6.0,33459,13.0,35106,37.0,10482,162,166936,15.0,11501,26.0,6088,4,7565
233,8/4/2021,390,404819,273,216563,138,195145,3.0,33462,14.0,35120,10.0,10492,105,167041,5.0,11506,18.0,6106,10,7575
234,8/5/2021,445,405264,287,216850,169,195314,5.0,33467,11.0,35131,19.0,10511,122,167163,17.0,11523,11.0,6117,4,7579
235,8/6/2021,679,405943,461,217311,264,195578,12.0,33479,16.0,35147,22.0,10533,200,167363,22.0,11545,20.0,6137,4,7583
236,8/7/2021,439,406382,305,217616,157,195735,4.0,33483,10.0,35157,12.0,10545,124,167487,5.0,11550,16.0,6153,5,7588
237,8/8/2021,217,406599,126,217742,98,195833,3.0,33486,5.0,35162,8.0,10553,72,167559,6.0,11556,12.0,6165,5,7593
238,8/9/2021,465,407064,281,218023,214,196047,4.0,33490,6.0,35168,22.0,10575,159,167718,11.0,11567,22.0,6187,8,7601
239,8/10/2021,503,407567,301,218324,227,196274,6.0,33496,14.0,35182,25.0,10600,179,167897,10.0,11577,13.0,6200,8,7609
240,8/11/2021,417,407984,265,218589,175,196449,11.0,33507,5.0,35187,16.0,10616,133,168030,14.0,11591,12.0,6212,3,7612
241,8/12/2021,542,408526,319,218908,259,196708,7.0,33514,13.0,35200,31.0,10647,182,168212,23.0,11614,23.0,6235,7,7619
242,8/13/2021,658,409184,379,219287,297,197005,11.0,33525,9.0,35209,31.0,10678,216,168428,19.0,11633,31.0,6266,6,7625
243,8/14/2021,503,409687,257,219544,249,197254,7.0,33532,9.0,35218,10.0,10688,213,168641,9.0,11642,17.0,6283,47,7672
244,8/15/2021,264,409951,129,219673,124,197378,2.0,33534,3.0,35221,11.0,10699,90,168731,6.0,11648,17.0,6300,19,7691
245,8/16/2021,538,410489,309,219982,168,197546,4.0,33538,11.0,35232,15.0,10714,128,168859,13.0,11661,12.0,6312,76,7767
246,8/17/2021,481,410970,227,220209,193,197739,20.0,33558,10.0,35242,17.0,10731,146,169005,10.0,11671,20.0,6332,80,7847
247,8/18/2021,591,411561,323,220532,255,197994,5.0,33563,15.0,35257,30.0,10761,172,169177,13.0,11684,40.0,6372,72,7919
248,8/19/2021,566,412127,278,220810,255,198249,7.0,33570,9.0,35266,21.0,10782,205,169382,17.0,11701,12.0,6384,77,7996
249,8/20/2021,842,412969,340,221150,452,198701,16.0,33586,11.0,35277,44.0,10826,359,169741,29.0,11730,20.0,6404,87,8083
250,8/21/2021,646,413615,211,221361,209,198910,4.0,33590,7.0,35284,14.0,10840,171,169912,13.0,11743,11.0,6415,196,8279
251,8/22/2021,317,413932,150,221511,144,199054,1.0,33591,2.0,35286,19.0,10859,102,170014,9.0,11752,14.0,6429,31,8310
252,8/23/2021,527,414459,262,221773,222,199276,10.0,33601,9.0,35295,19.0,10878,168,170182,12.0,11764,23.0,6452,61,8371
253,8/24/2021,570,415029,272,222045,277,199553,10.0,33611,8.0,35303,27.0,10905,217,170399,15.0,11779,18.0,6470,56,8427
254,8/25/2021,593,415622,320,222365,258,199811,12.0,33623,13.0,35316,19.0,10924,197,170596,9.0,11788,33.0,6503,48,8475
255,8/26/2021,535,416157,262,222627,252,200063,9.0,33632,14.0,35330,18.0,10942,194,170790,23.0,11811,17.0,6520,45,8520
256,8/27/2021,887,417044,351,222978,404,200467,15.0,33647,11.0,35341,37.0,10979,300,171090,22.0,11833,45.0,6565,157,8677
257,8/28/2021,1465,418509,202,223180,249,200716,7.0,33654,5.0,35346,23.0,11002,184,171274,14.0,11847,28.0,6593,995,9672
258,8/29/2021,1081,419590,161,223341,136,200852,4.0,33658,4.0,35350,8.0,11010,111,171385,12.0,11859,5.0,6598,773,10445
259,8/30/2021,618,420208,272,223613,282,201134,9.0,33667,13.0,35363,24.0,11034,217,171602,9.0,11868,32.0,6630,94,10539
260,8/31/2021,811,421019,235,223848,237,201371,7.0,33674,12.0,35375,18.0,11052,188,171790,18.0,11886,13.0,6643,343,10882
261,9/1/2021,950,421969,248,224096,221,201592,12.0,33686,15.0,35390,21.0,11073,168,171958,13.0,11899,19.0,6662,488,11370
262,9/2/2021,829,422798,184,224280,205,201797,13.0,33699,14.0,35404,19.0,11092,152,172110,16.0,11915,18.0,6680,461,11831
263,9/3/2021,855,423653,340,224620,372,202169,13.0,33712,12.0,35416,44.0,11136,272,172382,20.0,11935,36.0,6716,163,11994
264,9/4/2021,375,424028,163,224783,164,202333,6.0,33718,8.0,35424,13.0,11149,127,172509,11.0,11946,13.0,6729,58,12052
265,9/5/2021,251,424279,131,224914,108,202441,2.0,33720,4.0,35428,12.0,11161,77,172586,9.0,11955,10.0,6739,21,12073
266,9/6/2021,112,424391,47,224961,58,202499,1.0,33721,0.0,35428,4.0,11165,43,172629,8.0,11963,3.0,6742,12,12085
267,9/7/2021,952,425343,199,225160,272,202771,19.0,33740,12.0,35440,22.0,11187,208,172837,17.0,11980,25.0,6767,486,12571
268,9/8/2021,789,426132,219,225379,224,202995,11.0,33751,12.0,35452,24.0,11211,166,173003,10.0,11990,24.0,6791,370,12941
269,9/9/2021,403,426535,176,225555,195,203190,9.0,33760,8.0,35460,21.0,11232,143,173146,14.0,12004,17.0,6808,55,12996
270,9/10/2021,753,427288,340,225895,307,203497,9.0,33769,23.0,35483,28.0,11260,231,173377,20.0,12024,28.0,6836,147,13143
271,9/11/2021,1633,428921,162,226057,210,203707,10.0,33779,19.0,35502,18.0,11278,160,173537,15.0,12039,17.0,6853,1273,14416
272,9/12/2021,232,429153,101,226158,113,203820,1.0,33780,2.0,35504,11.0,11289,72,173609,10.0,12049,20.0,6873,16,14432
273,9/13/2021,492,429645,220,226378,245,204065,9.0,33789,8.0,35512,24.0,11313,184,173793,12.0,12061,25.0,6898,45,14477
274,9/14/2021,844,430489,204,226582,274,204339,14.0,33803,16.0,35528,17.0,11330,220,174013,14.0,12075,23.0,6921,401,14878
275,9/15/2021,830,431319,190,226772,266,204605,15.0,33818,15.0,35543,21.0,11351,196,174209,17.0,12092,32.0,6953,398,15276
276,9/16/2021,356,431675,134,226906,194,204799,9.0,33827,8.0,35551,32.0,11383,139,174348,11.0,12103,12.0,6965,43,15319
277,9/17/2021,746,432421,284,227190,387,205186,13.0,33840,13.0,35564,29.0,11412,289,174637,38.0,12141,31.0,6996,123,15442
278,9/18/2021,1839,434260,128,227318,171,205357,5.0,33845,20.0,35584,10.0,11422,126,174763,15.0,12156,20.0,7016,1543,16985
279,9/19/2021,181,434441,74,227392,106,205463,3.0,33848,2.0,35586,6.0,11428,82,174845,5.0,12161,13.0,7029,11,16996
280,9/20/2021,386,434827,144,227536,217,205680,8.0,33856,9.0,35595,27.0,11455,161,175006,10.0,12171,19.0,7048,55,17051
281,9/21/2021,771,435598,166,227702,199,205879,9.0,33865,14.0,35609,21.0,11476,153,175159,8.0,12179,17.0,7065,420,17471
282,9/22/2021,718,436316,164,227866,230,206109,6.0,33871,12.0,35621,15.0,11491,181,175340,16.0,12195,18.0,7083,362,17833
283,9/23/2021,348,436664,144,228010,179,206288,8.0,33879,3.0,35624,9.0,11500,132,175472,13.0,12208,25.0,7108,47,17880
284,9/24/2021,696,437360,208,228218,275,206563,16.0,33895,16.0,35640,20.0,11520,218,175690,11.0,12219,26.0,7134,232,18112
285,9/25/2021,1734,439094,136,228354,176,206739,11.0,33906,21.0,35661,15.0,11535,137,175827,12.0,12231,12.0,7146,1428,19540
286,9/26/2021,263,439357,65,228419,87,206826,3.0,33909,3.0,35664,11.0,11546,65,175892,4.0,12235,7.0,7153,110,19650
287,9/27/2021,566,439923,156,228575,124,206950,7.0,33916,11.0,35675,7.0,11553,96,175988,8.0,12243,13.0,7166,302,19952
288,9/28/2021,1127,441050,157,228732,203,207153,19.0,33935,23.0,35698,15.0,11568,154,176142,9.0,12252,25.0,7191,789,20741
289,9/29/2021,1142,442192,174,228906,171,207324,12.0,33947,19.0,35717,15.0,11583,127,176269,7.0,12259,22.0,7213,812,21553
290,9/30/2021,705,442897,161,229067,166,207490,15.0,33962,7.0,35724,11.0,11594,127,176396,10.0,12269,18.0,7231,408,21961
291,10/1/2021,1061,443958,175,229242,301,207791,20.0,33982,15.0,35739,20.0,11614,238,176634,21.0,12290,22.0,7253,601,22562
292,10/2/2021,1815,445773,118,229360,115,207906,12.0,33994,14.0,35753,9.0,11623,96,176730,5.0,12295,5.0,7258,1588,24150
293,10/3/2021,392,446165,64,229424,113,208019,1.0,33995,2.0,35755,18.0,11641,77,176807,7.0,12302,11.0,7269,227,24377
294,10/4/2021,794,446959,113,229537,156,208175,7.0,34002,12.0,35767,27.0,11668,102,176909,14.0,12316,13.0,7282,532,24909
295,10/5/2021,1116,448075,138,229675,135,208310,12.0,34014,17.0,35784,13.0,11681,103,177012,5.0,12321,14.0,7296,854,25763
296,10/6/2021,997,449072,106,229781,155,208465,8.0,34022,14.0,35798,11.0,11692,122,177134,5.0,12326,17.0,7313,753,26516
297,10/7/2021,783,449855,132,229913,107,208572,8.0,34030,14.0,35812,8.0,11700,83,177217,5.0,12331,11.0,7324,565,27081
298,10/8/2021,1036,450891,157,230070,239,208811,19.0,34049,11.0,35823,20.0,11720,186,177403,11.0,12342,22.0,7346,651,27732
299,10/9/2021,1676,452567,108,230178,131,208942,11.0,34060,8.0,35831,22.0,11742,98,177501,3.0,12345,8.0,7354,1439,29171
300,10/10/2021,243,452810,50,230228,63,209005,2.0,34062,2.0,35833,4.0,11746,49,177550,5.0,12350,5.0,7359,131,29302
301,10/11/2021,821,453631,123,230351,135,209140,16.0,34078,18.0,35851,3.0,11749,111,177661,10.0,12360,11.0,7370,574,29876
302,10/12/2021,1023,454654,118,230469,132,209272,8.0,34086,20.0,35871,16.0,11765,104,177765,4.0,12364,8.0,7378,783,30659
303,10/13/2021,970,455624,116,230585,150,209422,16.0,34102,8.0,35879,16.0,11781,114,177879,12.0,12376,8.0,7386,722,31381
304,10/14/2021,712,456336,102,230687,127,209549,14.0,34116,9.0,35888,20.0,11801,94,177973,8.0,12384,5.0,7391,490,31871
305,10/15/2021,1028,457364,177,230864,215,209764,11.0,34127,7.0,35895,15.0,11816,169,178142,13.0,12397,18.0,7409,671,32542
306,10/16/2021,803,458167,66,230930,80,209844,4.0,34131,3.0,35898,6.0,11822,69,178211,2.0,12399,3.0,7412,657,33199
307,10/17/2021,196,458363,48,230978,63,209907,1.0,34132,2.0,35900,4.0,11826,47,178258,3.0,12402,9.0,7421,83,33282
308,10/18/2021,652,459015,119,231097,135,210042,10.0,34142,4.0,35904,13.0,11839,106,178364,6.0,12408,10.0,7431,413,33695
309,10/19/2021,1050,460065,120,231217,134,210176,4.0,34146,11.0,35915,8.0,11847,108,178472,8.0,12416,10.0,7441,806,34501
310,10/20/2021,893,460958,121,231338,121,210297,6.0,34152,11.0,35926,9.0,11856,91,178563,7.0,12423,14.0,7455,665,35166
311,10/21/2021,534,461492,107,231445,128,210425,9.0,34161,8.0,35934,14.0,11870,86,178649,11.0,12434,17.0,7472,320,35486
312,10/22/2021,1479,462971,195,231640,230,210655,9.0,34170,13.0,35947,20.0,11890,171,178820,14.0,12448,25.0,7497,1075,36561
313,10/23/2021,1880,464851,88,231728,195,210850,14.0,34184,15.0,35962,4.0,11894,170,178990,11.0,12459,10.0,7507,1600,38161
314,10/24/2021,569,465420,81,231809,152,211002,8.0,34192,11.0,35973,12.0,11906,128,179118,7.0,12466,5.0,7512,349,38510
315,10/25/2021,1384,466804,137,231946,297,211299,27.0,34219,17.0,35990,12.0,11918,252,179370,21.0,12487,12.0,7524,963,39473
316,10/26/2021,2143,468947,177,232123,299,211598,14.0,34233,17.0,36007,19.0,11937,248,179618,18.0,12505,14.0,7538,1677,41150
317,10/27/2021,1971,470918,153,232276,274,211872,19.0,34252,19.0,36026,9.0,11946,242,179860,14.0,12519,9.0,7547,1552,42702
318,10/28/2021,1711,472629,139,232415,260,212132,11.0,34263,20.0,36046,11.0,11957,219,180079,17.0,12536,13.0,7560,1323,44025
319,10/29/2021,1656,474285,179,232594,278,212410,12.0,34275,15.0,36061,10.0,11967,243,180322,12.0,12548,13.0,7573,1210,45235
320,10/30/2021,1586,475871,79,232673,151,212561,13.0,34288,8.0,36069,6.0,11973,130,180452,9.0,12557,6.0,7579,1365,46600
321,10/31/2021,463,476334,48,232721,74,212635,2.0,34290,6.0,36075,6.0,11979,62,180514,4.0,12561,2.0,7581,340,46940
322,11/1/2021,1239,477573,136,232857,217,212852,10.0,34300,10.0,36085,10.0,11989,177,180691,12.0,12573,18.0,7599,894,47834
323,11/2/2021,1818,479391,131,232988,200,213052,8.0,34308,17.0,36102,14.0,12003,162,180853,13.0,12586,11.0,7610,1502,49336
324,11/3/2021,1743,481134,159,233147,229,213281,12.0,34320,17.0,36119,15.0,12018,181,181034,16.0,12602,17.0,7627,1371,50707
325,11/4/2021,1409,482543,145,233292,183,213464,4.0,34324,13.0,36132,1.0,12019,159,181193,12.0,12614,11.0,7638,1106,51813
326,11/5/2021,2015,484558,227,233519,298,213762,14.0,34338,12.0,36144,17.0,12036,249,181442,14.0,12628,18.0,7656,1522,53335
327,11/6/2021,1578,486136,215,233734,142,213904,4.0,34342,7.0,36151,6.0,12042,115,181557,15.0,12643,6.0,7662,1229,54564
328,11/7/2021,522,486658,119,233853,77,213981,1.0,34343,8.0,36159,5.0,12047,63,181620,3.0,12646,6.0,7668,327,54891
329,11/8/2021,1525,488183,386,234239,198,214179,7.0,34350,9.0,36168,11.0,12058,164,181784,9.0,12655,14.0,7682,962,55853
330,11/9/2021,2630,490813,944,235183,221,214400,10.0,34360,21.0,36189,15.0,12073,163,181947,16.0,12671,27.0,7709,1485,57338
331,11/10/2021,2487,493300,823,236006,223,214623,11.0,34371,18.0,36207,12.0,12085,176,182123,22.0,12693,13.0,7722,1465,58803
332,11/11/2021,2347,495647,966,236972,188,214811,17.0,34388,8.0,36215,13.0,12098,154,182277,13.0,12706,8.0,7730,1213,60016
333,11/12/2021,2553,498200,754,237726,240,215051,12.0,34400,19.0,36234,23.0,12121,191,182468,13.0,12719,13.0,7743,1570,61586
334,11/13/2021,1927,500127,405,238131,140,215191,4.0,34404,12.0,36246,7.0,12128,104,182572,15.0,12734,14.0,7757,1392,62978
335,11/14/2021,1481,501608,911,239042,107,215298,1.0,34405,2.0,36248,11.0,12139,72,182644,14.0,12748,10.0,7767,472,63450
336,11/15/2021,1954,503562,452,239494,199,215497,7.0,34412,11.0,36259,12.0,12151,159,182803,12.0,12760,16.0,7783,1324,64774
337,11/16/2021,2398,505960,455,239949,212,215709,5.0,34417,21.0,36280,26.0,12177,155,182958,17.0,12777,14.0,7797,1743,66517
338,11/17/2021,2721,508681,633,240582,268,215977,12.0,34429,16.0,36296,16.0,12193,221,183179,17.0,12794,14.0,7811,1851,68368
339,11/18/2021,1885,510566,377,240959,178,216155,7.0,34436,11.0,36307,15.0,12208,143,183322,15.0,12809,5.0,7816,1345,69713
340,11/19/2021,2562,513128,716,241675,281,216436,13.0,34449,14.0,36321,9.0,12217,235,183557,20.0,12829,17.0,7833,1585,71298
341,11/20/2021,1874,515002,531,242206,112,216548,6.0,34455,5.0,36326,8.0,12225,95,183652,4.0,12833,5.0,7838,1234,72532
342,11/21/2021,639,515641,124,242330,85,216633,0.0,34455,1.0,36327,3.0,12228,69,183721,8.0,12841,5.0,7843,433,72965
343,11/22/2021,1970,517611,427,242757,208,216841,11.0,34466,21.0,36348,10.0,12238,169,183890,11.0,12852,18.0,7861,1355,74320
344,11/23/2021,1837,519448,289,243046,184,217025,8.0,34474,15.0,36363,15.0,12253,148,184038,14.0,12866,7.0,7868,1373,75693
345,11/24/2021,1510,520958,216,243262,162,217187,6.0,34480,11.0,36374,14.0,12267,131,184169,11.0,12877,6.0,7874,1146,76839
346,11/25/2021,46,521004,9,243271,2,217189,0.0,34480,0.0,36374,0.0,12267,1,184170,1.0,12878,,7874,35,76874
347,11/26/2021,1257,522261,191,243462,202,217391,3.0,34483,4.0,36378,17.0,12284,163,184333,12.0,12890,10.0,7884,883,77757
348,11/27/2021,946,523207,137,243599,152,217543,2.0,34485,2.0,36380,7.0,12291,130,184463,8.0,12898,7.0,7891,659,78416
349,11/28/2021,539,523746,96,243695,104,217647,2.0,34487,2.0,36382,9.0,12300,83,184546,5.0,12903,7.0,7898,345,78761
350,11/29/2021,1838,525584,276,243971,407,218054,8.0,34495,14.0,36396,29.0,12329,338,184884,25.0,12928,15.0,7913,1176,79937
351,11/30/2021,2656,528240,338,244309,787,218841,8.0,34503,11.0,36407,51.0,12380,663,185547,61.0,12989,12.0,7925,1551,81488
352,12/1/2021,2429,530669,261,244570,746,219587,13.0,34516,10.0,36417,30.0,12410,656,186203,56.0,13045,4.0,7929,1433,82921
353,12/2/2021,2803,533472,351,244921,911,220498,9.0,34525,15.0,36432,69.0,12479,740,186943,73.0,13118,29.0,7958,1568,84489
354,12/3/2021,2583,536055,287,245208,755,221253,11.0,34536,4.0,36436,61.0,12540,596,187539,69.0,13187,29.0,7987,1561,86050
355,12/4/2021,2183,538238,162,245370,420,221673,4.0,34540,1.0,36437,24.0,12564,329,187868,36.0,13223,31.0,8018,1608,87658
356,12/5/2021,1377,539615,104,245474,840,222513,1.0,34541,0.0,36437,67.0,12631,667,188535,69.0,13292,37.0,8055,442,88100
357,12/6/2021,1914,541529,233,245707,466,222979,7.0,34548,5.0,36442,54.0,12685,363,188898,33.0,13325,16.0,8071,1228,89328
358,12/7/2021,2444,543973,307,246014,468,223447,10.0,34558,9.0,36451,49.0,12734,372,189270,31.0,13356,16.0,8087,1688,91016
359,12/8/2021,2226,546199,270,246284,512,223959,9.0,34567,12.0,36463,29.0,12763,429,189699,40.0,13396,14.0,8101,1466,92482
360,12/9/2021,2144,548343,304,246588,459,224418,6.0,34573,8.0,36471,27.0,12790,356,190055,43.0,13439,33.0,8134,1395,93877
361,12/10/2021,2084,550427,241,246829,403,224821,10.0,34583,9.0,36480,38.0,12828,313,190368,32.0,13471,20.0,8154,1450,95327
362,12/11/2021,1777,552204,135,246964,491,225312,6.0,34589,1.0,36481,59.0,12887,365,190733,41.0,13512,26.0,8180,1153,96480
363,12/12/2021,415,552619,55,247019,88,225400,1.0,34590,3.0,36484,4.0,12891,71,190804,7.0,13519,6.0,8186,275,96755
364,12/13/2021,1748,554367,298,247317,392,225792,9.0,34599,9.0,36493,26.0,12917,318,191122,35.0,13554,13.0,8199,1076,97831
365,12/14/2021,2176,556543,276,247593,365,226157,7.0,34606,5.0,36498,33.0,12950,299,191421,16.0,13570,17.0,8216,1560,99391
366,12/15/2021,1735,558278,202,247795,228,226385,6.0,34612,4.0,36502,9.0,12959,185,191606,19.0,13589,15.0,8231,1318,100709
367,12/16/2021,1764,560042,314,248109,246,226631,7.0,34619,7.0,36509,16.0,12975,206,191812,15.0,13604,9.0,8240,1222,101931
368,12/17/2021,2109,562151,308,248417,441,227072,6.0,34625,10.0,36519,28.0,13003,363,192175,39.0,13643,11.0,8251,1371,103302
369,12/18/2021,1800,563951,180,248597,240,227312,4.0,34629,4.0,36523,17.0,13020,205,192380,10.0,13653,8.0,8259,1381,104683
370,12/19/2021,438,564389,44,248641,80,227392,1.0,34630,3.0,36526,5.0,13025,66,192446,3.0,13656,6.0,8265,314,104997
371,12/20/2021,1548,565937,198,248839,241,227633,10.0,34640,9.0,36535,27.0,13052,191,192637,16.0,13672,7.0,8272,1114,106111
372,12/21/2021,2183,568120,309,249148,293,227926,10.0,34650,8.0,36543,28.0,13080,227,192864,25.0,13697,13.0,8285,1589,107700
373,12/22/2021,1869,569989,218,249366,284,228210,4.0,34654,9.0,36552,27.0,13107,227,193091,22.0,13719,8.0,8293,1370,109070
374,12/23/2021,1232,571221,217,249583,206,228416,5.0,34659,5.0,36557,23.0,13130,156,193247,16.0,13735,11.0,8304,822,109892
375,12/24/2021,319,571540,45,249628,63,228479,3.0,34662,2.0,36559,4.0,13134,54,193301,4.0,13739,1.0,8305,213,110105
376,12/25/2021,14,571554,3,249631,2,228481,0.0,34662,0.0,36559,,13134,1,193302,1.0,13740,,8305,9,110114
377,12/26/2021,354,571908,60,249691,68,228549,1.0,34663,0.0,36559,7.0,13141,53,193355,5.0,13745,3.0,8308,228,110342
378,12/27/2021,1249,573157,175,249866,222,228771,4.0,34667,5.0,36564,18.0,13159,176,193531,20.0,13765,8.0,8316,859,111201
379,12/28/2021,1889,575046,269,250135,296,229067,12.0,34679,12.0,36576,35.0,13194,231,193762,16.0,13781,14.0,8330,1328,112529
380,12/29/2021,1693,576739,212,250347,251,229318,5.0,34684,6.0,36582,27.0,13221,191,193953,22.0,13803,11.0,8341,1241,113770
381,12/30/2021,1366,578105,223,250570,239,229557,7.0,34691,9.0,36591,26.0,13247,186,194139,15.0,13818,12.0,8353,914,114684
382,12/31/2021,500,578605,97,250667,92,229649,0.0,34691,2.0,36593,7.0,13254,75,194214,5.0,13823,5.0,8358,314,114998
383,1/1/2022,93,578698,12,250679,16,229665,1.0,34692,1.0,36594,0.0,13254,13,194227,2.0,13825,1.0,8359,65,115063
384,1/2/2022,315,579013,45,250724,60,229725,1.0,34693,1.0,36595,7.0,13261,41,194268,9.0,13834,3.0,8362,211,115274
385,1/3/2022,1595,580608,330,251054,345,230070,4.0,34697,5.0,36600,34.0,13295,281,194549,20.0,13854,10.0,8372,930,116204
386,1/4/2022,1669,582277,264,251318,275,230345,10.0,34707,7.0,36607,30.0,13325,217,194766,17.0,13871,11.0,8383,1143,117347
387,1/5/2022,1332,583609,208,251526,200,230545,7.0,34714,8.0,36615,13.0,13338,163,194929,9.0,13880,15.0,8398,938,118285
388,1/6/2022,1225,584834,252,251778,232,230777,4.0,34718,4.0,36619,24.0,13362,173,195102,13.0,13893,22.0,8420,750,119035
389,1/7/2022,2053,586887,253,252031,340,231117,6.0,34724,9.0,36628,35.0,13397,262,195364,30.0,13923,13.0,8433,1472,120507
390,1/8/2022,1573,588460,125,252156,130,231247,0.0,34724,3.0,36631,7.0,13404,109,195473,7.0,13930,7.0,8440,1322,121829
391,1/9/2022,497,588957,92,252248,72,231319,0.0,34724,2.0,36633,14.0,13418,49,195522,3.0,13933,6.0,8446,334,122163
392,1/10/2022,1552,590509,287,252535,251,231570,3.0,34727,6.0,36639,19.0,13437,194,195716,27.0,13960,11.0,8457,1025,123188
393,1/11/2022,1558,592067,219,252754,274,231844,3.0,34730,4.0,36643,31.0,13468,209,195925,15.0,13975,19.0,8476,1077,124265
394,1/12/2022,1400,593467,179,252933,184,232028,6.0,34736,5.0,36648,28.0,13496,126,196051,20.0,13995,10.0,8486,1049,125314
395,1/13/2022,1097,594564,192,253125,177,232205,3.0,34739,2.0,36650,14.0,13510,131,196182,18.0,14013,14.0,8500,737,126051
396,1/14/2022,1615,596179,279,253404,214,232419,2.0,34741,9.0,36659,25.0,13535,156,196338,20.0,14033,13.0,8513,1137,127188
397,1/15/2022,1216,597395,137,253541,102,232521,1.0,34742,3.0,36662,11.0,13546,80,196418,9.0,14042,2.0,8515,978,128166
398,1/16/2022,289,597684,46,253587,35,232556,1.0,34743,0.0,36662,1.0,13547,31,196449,3.0,14045,0.0,8515,208,128374
399,1/17/2022,772,598456,159,253746,127,232683,4.0,34747,5.0,36667,12.0,13559,105,196554,8.0,14053,2.0,8517,488,128862
400,1/18/2022,887,599343,165,253911,165,232848,2.0,34749,6.0,36673,25.0,13584,126,196680,6.0,14059,8.0,8525,564,129426
401,1/19/2022,720,600063,121,254032,117,232965,4.0,34753,7.0,36680,9.0,13593,86,196766,10.0,14069,12.0,8537,494,129920
402,1/20/2022,780,600843,145,254177,147,233112,0.0,34753,10.0,36690,17.0,13610,111,196877,10.0,14079,9.0,8546,495,130415
403,1/21/2022,1174,602017,166,254343,172,233284,7.0,34760,2.0,36692,15.0,13625,133,197010,11.0,14090,13.0,8559,846,131261
404,1/22/2022,781,602798,87,254430,103,233387,0.0,34760,1.0,36693,14.0,13639,74,197084,6.0,14096,9.0,8568,594,131855
405,1/23/2022,210,603008,24,254454,53,233440,1.0,34761,0.0,36693,5.0,13644,41,197125,7.0,14103,0.0,8568,133,131988
406,1/24/2022,486,603494,75,254529,106,233546,1.0,34762,1.0,36694,14.0,13658,77,197202,8.0,14111,7.0,8575,308,132296
407,1/25/2022,662,604156,118,254647,142,233688,3.0,34765,2.0,36696,15.0,13673,100,197302,20.0,14131,7.0,8582,404,132700
408,1/26/2022,639,604795,99,254746,138,233826,7.0,34772,2.0,36698,12.0,13685,105,197407,13.0,14144,8.0,8590,411,133111
409,1/27/2022,613,605408,113,254859,170,233996,5.0,34777,1.0,36699,29.0,13714,125,197532,10.0,14154,6.0,8596,336,133447
410,1/28/2022,967,606375,164,255023,169,234165,6.0,34783,6.0,36705,20.0,13734,119,197651,14.0,14168,16.0,8612,639,134086
411,1/29/2022,556,606931,68,255091,83,234248,1.0,34784,4.0,36709,10.0,13744,60,197711,8.0,14176,5.0,8617,405,134491
412,1/30/2022,191,607122,33,255124,43,234291,1.0,34785,1.0,36710,13.0,13757,26,197737,1.0,14177,3.0,8620,117,134608
413,1/31/2022,553,607675,136,255260,120,234411,2.0,34787,2.0,36712,17.0,13774,79,197816,13.0,14190,11.0,8631,301,134909
414,2/1/2022,548,608223,99,255359,137,234548,0.0,34787,4.0,36716,19.0,13793,102,197918,11.0,14201,5.0,8636,314,135223
415,2/2/2022,126,608349,18,255377,45,234593,0.0,34787,1.0,36717,2.0,13795,41,197959,1.0,14202,1.0,8637,66,135289
416,2/3/2022,362,608711,75,255452,114,234707,0.0,34787,3.0,36720,24.0,13819,78,198037,6.0,14208,6.0,8643,178,135467
417,2/4/2022,634,609345,107,255559,144,234851,6.0,34793,3.0,36723,16.0,13835,113,198150,9.0,14217,6.0,8649,385,135852
418,2/5/2022,456,609801,57,255616,112,234963,2.0,34795,0.0,36723,7.0,13842,90,198240,6.0,14223,9.0,8658,289,136141
419,2/6/2022,123,609924,21,255637,34,234997,0.0,34795,1.0,36724,1.0,13843,23,198263,6.0,14229,4.0,8662,69,136210
420,2/7/2022,358,610282,59,255696,107,235104,0.0,34795,0.0,36724,11.0,13854,83,198346,5.0,14234,8.0,8670,194,136404
421,2/8/2022,430,610712,86,255782,108,235212,0.0,34795,3.0,36727,15.0,13869,82,198428,5.0,14239,6.0,8676,246,136650
422,2/9/2022,239,610951,45,255827,58,235270,2.0,34797,1.0,36728,14.0,13883,35,198463,1.0,14240,8.0,8684,139,136789
