,Date,daily number of doses received by Larimer County residents,total number of doses recevied by residents,daily number of residents receiving first dose,total number of residents receiving first dose,daily number of residents vaccinated,total number of residents vaccinated,daily number of 70+ vaccinated,total number of 70+ vaccinated,daily number of 70+ at least one dose,total number of 70+ at least one dose,daily number of Latinx residents vaccinated,total of Latinx residents vaccinated,daily number of White non-Latinx residents vaccinated,total of White non-Latinx residents vaccinated,daily number of non-White non-Latinx residents vaccinated,total of non-White non-Latinx residents vaccinated,dailyUnknown,totalUnknown,daily_additional_doses,total_additional_doses
0,12/14/2020,32,32,32,32,1,1,0.0,0,1.0,1,0.0,0,1,1,0.0,0,,0,0,0
1,12/15/2020,13,45,13,45,0,1,,0,,1,,0,0,1,0.0,0,,0,0,0
2,12/16/2020,303,348,303,348,0,1,0.0,0,2.0,3,0.0,0,0,1,0.0,0,0.0,0,0,0
3,12/17/2020,990,1338,990,1338,0,1,0.0,0,11.0,14,0.0,0,0,1,0.0,0,0.0,0,0,0
4,12/18/2020,1056,2394,1056,2394,2,3,0.0,0,15.0,29,0.0,0,2,3,0.0,0,0.0,0,0,0
5,12/19/2020,722,3116,722,3116,0,3,0.0,0,14.0,43,0.0,0,0,3,0.0,0,0.0,0,0,0
6,12/20/2020,266,3382,266,3382,0,3,0.0,0,4.0,47,0.0,0,0,3,0.0,0,0.0,0,0,0
7,12/21/2020,357,3739,357,3739,3,6,0.0,0,3.0,50,0.0,0,3,6,0.0,0,0.0,0,0,0
8,12/22/2020,363,4102,363,4102,0,6,0.0,0,7.0,57,0.0,0,0,6,0.0,0,0.0,0,0,0
9,12/23/2020,440,4542,440,4542,0,6,0.0,0,6.0,63,0.0,0,0,6,0.0,0,0.0,0,0,0
10,12/24/2020,105,4647,105,4647,0,6,0.0,0,3.0,66,0.0,0,0,6,0.0,0,0.0,0,0,0
11,12/25/2020,1,4648,1,4648,0,6,,0,,66,,0,0,6,,0,,0,0,0
12,12/26/2020,227,4875,227,4875,1,7,0.0,0,3.0,69,0.0,0,1,7,0.0,0,0.0,0,0,0
13,12/27/2020,278,5153,278,5153,0,7,0.0,0,197.0,266,0.0,0,0,7,0.0,0,,0,0,0
14,12/28/2020,709,5862,709,5862,0,7,0.0,0,386.0,652,0.0,0,0,7,0.0,0,0.0,0,0,0
15,12/29/2020,912,6774,911,6773,1,8,0.0,0,461.0,1113,0.0,0,1,8,0.0,0,0.0,0,0,0
16,12/30/2020,882,7656,882,7655,0,8,0.0,0,273.0,1386,0.0,0,0,8,0.0,0,0.0,0,0,0
17,12/31/2020,894,8550,894,8549,0,8,0.0,0,342.0,1728,0.0,0,0,8,0.0,0,0.0,0,0,0
18,1/1/2021,4,8554,3,8552,1,9,,0,,1728,,0,1,9,,0,,0,0,0
19,1/2/2021,391,8945,391,8943,1,10,0.0,0,141.0,1869,0.0,0,1,10,0.0,0,0.0,0,0,0
20,1/3/2021,123,9068,123,9066,0,10,0.0,0,52.0,1921,0.0,0,0,10,0.0,0,0.0,0,0,0
21,1/4/2021,587,9655,574,9640,12,22,0.0,0,320.0,2241,0.0,0,10,20,2.0,2,0.0,0,0,0
22,1/5/2021,645,10300,636,10276,10,32,0.0,0,409.0,2650,0.0,0,9,29,1.0,3,0.0,0,0,0
23,1/6/2021,1230,11530,912,11188,310,342,4.0,4,515.0,3165,18.0,18,272,301,16.0,19,4.0,4,0,0
24,1/7/2021,1657,13187,702,11890,931,1273,11.0,15,406.0,3571,34.0,52,840,1141,42.0,61,15.0,19,0,0
25,1/8/2021,1990,15177,981,12871,991,2264,11.0,26,479.0,4050,48.0,100,880,2021,44.0,105,19.0,38,1,1
26,1/9/2021,1230,16407,529,13400,683,2947,12.0,38,303.0,4353,16.0,116,618,2639,37.0,142,12.0,50,0,1
27,1/10/2021,703,17110,428,13828,271,3218,4.0,42,261.0,4614,10.0,126,244,2883,14.0,156,3.0,53,0,1
28,1/11/2021,1148,18258,798,14626,347,3565,1.0,43,536.0,5150,10.0,136,315,3198,19.0,175,3.0,56,0,1
29,1/12/2021,1178,19436,880,15506,297,3862,8.0,51,517.0,5667,14.0,150,257,3455,18.0,193,8.0,64,1,2
30,1/13/2021,1078,20514,833,16339,242,4104,1.0,52,376.0,6043,23.0,173,196,3651,15.0,208,8.0,72,0,2
31,1/14/2021,870,21384,835,17174,35,4139,1.0,53,494.0,6537,2.0,175,31,3682,1.0,209,1.0,73,0,2
32,1/15/2021,1219,22603,1207,18381,12,4151,0.0,53,760.0,7297,0.0,175,12,3694,0.0,209,0.0,73,0,2
33,1/16/2021,986,23589,972,19353,14,4165,1.0,54,585.0,7882,0.0,175,13,3707,1.0,210,0.0,73,0,2
34,1/17/2021,54,23643,50,19403,4,4169,0.0,54,19.0,7901,0.0,175,2,3709,2.0,212,0.0,73,0,2
35,1/18/2021,1014,24657,812,20215,200,4369,48.0,102,598.0,8499,8.0,183,174,3883,13.0,225,5.0,78,2,4
36,1/19/2021,1258,25915,1116,21331,140,4509,8.0,110,737.0,9236,7.0,190,119,4002,6.0,231,8.0,86,0,4
37,1/20/2021,1421,27336,1202,22533,217,4726,17.0,127,571.0,9807,15.0,205,176,4178,9.0,240,17.0,103,1,5
38,1/21/2021,2253,29589,2043,24576,210,4936,7.0,134,1587.0,11394,13.0,218,175,4353,15.0,255,7.0,110,0,5
39,1/22/2021,1736,31325,1461,26037,274,5210,89.0,223,1090.0,12484,34.0,252,221,4574,13.0,268,6.0,116,0,5
40,1/23/2021,894,32219,561,26598,328,5538,54.0,277,416.0,12900,8.0,260,300,4874,13.0,281,7.0,123,0,5
41,1/24/2021,393,32612,104,26702,285,5823,205.0,482,61.0,12961,8.0,268,269,5143,8.0,289,,123,0,5
42,1/25/2021,1406,34018,785,27487,609,6432,360.0,842,554.0,13515,14.0,282,568,5711,15.0,304,12.0,135,0,5
43,1/26/2021,1622,35640,692,28179,916,7348,453.0,1295,441.0,13956,30.0,312,841,6552,32.0,336,13.0,148,0,5
44,1/27/2021,1836,37476,769,28948,1060,8408,534.0,1829,334.0,14290,40.0,352,967,7519,44.0,380,9.0,157,0,5
45,1/28/2021,1345,38821,539,29487,803,9211,356.0,2185,295.0,14585,25.0,377,735,8254,28.0,408,15.0,172,2,7
46,1/29/2021,1635,40456,1156,30643,475,9686,157.0,2342,826.0,15411,21.0,398,411,8665,33.0,441,10.0,182,0,7
47,1/30/2021,1228,41684,734,31377,490,10176,213.0,2555,598.0,16009,24.0,422,439,9104,21.0,462,6.0,188,0,7
48,1/31/2021,623,42307,398,31775,224,10400,76.0,2631,353.0,16362,5.0,427,198,9302,15.0,477,6.0,194,1,8
49,2/1/2021,1604,43911,901,32676,699,11099,466.0,3097,653.0,17015,17.0,444,646,9948,26.0,503,10.0,204,1,9
50,2/2/2021,1863,45774,730,33406,1126,12225,732.0,3829,583.0,17598,43.0,487,1038,10986,34.0,537,11.0,215,0,9
51,2/3/2021,1264,47038,584,33990,677,12902,320.0,4149,225.0,17823,48.0,535,577,11563,41.0,578,11.0,226,0,9
52,2/4/2021,2535,49573,1794,35784,730,13632,488.0,4637,1551.0,19374,29.0,564,654,12217,37.0,615,10.0,236,1,10
53,2/5/2021,2580,52153,1533,37317,1033,14665,680.0,5317,1305.0,20679,38.0,602,947,13164,30.0,645,18.0,254,2,12
54,2/6/2021,2218,54371,1595,38912,614,15279,441.0,5758,1240.0,21919,6.0,608,584,13748,22.0,667,2.0,256,0,12
55,2/7/2021,233,54604,89,39001,142,15421,95.0,5853,26.0,21945,7.0,615,126,13874,4.0,671,5.0,261,1,13
56,2/8/2021,2482,57086,1595,40596,879,16300,594.0,6447,1138.0,23083,26.0,641,808,14682,28.0,699,17.0,278,0,13
57,2/9/2021,2390,59476,1546,42142,839,17139,511.0,6958,998.0,24081,26.0,667,754,15436,32.0,731,27.0,305,0,13
58,2/10/2021,1586,61062,966,43108,616,17755,321.0,7279,288.0,24369,25.0,692,549,15985,26.0,757,16.0,321,4,17
59,2/11/2021,3532,64594,2000,45108,1522,19277,1053.0,8332,808.0,25177,55.0,747,1392,17377,49.0,806,26.0,347,2,19
60,2/12/2021,3265,67859,1812,46920,1442,20719,953.0,9285,800.0,25977,61.0,808,1326,18703,42.0,848,13.0,360,0,19
61,2/13/2021,2997,70856,2363,49283,628,21347,309.0,9594,672.0,26649,13.0,821,580,19283,23.0,871,12.0,372,1,20
62,2/14/2021,421,71277,350,49633,71,21418,49.0,9643,46.0,26695,2.0,823,64,19347,3.0,874,2.0,374,0,20
63,2/15/2021,2625,73902,2130,51763,491,21909,324.0,9967,256.0,26951,17.0,840,460,19807,12.0,886,2.0,376,0,20
64,2/16/2021,2753,76655,1920,53683,825,22734,496.0,10463,231.0,27182,35.0,875,750,20557,24.0,910,16.0,392,0,20
65,2/17/2021,1632,78287,655,54338,971,23705,479.0,10942,155.0,27337,29.0,904,886,21443,36.0,946,20.0,412,0,20
66,2/18/2021,2639,80926,1674,56012,954,24659,733.0,11675,275.0,27612,37.0,941,880,22323,30.0,976,7.0,419,1,21
67,2/19/2021,2421,83347,1029,57041,1374,26033,1015.0,12690,154.0,27766,44.0,985,1271,23594,44.0,1020,15.0,434,3,24
68,2/20/2021,1653,85000,689,57730,958,26991,782.0,13472,134.0,27900,22.0,1007,898,24492,28.0,1048,10.0,444,1,25
69,2/21/2021,108,85108,40,57770,67,27058,37.0,13509,8.0,27908,1.0,1008,64,24556,2.0,1050,0.0,444,0,25
70,2/22/2021,2024,87132,763,58533,1246,28304,921.0,14430,147.0,28055,37.0,1045,1162,25718,37.0,1087,10.0,454,1,26
71,2/23/2021,1222,88354,518,59051,703,29007,470.0,14900,161.0,28216,20.0,1065,635,26353,35.0,1122,13.0,467,0,26
72,2/24/2021,1410,89764,755,59806,648,29655,276.0,15176,136.0,28352,31.0,1096,593,26946,19.0,1141,5.0,472,1,27
73,2/25/2021,3867,93631,2072,61878,1786,31441,1505.0,16681,351.0,28703,47.0,1143,1686,28632,36.0,1177,17.0,489,0,27
74,2/26/2021,3273,96904,1156,63034,2110,33551,1745.0,18426,202.0,28905,33.0,1176,1989,30621,59.0,1236,29.0,518,2,29
75,2/27/2021,3491,100395,1662,64696,1819,35370,1558.0,19984,544.0,29449,36.0,1212,1704,32325,52.0,1288,27.0,545,1,30
76,2/28/2021,428,100823,358,65054,69,35439,43.0,20027,115.0,29564,2.0,1214,63,32388,2.0,1290,2.0,547,0,30
77,3/1/2021,2819,103642,1345,66399,1466,36905,1075.0,21102,300.0,29864,53.0,1267,1355,33743,46.0,1336,12.0,559,5,35
78,3/2/2021,3257,106899,1727,68126,1522,38427,1052.0,22154,383.0,30247,38.0,1305,1413,35156,44.0,1380,27.0,586,1,36
79,3/3/2021,1656,108555,1091,69217,562,38989,174.0,22328,203.0,30450,32.0,1337,502,35658,24.0,1404,4.0,590,0,36
80,3/4/2021,3002,111557,1582,70799,1421,40410,814.0,23142,170.0,30620,42.0,1379,1305,36963,54.0,1458,20.0,610,25,61
81,3/5/2021,3488,115045,2059,72858,1434,41844,811.0,23953,426.0,31046,39.0,1418,1329,38292,43.0,1501,23.0,633,26,87
82,3/6/2021,4110,119155,2328,75186,1985,43829,753.0,24706,268.0,31314,95.0,1513,1778,40070,77.0,1578,35.0,668,587,674
83,3/7/2021,417,119572,301,75487,125,43954,37.0,24743,20.0,31334,1.0,1514,119,40189,3.0,1581,2.0,670,22,696
84,3/8/2021,2824,122396,1057,76544,1773,45727,260.0,25003,75.0,31409,49.0,1563,1639,41828,62.0,1643,23.0,693,125,821
85,3/9/2021,3187,125583,1654,78198,1548,47275,264.0,25267,96.0,31505,51.0,1614,1408,43236,64.0,1707,25.0,718,73,894
86,3/10/2021,2381,127964,1366,79564,1019,48294,299.0,25566,83.0,31588,54.0,1668,917,44153,32.0,1739,16.0,734,63,957
87,3/11/2021,4176,132140,2380,81944,1801,50095,400.0,25966,135.0,31723,63.0,1731,1652,45805,67.0,1806,19.0,753,75,1032
88,3/12/2021,3946,136086,2575,84519,1390,51485,197.0,26163,67.0,31790,64.0,1795,1240,47045,53.0,1859,33.0,786,72,1104
89,3/13/2021,213,136299,130,84649,99,51584,20.0,26183,7.0,31797,1.0,1796,92,47137,4.0,1863,2.0,788,30,1134
90,3/14/2021,101,136400,61,84710,39,51623,9.0,26192,0.0,31797,1.0,1797,36,47173,1.0,1864,1.0,789,2,1136
91,3/15/2021,899,137299,362,85072,537,52160,85.0,26277,15.0,31812,19.0,1816,494,47667,17.0,1881,7.0,796,19,1155
92,3/16/2021,3286,140585,2114,87186,1174,53334,227.0,26504,46.0,31858,65.0,1881,1046,48713,41.0,1922,22.0,818,30,1185
93,3/17/2021,2911,143496,1788,88974,1126,54460,238.0,26742,89.0,31947,40.0,1921,1031,49744,35.0,1957,20.0,838,32,1217
94,3/18/2021,4000,147496,2088,91062,1918,56378,337.0,27079,91.0,32038,97.0,2018,1736,51480,64.0,2021,21.0,859,21,1238
95,3/19/2021,3001,150497,1752,92814,1249,57627,221.0,27300,42.0,32080,60.0,2078,1124,52604,46.0,2067,19.0,878,16,1254
96,3/20/2021,3083,153580,1966,94780,1120,58747,313.0,27613,54.0,32134,37.0,2115,1007,53611,55.0,2122,21.0,899,36,1290
97,3/21/2021,661,154241,398,95178,265,59012,26.0,27639,5.0,32139,11.0,2126,236,53847,16.0,2138,2.0,901,18,1308
98,3/22/2021,3110,157351,2244,97422,864,59876,188.0,27827,56.0,32195,19.0,2145,795,54642,37.0,2175,13.0,914,25,1333
99,3/23/2021,4445,161796,3568,100990,1172,61048,194.0,28021,75.0,32270,38.0,2183,1044,55686,51.0,2226,39.0,953,494,1827
100,3/24/2021,3162,164958,2428,103418,747,61795,118.0,28139,37.0,32307,40.0,2223,667,56353,26.0,2252,14.0,967,35,1862
101,3/25/2021,5069,170027,3054,106472,2015,63810,312.0,28451,71.0,32378,68.0,2291,1847,58200,69.0,2321,31.0,998,15,1877
102,3/26/2021,4576,174603,2726,109198,1848,65658,329.0,28780,65.0,32443,118.0,2409,1587,59787,112.0,2433,31.0,1029,30,1907
103,3/27/2021,3342,177945,1915,111113,1423,67081,325.0,29105,21.0,32464,49.0,2458,1308,61095,46.0,2479,20.0,1049,4,1911
104,3/28/2021,1172,179117,811,111924,361,67442,93.0,29198,16.0,32480,12.0,2470,331,61426,16.0,2495,2.0,1051,4,1915
105,3/29/2021,3986,183103,2689,114613,1295,68737,230.0,29428,52.0,32532,39.0,2509,1215,62641,28.0,2523,13.0,1064,8,1923
106,3/30/2021,4371,187474,2755,117368,1643,70380,237.0,29665,74.0,32606,55.0,2564,1502,64143,68.0,2591,18.0,1082,45,1968
107,3/31/2021,3572,191046,2558,119926,1044,71424,165.0,29830,47.0,32653,40.0,2604,934,65077,50.0,2641,20.0,1102,30,1998
108,4/1/2021,5108,196154,3330,123256,1786,73210,147.0,29977,76.0,32729,72.0,2676,1635,66712,60.0,2701,19.0,1121,33,2031
109,4/2/2021,4710,200864,2524,125780,2185,75395,245.0,30222,49.0,32778,82.0,2758,1985,68697,91.0,2792,27.0,1148,27,2058
110,4/3/2021,4257,205121,3527,129307,762,76157,94.0,30316,41.0,32819,36.0,2794,677,69374,29.0,2821,20.0,1168,70,2128
111,4/4/2021,371,205492,257,129564,132,76289,6.0,30322,7.0,32826,3.0,2797,116,69490,11.0,2832,2.0,1170,33,2161
112,4/5/2021,4692,210184,3761,133325,952,77241,75.0,30397,47.0,32873,70.0,2867,814,70304,49.0,2881,19.0,1189,91,2252
113,4/6/2021,5166,215350,3032,136357,2317,79558,85.0,30482,58.0,32931,80.0,2947,2056,72360,126.0,3007,55.0,1244,273,2525
114,4/7/2021,4965,220315,3684,140041,2170,81728,60.0,30542,109.0,33040,118.0,3065,1845,74205,134.0,3141,73.0,1317,1165,3690
115,4/8/2021,6684,226999,4508,144549,2861,84589,137.0,30679,123.0,33163,136.0,3201,2510,76715,141.0,3282,74.0,1391,929,4619
116,4/9/2021,5722,232721,3267,147816,3219,87808,77.0,30756,71.0,33234,163.0,3364,2787,79502,181.0,3463,88.0,1479,814,5433
117,4/10/2021,4435,237156,3167,150983,1743,89551,51.0,30807,71.0,33305,98.0,3462,1473,80975,118.0,3581,54.0,1533,515,5948
118,4/11/2021,1038,238194,795,151778,288,89839,6.0,30813,11.0,33316,12.0,3474,241,81216,24.0,3605,11.0,1544,57,6005
119,4/12/2021,5041,243235,3641,155419,2014,91853,75.0,30888,96.0,33412,77.0,3551,1744,82960,133.0,3738,60.0,1604,509,6514
120,4/13/2021,5036,248271,3564,158983,1485,93338,55.0,30943,77.0,33489,70.0,3621,1295,84255,96.0,3834,24.0,1628,22,6536
121,4/14/2021,2956,251227,1438,160421,1511,94849,86.0,31029,26.0,33515,93.0,3714,1315,85570,70.0,3904,33.0,1661,2,6538
122,4/15/2021,4950,256177,2326,162747,2607,97456,102.0,31131,58.0,33573,217.0,3931,2168,87738,161.0,4065,61.0,1722,3,6541
123,4/16/2021,3909,260086,2077,164824,1818,99274,44.0,31175,34.0,33607,66.0,3997,1591,89329,127.0,4192,34.0,1756,4,6545
124,4/17/2021,4589,264675,2402,167226,2170,101444,39.0,31214,57.0,33664,99.0,4096,1888,91217,132.0,4324,51.0,1807,4,6549
125,4/18/2021,1039,265714,408,167634,624,102068,13.0,31227,11.0,33675,42.0,4138,519,91736,33.0,4357,30.0,1837,4,6553
126,4/19/2021,3862,269576,1411,169045,2426,104494,44.0,31271,40.0,33715,164.0,4302,2043,93779,161.0,4518,58.0,1895,5,6558
127,4/20/2021,4699,274275,1868,170913,2816,107310,47.0,31318,69.0,33784,160.0,4462,2399,96178,193.0,4711,64.0,1959,5,6563
128,4/21/2021,3171,277446,711,171624,2449,109759,35.0,31353,31.0,33815,145.0,4607,2060,98238,165.0,4876,79.0,2038,5,6568
129,4/22/2021,4656,282102,1770,173394,2874,112633,46.0,31399,62.0,33877,143.0,4750,2464,100702,193.0,5069,74.0,2112,2,6570
130,4/23/2021,3586,285688,1176,174570,2394,115027,41.0,31440,30.0,33907,73.0,4823,2110,102812,128.0,5197,83.0,2195,5,6575
131,4/24/2021,3358,289046,1118,175688,2235,117262,14.0,31454,20.0,33927,104.0,4927,1894,104706,196.0,5393,41.0,2236,5,6580
132,4/25/2021,794,289840,343,176031,450,117712,6.0,31460,6.0,33933,105.0,5032,267,104973,38.0,5431,40.0,2276,1,6581
133,4/26/2021,4359,294199,1113,177144,3237,120949,35.0,31495,31.0,33964,147.0,5179,2784,107757,214.0,5645,92.0,2368,4,6585
134,4/27/2021,3348,297547,1194,178338,2147,123096,36.0,31531,37.0,34001,79.0,5258,1891,109648,134.0,5779,43.0,2411,10,6595
135,4/28/2021,2987,300534,717,179055,2270,125366,45.0,31576,20.0,34021,167.0,5425,1842,111490,196.0,5975,65.0,2476,14,6609
136,4/29/2021,3965,304499,820,179875,3139,128505,67.0,31643,33.0,34054,227.0,5652,2579,114069,225.0,6200,108.0,2584,8,6617
137,4/30/2021,2872,307371,641,180516,2230,130735,44.0,31687,24.0,34078,74.0,5726,1894,115963,199.0,6399,63.0,2647,11,6628
138,5/1/2021,3648,311019,818,181334,2812,133547,35.0,31722,18.0,34096,283.0,6009,2189,118152,200.0,6599,140.0,2787,16,6644
139,5/2/2021,527,311546,232,181566,306,133853,7.0,31729,2.0,34098,12.0,6021,246,118398,38.0,6637,10.0,2797,10,6654
140,5/3/2021,3427,314973,637,182203,2789,136642,47.0,31776,34.0,34132,107.0,6128,2392,120790,213.0,6850,77.0,2874,12,6666
141,5/4/2021,4348,319321,699,182902,3667,140309,67.0,31843,27.0,34159,148.0,6276,3149,123939,259.0,7109,111.0,2985,30,6696
142,5/5/2021,2231,321552,477,183379,1789,142098,63.0,31906,24.0,34183,86.0,6362,1481,125420,142.0,7251,80.0,3065,14,6710
143,5/6/2021,3690,325242,821,184200,2987,145085,100.0,32006,40.0,34223,179.0,6541,2476,127896,196.0,7447,136.0,3201,45,6755
144,5/7/2021,2941,328183,542,184742,2489,147574,44.0,32050,11.0,34234,135.0,6676,2046,129942,211.0,7658,97.0,3298,39,6794
145,5/8/2021,2987,331170,553,185295,2538,150112,45.0,32095,16.0,34250,167.0,6843,2046,131988,195.0,7853,130.0,3428,47,6841
146,5/9/2021,367,331537,141,185436,239,150351,4.0,32099,2.0,34252,10.0,6853,199,132187,20.0,7873,10.0,3438,3,6844
147,5/10/2021,2427,333964,381,185817,2080,152431,60.0,32159,16.0,34268,87.0,6940,1690,133877,205.0,8078,98.0,3536,25,6869
148,5/11/2021,2719,336683,543,186360,2217,154648,91.0,32250,24.0,34292,189.0,7129,1728,135605,203.0,8281,97.0,3633,17,6886
149,5/12/2021,1229,337912,459,186819,822,155470,23.0,32273,14.0,34306,49.0,7178,652,136257,86.0,8367,35.0,3668,23,6909
150,5/13/2021,3251,341163,1034,187853,2232,157702,82.0,32355,25.0,34331,151.0,7329,1820,138077,156.0,8523,105.0,3773,16,6925
151,5/14/2021,2472,343635,1281,189134,1288,158990,51.0,32406,30.0,34361,64.0,7393,1071,139148,100.0,8623,53.0,3826,35,6960
152,5/15/2021,3022,346657,1512,190646,1592,160582,40.0,32446,15.0,34376,115.0,7508,1264,140412,139.0,8762,74.0,3900,28,6988
153,5/16/2021,944,347601,572,191218,405,160987,8.0,32454,8.0,34384,83.0,7591,252,140664,30.0,8792,40.0,3940,10,6998
154,5/17/2021,2447,350048,1213,192431,1307,162294,38.0,32492,27.0,34411,48.0,7639,1098,141762,102.0,8894,59.0,3999,20,7018
155,5/18/2021,2587,352635,1177,193608,1443,163737,44.0,32536,22.0,34433,72.0,7711,1213,142975,84.0,8978,74.0,4073,19,7037
156,5/19/2021,1875,354510,1152,194760,786,164523,24.0,32560,19.0,34452,42.0,7753,636,143611,69.0,9047,39.0,4112,17,7054
157,5/20/2021,1979,356489,923,195683,1097,165620,45.0,32605,27.0,34479,94.0,7847,873,144484,81.0,9128,49.0,4161,18,7072
158,5/21/2021,1626,358115,923,196606,780,166400,18.0,32623,16.0,34495,43.0,7890,620,145104,60.0,9188,57.0,4218,29,7101
159,5/22/2021,1690,359805,796,197402,924,167324,9.0,32632,13.0,34508,123.0,8013,641,145745,74.0,9262,86.0,4304,16,7117
160,5/23/2021,680,360485,342,197744,368,167692,2.0,32634,5.0,34513,68.0,8081,227,145972,18.0,9280,55.0,4359,3,7120
161,5/24/2021,1338,361823,539,198283,851,168543,36.0,32670,20.0,34533,43.0,8124,685,146657,82.0,9362,41.0,4400,19,7139
162,5/25/2021,1233,363056,509,198792,755,169298,22.0,32692,20.0,34553,57.0,8181,568,147225,65.0,9427,65.0,4465,19,7158
163,5/26/2021,965,364021,553,199345,525,169823,17.0,32709,25.0,34578,38.0,8219,415,147640,44.0,9471,28.0,4493,25,7183
164,5/27/2021,1273,365294,659,200004,678,170501,32.0,32741,19.0,34597,54.0,8273,548,148188,49.0,9520,27.0,4520,20,7203
165,5/28/2021,1033,366327,597,200601,481,170982,18.0,32759,22.0,34619,30.0,8303,374,148562,50.0,9570,27.0,4547,16,7219
166,5/29/2021,1015,367342,492,201093,560,171542,18.0,32777,8.0,34627,32.0,8335,441,149003,42.0,9612,45.0,4592,12,7231
167,5/30/2021,332,367674,220,201313,143,171685,5.0,32782,3.0,34630,12.0,8347,104,149107,17.0,9629,10.0,4602,10,7241
168,5/31/2021,339,368013,192,201505,174,171859,8.0,32790,6.0,34636,8.0,8355,140,149247,13.0,9642,13.0,4615,10,7251
169,6/1/2021,972,368985,400,201905,603,172462,26.0,32816,17.0,34653,49.0,8404,461,149708,46.0,9688,47.0,4662,24,7275
170,6/2/2021,719,369704,369,202274,406,172868,16.0,32832,8.0,34661,34.0,8438,321,150029,23.0,9711,28.0,4690,8,7283
171,6/3/2021,1308,371012,521,202795,835,173703,22.0,32854,12.0,34673,48.0,8486,688,150717,58.0,9769,41.0,4731,15,7298
172,6/4/2021,1503,372515,402,203197,1142,174845,16.0,32870,9.0,34682,71.0,8557,954,151671,70.0,9839,47.0,4778,4,7302
173,6/5/2021,1414,373929,358,203555,1083,175928,12.0,32882,6.0,34688,64.0,8621,887,152558,92.0,9931,40.0,4818,9,7311
174,6/6/2021,529,374458,141,203696,397,176325,5.0,32887,3.0,34691,43.0,8664,317,152875,25.0,9956,12.0,4830,10,7321
175,6/7/2021,1195,375653,335,204031,903,177228,14.0,32901,12.0,34703,68.0,8732,720,153595,83.0,10039,32.0,4862,19,7340
176,6/8/2021,1088,376741,253,204284,859,178087,18.0,32919,5.0,34708,57.0,8789,698,154293,70.0,10109,34.0,4896,4,7344
177,6/9/2021,1079,377820,283,204567,842,178929,15.0,32934,12.0,34720,78.0,8867,645,154938,72.0,10181,47.0,4943,12,7356
178,6/10/2021,1312,379132,336,204903,1013,179942,20.0,32954,4.0,34724,93.0,8960,799,155737,67.0,10248,54.0,4997,10,7366
179,6/11/2021,1113,380245,324,205227,831,180773,19.0,32973,13.0,34737,57.0,9017,652,156389,78.0,10326,44.0,5041,9,7375
180,6/12/2021,1048,381293,290,205517,800,181573,15.0,32988,9.0,34746,73.0,9090,620,157009,64.0,10390,43.0,5084,9,7384
181,6/13/2021,371,381664,98,205615,284,181857,4.0,32992,1.0,34747,37.0,9127,203,157212,25.0,10415,19.0,5103,6,7390
182,6/14/2021,830,382494,282,205897,592,182449,15.0,33007,4.0,34751,44.0,9171,449,157661,42.0,10457,57.0,5160,6,7396
183,6/15/2021,694,383188,237,206134,478,182927,20.0,33027,10.0,34761,40.0,9211,388,158049,34.0,10491,16.0,5176,2,7398
184,6/16/2021,626,383814,204,206338,448,183375,12.0,33039,4.0,34765,38.0,9249,341,158390,34.0,10525,35.0,5211,9,7407
185,6/17/2021,694,384508,250,206588,468,183843,13.0,33052,10.0,34775,41.0,9290,349,158739,49.0,10574,29.0,5240,4,7411
186,6/18/2021,1038,385546,380,206968,687,184530,23.0,33075,11.0,34786,52.0,9342,555,159294,51.0,10625,29.0,5269,8,7419
187,6/19/2021,635,386181,154,207122,496,185026,10.0,33085,6.0,34792,51.0,9393,365,159659,54.0,10679,26.0,5295,9,7428
188,6/20/2021,300,386481,114,207236,192,185218,3.0,33088,2.0,34794,36.0,9429,119,159778,15.0,10694,22.0,5317,5,7433
189,6/21/2021,516,386997,215,207451,327,185545,5.0,33093,8.0,34802,28.0,9457,243,160021,35.0,10729,21.0,5338,8,7441
190,6/22/2021,612,387609,250,207701,392,185937,12.0,33105,7.0,34809,31.0,9488,308,160329,25.0,10754,28.0,5366,5,7446
191,6/23/2021,511,388120,186,207887,353,186290,7.0,33112,10.0,34819,38.0,9526,256,160585,37.0,10791,22.0,5388,11,7457
192,6/24/2021,520,388640,211,208098,333,186623,12.0,33124,9.0,34828,30.0,9556,259,160844,23.0,10814,21.0,5409,1,7458
193,6/25/2021,690,389330,275,208373,437,187060,12.0,33136,8.0,34836,42.0,9598,325,161169,42.0,10856,28.0,5437,5,7463
194,6/26/2021,597,389927,166,208539,440,187500,9.0,33145,9.0,34845,77.0,9675,289,161458,43.0,10899,31.0,5468,4,7467
195,6/27/2021,183,390110,71,208610,113,187613,2.0,33147,3.0,34848,9.0,9684,82,161540,12.0,10911,10.0,5478,2,7469
196,6/28/2021,487,390597,209,208819,285,187898,7.0,33154,6.0,34854,39.0,9723,206,161746,24.0,10935,16.0,5494,2,7471
197,6/29/2021,560,391157,251,209070,330,188228,16.0,33170,11.0,34865,42.0,9765,239,161985,23.0,10958,26.0,5520,11,7482
198,6/30/2021,413,391570,206,209276,221,188449,8.0,33178,11.0,34876,19.0,9784,166,162151,16.0,10974,20.0,5540,12,7494
199,7/1/2021,488,392058,210,209486,296,188745,8.0,33186,7.0,34883,21.0,9805,222,162373,33.0,11007,20.0,5560,4,7498
200,7/2/2021,569,392627,273,209759,307,189052,5.0,33191,7.0,34890,27.0,9832,240,162613,24.0,11031,16.0,5576,3,7501
201,7/3/2021,307,392934,120,209879,194,189246,4.0,33195,3.0,34893,29.0,9861,126,162739,20.0,11051,19.0,5595,5,7506
202,7/4/2021,53,392987,18,209897,35,189281,1.0,33196,0.0,34893,4.0,9865,22,162761,1.0,11052,8.0,5603,0,7506
203,7/5/2021,316,393303,139,210036,175,189456,3.0,33199,1.0,34894,18.0,9883,121,162882,26.0,11078,10.0,5613,4,7510
204,7/6/2021,453,393756,190,210226,272,189728,4.0,33203,5.0,34899,45.0,9928,193,163075,19.0,11097,15.0,5628,1,7511
205,7/7/2021,372,394128,210,210436,176,189904,7.0,33210,6.0,34905,19.0,9947,130,163205,12.0,11109,15.0,5643,4,7515
206,7/8/2021,424,394552,198,210634,247,190151,10.0,33220,8.0,34913,23.0,9970,177,163382,23.0,11132,24.0,5667,3,7518
207,7/9/2021,482,395034,195,210829,293,190444,9.0,33229,2.0,34915,36.0,10006,215,163597,24.0,11156,18.0,5685,6,7524
208,7/10/2021,259,395293,147,210976,127,190571,5.0,33234,2.0,34917,5.0,10011,105,163702,10.0,11166,7.0,5692,2,7526
209,7/11/2021,223,395516,119,211095,122,190693,6.0,33240,6.0,34923,11.0,10022,88,163790,10.0,11176,13.0,5705,7,7533
210,7/12/2021,385,395901,202,211297,196,190889,7.0,33247,4.0,34927,25.0,10047,130,163920,24.0,11200,17.0,5722,4,7537
211,7/13/2021,436,396337,225,211522,224,191113,16.0,33263,10.0,34937,26.0,10073,175,164095,12.0,11212,11.0,5733,4,7541
212,7/14/2021,283,396620,150,211672,154,191267,8.0,33271,5.0,34942,20.0,10093,110,164205,9.0,11221,15.0,5748,8,7549
213,7/15/2021,362,396982,189,211861,184,191451,1.0,33272,4.0,34946,15.0,10108,139,164344,13.0,11234,17.0,5765,3,7552
214,7/16/2021,510,397492,243,212104,277,191728,8.0,33280,9.0,34955,25.0,10133,210,164554,22.0,11256,20.0,5785,5,7557
215,7/17/2021,277,397769,159,212263,128,191856,11.0,33291,5.0,34960,11.0,10144,97,164651,9.0,11265,11.0,5796,6,7563
216,7/18/2021,195,397964,118,212381,89,191945,4.0,33295,3.0,34963,13.0,10157,63,164714,6.0,11271,7.0,5803,4,7567
217,7/19/2021,406,398370,206,212587,206,192151,8.0,33303,8.0,34971,26.0,10183,150,164864,17.0,11288,13.0,5816,4,7571
218,7/20/2021,416,398786,210,212797,214,192365,6.0,33309,8.0,34979,12.0,10195,165,165029,23.0,11311,14.0,5830,5,7576
219,7/21/2021,335,399121,183,212980,172,192537,13.0,33322,14.0,34993,12.0,10207,129,165158,14.0,11325,17.0,5847,3,7579
220,7/22/2021,394,399515,232,213212,169,192706,6.0,33328,18.0,35011,19.0,10226,124,165282,18.0,11343,8.0,5855,6,7585
221,7/23/2021,552,400067,318,213530,237,192943,6.0,33334,10.0,35021,37.0,10263,161,165443,20.0,11363,19.0,5874,3,7588
222,7/24/2021,351,400418,214,213744,156,193099,8.0,33342,10.0,35031,19.0,10282,114,165557,9.0,11372,14.0,5888,5,7593
223,7/25/2021,199,400617,145,213889,62,193161,0.0,33342,4.0,35035,7.0,10289,44,165601,5.0,11377,6.0,5894,4,7597
224,7/26/2021,347,400964,200,214089,144,193305,1.0,33343,7.0,35042,11.0,10300,98,165699,18.0,11395,17.0,5911,4,7601
225,7/27/2021,424,401388,238,214327,174,193479,5.0,33348,16.0,35058,21.0,10321,122,165821,18.0,11413,13.0,5924,15,7616
226,7/28/2021,467,401855,283,214610,222,193701,3.0,33351,10.0,35068,28.0,10349,144,165965,17.0,11430,33.0,5957,5,7621
227,7/29/2021,510,402365,306,214916,233,193934,8.0,33359,6.0,35074,24.0,10373,177,166142,14.0,11444,18.0,5975,9,7630
228,7/30/2021,685,403050,476,215392,247,194181,10.0,33369,14.0,35088,25.0,10398,187,166329,16.0,11460,19.0,5994,5,7635
229,7/31/2021,334,403384,202,215594,136,194317,4.0,33373,1.0,35089,15.0,10413,107,166436,9.0,11469,5.0,5999,5,7640
230,8/1/2021,267,403651,170,215764,105,194422,0.0,33373,2.0,35091,15.0,10428,66,166502,8.0,11477,16.0,6015,8,7648
231,8/2/2021,446,404097,297,216061,173,194595,4.0,33377,13.0,35104,21.0,10449,119,166621,20.0,11497,13.0,6028,6,7654
232,8/3/2021,560,404657,346,216407,239,194834,6.0,33383,13.0,35117,37.0,10486,161,166782,15.0,11512,26.0,6054,4,7658
233,8/4/2021,391,405048,273,216680,139,194973,3.0,33386,14.0,35131,10.0,10496,106,166888,5.0,11517,18.0,6072,10,7668
234,8/5/2021,444,405492,287,216967,168,195141,5.0,33391,11.0,35142,19.0,10515,122,167010,16.0,11533,11.0,6083,4,7672
235,8/6/2021,680,406172,461,217428,265,195406,12.0,33403,16.0,35158,22.0,10537,201,167211,22.0,11555,20.0,6103,4,7676
236,8/7/2021,440,406612,306,217734,157,195563,4.0,33407,10.0,35168,12.0,10549,124,167335,5.0,11560,16.0,6119,5,7681
237,8/8/2021,217,406829,126,217860,98,195661,3.0,33410,5.0,35173,8.0,10557,71,167406,7.0,11567,12.0,6131,5,7686
238,8/9/2021,464,407293,280,218140,214,195875,4.0,33414,6.0,35179,22.0,10579,159,167565,11.0,11578,22.0,6153,8,7694
239,8/10/2021,505,407798,301,218441,229,196104,6.0,33420,14.0,35193,25.0,10604,180,167745,11.0,11589,13.0,6166,8,7702
240,8/11/2021,417,408215,264,218705,175,196279,11.0,33431,5.0,35198,16.0,10620,133,167878,14.0,11603,12.0,6178,2,7704
241,8/12/2021,543,408758,321,219026,259,196538,7.0,33438,13.0,35211,31.0,10651,182,168060,23.0,11626,23.0,6201,7,7711
242,8/13/2021,657,409415,378,219404,298,196836,11.0,33449,9.0,35220,31.0,10682,217,168277,19.0,11645,31.0,6232,5,7716
243,8/14/2021,503,409918,257,219661,249,197085,7.0,33456,9.0,35229,11.0,10693,212,168489,9.0,11654,17.0,6249,45,7761
244,8/15/2021,264,410182,128,219789,125,197210,2.0,33458,3.0,35232,11.0,10704,91,168580,6.0,11660,17.0,6266,17,7778
245,8/16/2021,539,410721,311,220100,169,197379,5.0,33463,11.0,35243,15.0,10719,129,168709,13.0,11673,12.0,6278,72,7850
246,8/17/2021,483,411204,228,220328,194,197573,19.0,33482,10.0,35253,17.0,10736,146,168855,10.0,11683,21.0,6299,71,7921
247,8/18/2021,592,411796,323,220651,256,197829,5.0,33487,15.0,35268,30.0,10766,173,169028,13.0,11696,40.0,6339,68,7989
248,8/19/2021,566,412362,278,220929,256,198085,7.0,33494,9.0,35277,21.0,10787,206,169234,17.0,11713,12.0,6351,70,8059
249,8/20/2021,843,413205,340,221269,453,198538,15.0,33509,11.0,35288,44.0,10831,360,169594,29.0,11742,20.0,6371,82,8141
250,8/21/2021,646,413851,210,221479,209,198747,4.0,33513,7.0,35295,14.0,10845,171,169765,13.0,11755,11.0,6382,187,8328
251,8/22/2021,317,414168,151,221630,142,198889,1.0,33514,2.0,35297,19.0,10864,100,169865,9.0,11764,14.0,6396,31,8359
252,8/23/2021,527,414695,262,221892,221,199110,10.0,33524,9.0,35306,19.0,10883,167,170032,12.0,11776,23.0,6419,60,8419
253,8/24/2021,569,415264,272,222164,276,199386,10.0,33534,8.0,35314,27.0,10910,216,170248,15.0,11791,18.0,6437,53,8472
254,8/25/2021,592,415856,319,222483,256,199642,12.0,33546,13.0,35327,19.0,10929,195,170443,9.0,11800,33.0,6470,48,8520
255,8/26/2021,531,416387,259,222742,251,199893,9.0,33555,14.0,35341,18.0,10947,193,170636,23.0,11823,17.0,6487,42,8562
256,8/27/2021,889,417276,351,223093,405,200298,15.0,33570,11.0,35352,38.0,10985,299,170935,23.0,11846,45.0,6532,145,8707
257,8/28/2021,1466,418742,202,223295,250,200548,7.0,33577,5.0,35357,23.0,11008,185,171120,14.0,11860,28.0,6560,976,9683
258,8/29/2021,1080,419822,160,223455,136,200684,4.0,33581,4.0,35361,8.0,11016,111,171231,12.0,11872,5.0,6565,770,10453
259,8/30/2021,615,420437,271,223726,280,200964,9.0,33590,13.0,35374,24.0,11040,215,171446,9.0,11881,32.0,6597,89,10542
260,8/31/2021,810,421247,234,223960,237,201201,7.0,33597,12.0,35386,18.0,11058,188,171634,18.0,11899,13.0,6610,338,10880
261,9/1/2021,950,422197,248,224208,222,201423,12.0,33609,15.0,35401,21.0,11079,169,171803,13.0,11912,19.0,6629,481,11361
262,9/2/2021,829,423026,184,224392,205,201628,13.0,33622,14.0,35415,19.0,11098,153,171956,16.0,11928,17.0,6646,457,11818
263,9/3/2021,853,423879,340,224732,370,201998,13.0,33635,12.0,35427,43.0,11141,271,172227,21.0,11949,35.0,6681,161,11979
264,9/4/2021,375,424254,163,224895,164,202162,6.0,33641,8.0,35435,13.0,11154,127,172354,11.0,11960,13.0,6694,57,12036
265,9/5/2021,251,424505,131,225026,108,202270,2.0,33643,4.0,35439,12.0,11166,77,172431,9.0,11969,10.0,6704,21,12057
266,9/6/2021,112,424617,46,225072,59,202329,1.0,33644,0.0,35439,4.0,11170,43,172474,8.0,11977,4.0,6708,11,12068
267,9/7/2021,952,425569,199,225271,272,202601,19.0,33663,12.0,35451,22.0,11192,208,172682,17.0,11994,25.0,6733,482,12550
268,9/8/2021,789,426358,219,225490,225,202826,11.0,33674,12.0,35463,24.0,11216,167,172849,10.0,12004,24.0,6757,365,12915
269,9/9/2021,401,426759,175,225665,193,203019,9.0,33683,8.0,35471,21.0,11237,141,172990,14.0,12018,17.0,6774,54,12969
270,9/10/2021,752,427511,339,226004,306,203325,9.0,33692,23.0,35494,28.0,11265,230,173220,20.0,12038,28.0,6802,145,13114
271,9/11/2021,1634,429145,162,226166,211,203536,10.0,33702,19.0,35513,18.0,11283,161,173381,15.0,12053,17.0,6819,1261,14375
272,9/12/2021,233,429378,101,226267,114,203650,1.0,33703,2.0,35515,11.0,11294,74,173455,10.0,12063,19.0,6838,16,14391
273,9/13/2021,493,429871,220,226487,245,203895,9.0,33712,8.0,35523,24.0,11318,184,173639,12.0,12075,25.0,6863,44,14435
274,9/14/2021,844,430715,203,226690,273,204168,13.0,33725,15.0,35538,17.0,11335,219,173858,14.0,12089,23.0,6886,397,14832
275,9/15/2021,830,431545,191,226881,266,204434,15.0,33740,15.0,35553,21.0,11356,196,174054,17.0,12106,32.0,6918,396,15228
276,9/16/2021,353,431898,134,227015,191,204625,9.0,33749,8.0,35561,32.0,11388,136,174190,11.0,12117,12.0,6930,42,15270
277,9/17/2021,747,432645,284,227299,387,205012,13.0,33762,13.0,35574,29.0,11417,289,174479,38.0,12155,31.0,6961,123,15393
278,9/18/2021,1840,434485,129,227428,173,205185,6.0,33768,20.0,35594,10.0,11427,127,174606,16.0,12171,20.0,6981,1537,16930
279,9/19/2021,181,434666,74,227502,105,205290,3.0,33771,2.0,35596,7.0,11434,80,174686,5.0,12176,13.0,6994,10,16940
280,9/20/2021,384,435050,143,227645,216,205506,8.0,33779,9.0,35605,27.0,11461,160,174846,10.0,12186,19.0,7013,55,16995
281,9/21/2021,771,435821,166,227811,199,205705,9.0,33788,14.0,35619,21.0,11482,153,174999,8.0,12194,17.0,7030,419,17414
282,9/22/2021,718,436539,164,227975,229,205934,6.0,33794,12.0,35631,15.0,11497,181,175180,16.0,12210,17.0,7047,361,17775
283,9/23/2021,347,436886,143,228118,178,206112,8.0,33802,3.0,35634,9.0,11506,131,175311,13.0,12223,25.0,7072,47,17822
284,9/24/2021,695,437581,207,228325,275,206387,16.0,33818,16.0,35650,20.0,11526,218,175529,11.0,12234,26.0,7098,231,18053
285,9/25/2021,1733,439314,135,228460,176,206563,11.0,33829,21.0,35671,15.0,11541,137,175666,12.0,12246,12.0,7110,1427,19480
286,9/26/2021,264,439578,66,228526,87,206650,3.0,33832,3.0,35674,11.0,11552,65,175731,4.0,12250,7.0,7117,110,19590
287,9/27/2021,566,440144,156,228682,123,206773,7.0,33839,11.0,35685,7.0,11559,96,175827,7.0,12257,13.0,7130,303,19893
288,9/28/2021,1130,441274,157,228839,202,206975,19.0,33858,23.0,35708,15.0,11574,153,175980,9.0,12266,25.0,7155,792,20685
289,9/29/2021,1139,442413,174,229013,170,207145,12.0,33870,19.0,35727,15.0,11589,127,176107,7.0,12273,21.0,7176,807,21492
290,9/30/2021,706,443119,162,229175,166,207311,15.0,33885,7.0,35734,11.0,11600,127,176234,10.0,12283,18.0,7194,408,21900
291,10/1/2021,1066,444185,176,229351,301,207612,20.0,33905,15.0,35749,20.0,11620,238,176472,21.0,12304,22.0,7216,602,22502
292,10/2/2021,1815,446000,118,229469,115,207727,12.0,33917,14.0,35763,9.0,11629,96,176568,5.0,12309,5.0,7221,1588,24090
293,10/3/2021,392,446392,64,229533,113,207840,1.0,33918,2.0,35765,18.0,11647,77,176645,7.0,12316,11.0,7232,227,24317
294,10/4/2021,795,447187,113,229646,156,207996,7.0,33925,12.0,35777,27.0,11674,102,176747,14.0,12330,13.0,7245,533,24850
295,10/5/2021,1122,448309,139,229785,135,208131,12.0,33937,17.0,35794,13.0,11687,103,176850,5.0,12335,14.0,7259,859,25709
296,10/6/2021,998,449307,107,229892,155,208286,8.0,33945,14.0,35808,11.0,11698,122,176972,5.0,12340,17.0,7276,753,26462
297,10/7/2021,785,450092,133,230025,107,208393,8.0,33953,14.0,35822,8.0,11706,83,177055,5.0,12345,11.0,7287,565,27027
298,10/8/2021,1037,451129,157,230182,239,208632,19.0,33972,11.0,35833,20.0,11726,186,177241,11.0,12356,22.0,7309,652,27679
299,10/9/2021,1677,452806,108,230290,132,208764,11.0,33983,8.0,35841,22.0,11748,98,177339,4.0,12360,8.0,7317,1437,29116
300,10/10/2021,243,453049,50,230340,63,208827,2.0,33985,2.0,35843,4.0,11752,49,177388,5.0,12365,5.0,7322,131,29247
301,10/11/2021,821,453870,122,230462,135,208962,17.0,34002,18.0,35861,3.0,11755,111,177499,10.0,12375,11.0,7333,575,29822
302,10/12/2021,1024,454894,117,230579,133,209095,8.0,34010,19.0,35880,16.0,11771,104,177603,4.0,12379,9.0,7342,784,30606
303,10/13/2021,972,455866,117,230696,151,209246,17.0,34027,9.0,35889,16.0,11787,114,177717,12.0,12391,9.0,7351,723,31329
304,10/14/2021,711,456577,100,230796,127,209373,14.0,34041,9.0,35898,20.0,11807,94,177811,8.0,12399,5.0,7356,491,31820
305,10/15/2021,1028,457605,177,230973,215,209588,11.0,34052,7.0,35905,15.0,11822,169,177980,13.0,12412,18.0,7374,671,32491
306,10/16/2021,802,458407,66,231039,80,209668,4.0,34056,3.0,35908,6.0,11828,69,178049,2.0,12414,3.0,7377,656,33147
307,10/17/2021,196,458603,48,231087,63,209731,1.0,34057,2.0,35910,4.0,11832,47,178096,3.0,12417,9.0,7386,83,33230
308,10/18/2021,650,459253,118,231205,134,209865,10.0,34067,4.0,35914,13.0,11845,105,178201,6.0,12423,10.0,7396,413,33643
309,10/19/2021,1048,460301,120,231325,134,209999,4.0,34071,11.0,35925,8.0,11853,108,178309,8.0,12431,10.0,7406,804,34447
310,10/20/2021,891,461192,121,231446,119,210118,6.0,34077,12.0,35937,8.0,11861,90,178399,7.0,12438,14.0,7420,664,35111
311,10/21/2021,534,461726,107,231553,127,210245,9.0,34086,8.0,35945,14.0,11875,85,178484,11.0,12449,17.0,7437,321,35432
312,10/22/2021,1474,463200,195,231748,229,210474,9.0,34095,13.0,35958,20.0,11895,170,178654,14.0,12463,25.0,7462,1070,36502
313,10/23/2021,1879,465079,88,231836,195,210669,14.0,34109,15.0,35973,4.0,11899,170,178824,11.0,12474,10.0,7472,1599,38101
314,10/24/2021,571,465650,81,231917,151,210820,8.0,34117,11.0,35984,12.0,11911,127,178951,7.0,12481,5.0,7477,351,38452
315,10/25/2021,1386,467036,136,232053,297,211117,27.0,34144,17.0,36001,12.0,11923,252,179203,21.0,12502,12.0,7489,965,39417
316,10/26/2021,2144,469180,177,232230,300,211417,15.0,34159,17.0,36018,19.0,11942,249,179452,18.0,12520,14.0,7503,1677,41094
317,10/27/2021,1972,471152,153,232383,274,211691,19.0,34178,19.0,36037,9.0,11951,242,179694,14.0,12534,9.0,7512,1552,42646
318,10/28/2021,1713,472865,138,232521,260,211951,11.0,34189,20.0,36057,11.0,11962,219,179913,17.0,12551,13.0,7525,1326,43972
319,10/29/2021,1661,474526,178,232699,279,212230,12.0,34201,15.0,36072,10.0,11972,244,180157,12.0,12563,13.0,7538,1215,45187
320,10/30/2021,1588,476114,78,232777,150,212380,13.0,34214,8.0,36080,6.0,11978,129,180286,9.0,12572,6.0,7544,1369,46556
321,10/31/2021,461,476575,48,232825,74,212454,2.0,34216,6.0,36086,6.0,11984,62,180348,4.0,12576,2.0,7546,337,46893
322,11/1/2021,1244,477819,138,232963,215,212669,10.0,34226,10.0,36096,8.0,11992,177,180525,12.0,12588,18.0,7564,897,47790
323,11/2/2021,1822,479641,129,233092,201,212870,8.0,34234,17.0,36113,14.0,12006,162,180687,14.0,12602,11.0,7575,1507,49297
324,11/3/2021,1742,481383,159,233251,229,213099,12.0,34246,17.0,36130,15.0,12021,181,180868,16.0,12618,17.0,7592,1369,50666
325,11/4/2021,1409,482792,144,233395,183,213282,4.0,34250,13.0,36143,1.0,12022,159,181027,12.0,12630,11.0,7603,1106,51772
326,11/5/2021,2016,484808,226,233621,299,213581,14.0,34264,12.0,36155,18.0,12040,251,181278,14.0,12644,16.0,7619,1523,53295
327,11/6/2021,1578,486386,215,233836,142,213723,4.0,34268,7.0,36162,6.0,12046,115,181393,15.0,12659,6.0,7625,1229,54524
328,11/7/2021,527,486913,121,233957,77,213800,1.0,34269,8.0,36170,5.0,12051,63,181456,3.0,12662,6.0,7631,329,54853
329,11/8/2021,1524,488437,385,234342,198,213998,7.0,34276,9.0,36179,11.0,12062,164,181620,9.0,12671,14.0,7645,962,55815
330,11/9/2021,2630,491067,942,235284,221,214219,10.0,34286,21.0,36200,15.0,12077,163,181783,16.0,12687,27.0,7672,1487,57302
331,11/10/2021,2485,493552,822,236106,223,214442,11.0,34297,17.0,36217,12.0,12089,176,181959,22.0,12709,13.0,7685,1464,58766
332,11/11/2021,2348,495900,964,237070,187,214629,17.0,34314,8.0,36225,13.0,12102,153,182112,13.0,12722,8.0,7693,1216,59982
333,11/12/2021,2555,498455,756,237826,240,214869,12.0,34326,19.0,36244,23.0,12125,191,182303,13.0,12735,13.0,7706,1570,61552
334,11/13/2021,1926,500381,405,238231,140,215009,4.0,34330,12.0,36256,7.0,12132,104,182407,15.0,12750,14.0,7720,1391,62943
335,11/14/2021,1482,501863,910,239141,107,215116,1.0,34331,2.0,36258,11.0,12143,72,182479,14.0,12764,10.0,7730,474,63417
336,11/15/2021,1955,503818,452,239593,200,215316,7.0,34338,11.0,36269,12.0,12155,160,182639,12.0,12776,16.0,7746,1324,64741
337,11/16/2021,2397,506215,454,240047,211,215527,5.0,34343,21.0,36290,26.0,12181,154,182793,17.0,12793,14.0,7760,1744,66485
338,11/17/2021,2724,508939,634,240681,268,215795,12.0,34355,16.0,36306,16.0,12197,221,183014,17.0,12810,14.0,7774,1853,68338
339,11/18/2021,1888,510827,377,241058,177,215972,7.0,34362,10.0,36316,15.0,12212,142,183156,15.0,12825,5.0,7779,1349,69687
340,11/19/2021,2562,513389,716,241774,280,216252,13.0,34375,14.0,36330,9.0,12221,234,183390,20.0,12845,17.0,7796,1586,71273
341,11/20/2021,1877,515266,533,242307,112,216364,6.0,34381,5.0,36335,8.0,12229,95,183485,4.0,12849,5.0,7801,1235,72508
342,11/21/2021,638,515904,123,242430,85,216449,0.0,34381,1.0,36336,3.0,12232,69,183554,8.0,12857,5.0,7806,433,72941
343,11/22/2021,1972,517876,426,242856,207,216656,11.0,34392,21.0,36357,10.0,12242,168,183722,11.0,12868,18.0,7824,1359,74300
344,11/23/2021,1837,519713,288,243144,185,216841,8.0,34400,15.0,36372,15.0,12257,149,183871,14.0,12882,7.0,7831,1372,75672
345,11/24/2021,1509,521222,215,243359,163,217004,6.0,34406,11.0,36383,14.0,12271,131,184002,12.0,12894,6.0,7837,1145,76817
346,11/25/2021,46,521268,9,243368,2,217006,0.0,34406,0.0,36383,0.0,12271,1,184003,1.0,12895,,7837,35,76852
347,11/26/2021,1256,522524,191,243559,202,217208,3.0,34409,4.0,36387,17.0,12288,163,184166,12.0,12907,10.0,7847,882,77734
348,11/27/2021,950,523474,136,243695,153,217361,2.0,34411,2.0,36389,8.0,12296,130,184296,8.0,12915,7.0,7854,663,78397
349,11/28/2021,538,524012,95,243790,105,217466,2.0,34413,2.0,36391,9.0,12305,84,184380,5.0,12920,7.0,7861,344,78741
350,11/29/2021,1844,525856,273,244063,409,217875,8.0,34421,13.0,36404,29.0,12334,340,184720,25.0,12945,15.0,7876,1183,79924
351,11/30/2021,2661,528517,337,244400,790,218665,8.0,34429,11.0,36415,51.0,12385,666,185386,61.0,13006,12.0,7888,1554,81478
352,12/1/2021,2432,530949,264,244664,745,219410,13.0,34442,11.0,36426,30.0,12415,655,186041,56.0,13062,4.0,7892,1434,82912
353,12/2/2021,2810,533759,351,245015,912,220322,9.0,34451,15.0,36441,69.0,12484,741,186782,73.0,13135,29.0,7921,1574,84486
354,12/3/2021,2590,536349,285,245300,756,221078,11.0,34462,4.0,36445,61.0,12545,597,187379,70.0,13205,28.0,7949,1569,86055
355,12/4/2021,2184,538533,161,245461,421,221499,4.0,34466,1.0,36446,24.0,12569,329,187708,37.0,13242,31.0,7980,1609,87664
356,12/5/2021,1374,539907,102,245563,839,222338,1.0,34467,0.0,36446,67.0,12636,666,188374,71.0,13313,35.0,8015,442,88106
357,12/6/2021,1922,541829,234,245797,466,222804,7.0,34474,5.0,36451,54.0,12690,363,188737,33.0,13346,16.0,8031,1234,89340
358,12/7/2021,2447,544276,307,246104,467,223271,10.0,34484,9.0,36460,48.0,12738,372,189109,31.0,13377,16.0,8047,1692,91032
359,12/8/2021,2229,546505,271,246375,511,223782,9.0,34493,12.0,36472,29.0,12767,429,189538,40.0,13417,13.0,8060,1468,92500
360,12/9/2021,2146,548651,302,246677,460,224242,6.0,34499,8.0,36480,27.0,12794,357,189895,43.0,13460,33.0,8093,1398,93898
361,12/10/2021,2086,550737,239,246916,402,224644,10.0,34509,9.0,36489,38.0,12832,312,190207,32.0,13492,20.0,8113,1455,95353
362,12/11/2021,1783,552520,137,247053,493,225137,6.0,34515,1.0,36490,59.0,12891,367,190574,41.0,13533,26.0,8139,1155,96508
363,12/12/2021,415,552935,55,247108,87,225224,1.0,34516,3.0,36493,4.0,12895,70,190644,7.0,13540,6.0,8145,275,96783
364,12/13/2021,1753,554688,298,247406,393,225617,9.0,34525,8.0,36501,26.0,12921,319,190963,35.0,13575,13.0,8158,1080,97863
365,12/14/2021,2180,556868,276,247682,365,225982,7.0,34532,5.0,36506,33.0,12954,299,191262,16.0,13591,17.0,8175,1564,99427
366,12/15/2021,1739,558607,200,247882,229,226211,6.0,34538,4.0,36510,9.0,12963,185,191447,20.0,13611,15.0,8190,1324,100751
367,12/16/2021,1767,560374,313,248195,246,226457,7.0,34545,8.0,36518,15.0,12978,207,191654,15.0,13626,9.0,8199,1226,101977
368,12/17/2021,2116,562490,307,248502,442,226899,6.0,34551,10.0,36528,28.0,13006,364,192018,39.0,13665,11.0,8210,1377,103354
369,12/18/2021,1803,564293,179,248681,241,227140,4.0,34555,4.0,36532,17.0,13023,206,192224,10.0,13675,8.0,8218,1384,104738
370,12/19/2021,438,564731,44,248725,80,227220,1.0,34556,3.0,36535,5.0,13028,67,192291,4.0,13679,4.0,8222,314,105052
371,12/20/2021,1549,566280,197,248922,243,227463,10.0,34566,9.0,36544,27.0,13055,192,192483,16.0,13695,8.0,8230,1114,106166
372,12/21/2021,2190,568470,311,249233,295,227758,10.0,34576,8.0,36552,28.0,13083,228,192711,25.0,13720,14.0,8244,1592,107758
373,12/22/2021,1876,570346,219,249452,285,228043,4.0,34580,9.0,36561,28.0,13111,227,192938,22.0,13742,8.0,8252,1375,109133
374,12/23/2021,1239,571585,216,249668,207,228250,5.0,34585,4.0,36565,23.0,13134,157,193095,16.0,13758,11.0,8263,829,109962
375,12/24/2021,320,571905,45,249713,63,228313,3.0,34588,2.0,36567,4.0,13138,54,193149,4.0,13762,1.0,8264,214,110176
376,12/25/2021,13,571918,3,249716,2,228315,0.0,34588,0.0,36567,,13138,1,193150,1.0,13763,,8264,8,110184
377,12/26/2021,356,572274,60,249776,68,228383,1.0,34589,0.0,36567,7.0,13145,53,193203,5.0,13768,3.0,8267,230,110414
378,12/27/2021,1252,573526,175,249951,222,228605,4.0,34593,5.0,36572,18.0,13163,176,193379,20.0,13788,8.0,8275,861,111275
379,12/28/2021,1891,575417,268,250219,295,228900,12.0,34605,11.0,36583,35.0,13198,230,193609,16.0,13804,14.0,8289,1332,112607
380,12/29/2021,1699,577116,210,250429,254,229154,5.0,34610,6.0,36589,28.0,13226,193,193802,22.0,13826,11.0,8300,1246,113853
381,12/30/2021,1367,578483,220,250649,242,229396,7.0,34617,9.0,36598,27.0,13253,188,193990,15.0,13841,12.0,8312,915,114768
382,12/31/2021,505,578988,96,250745,92,229488,0.0,34617,2.0,36600,7.0,13260,75,194065,5.0,13846,5.0,8317,320,115088
383,1/1/2022,93,579081,12,250757,16,229504,1.0,34618,1.0,36601,0.0,13260,13,194078,2.0,13848,1.0,8318,65,115153
384,1/2/2022,315,579396,45,250802,59,229563,1.0,34619,1.0,36602,7.0,13267,41,194119,8.0,13856,3.0,8321,212,115365
385,1/3/2022,1596,580992,329,251131,345,229908,4.0,34623,5.0,36607,34.0,13301,281,194400,20.0,13876,10.0,8331,932,116297
386,1/4/2022,1674,582666,263,251394,275,230183,10.0,34633,7.0,36614,30.0,13331,217,194617,17.0,13893,11.0,8342,1149,117446
387,1/5/2022,1331,583997,204,251598,200,230383,7.0,34640,8.0,36622,13.0,13344,163,194780,9.0,13902,15.0,8357,940,118386
388,1/6/2022,1228,585225,255,251853,232,230615,4.0,34644,4.0,36626,24.0,13368,173,194953,13.0,13915,22.0,8379,750,119136
389,1/7/2022,2057,587282,254,252107,341,230956,6.0,34650,9.0,36635,35.0,13403,263,195216,30.0,13945,13.0,8392,1474,120610
390,1/8/2022,1576,588858,124,252231,130,231086,0.0,34650,3.0,36638,7.0,13410,109,195325,7.0,13952,7.0,8399,1326,121936
391,1/9/2022,499,589357,91,252322,73,231159,0.0,34650,2.0,36640,14.0,13424,50,195375,3.0,13955,6.0,8405,336,122272
392,1/10/2022,1553,590910,286,252608,250,231409,3.0,34653,6.0,36646,19.0,13443,194,195569,27.0,13982,10.0,8415,1028,123300
393,1/11/2022,1562,592472,221,252829,275,231684,3.0,34656,4.0,36650,32.0,13475,209,195778,15.0,13997,19.0,8434,1078,124378
394,1/12/2022,1402,593874,178,253007,185,231869,6.0,34662,5.0,36655,29.0,13504,127,195905,20.0,14017,9.0,8443,1051,125429
395,1/13/2022,1095,594969,191,253198,177,232046,3.0,34665,2.0,36657,14.0,13518,131,196036,18.0,14035,14.0,8457,736,126165
396,1/14/2022,1615,596584,275,253473,214,232260,2.0,34667,8.0,36665,25.0,13543,156,196192,20.0,14055,13.0,8470,1142,127307
397,1/15/2022,1215,597799,136,253609,102,232362,1.0,34668,3.0,36668,11.0,13554,80,196272,9.0,14064,2.0,8472,978,128285
398,1/16/2022,290,598089,47,253656,35,232397,1.0,34669,0.0,36668,1.0,13555,31,196303,3.0,14067,0.0,8472,208,128493
399,1/17/2022,774,598863,160,253816,127,232524,4.0,34673,5.0,36673,12.0,13567,105,196408,8.0,14075,2.0,8474,489,128982
400,1/18/2022,886,599749,164,253980,165,232689,2.0,34675,6.0,36679,25.0,13592,126,196534,6.0,14081,8.0,8482,564,129546
401,1/19/2022,722,600471,122,254102,118,232807,4.0,34679,7.0,36686,9.0,13601,87,196621,10.0,14091,12.0,8494,494,130040
402,1/20/2022,780,601251,146,254248,146,232953,0.0,34679,10.0,36696,17.0,13618,110,196731,10.0,14101,9.0,8503,495,130535
403,1/21/2022,1174,602425,167,254415,171,233124,7.0,34686,2.0,36698,15.0,13633,133,196864,12.0,14113,11.0,8514,845,131380
404,1/22/2022,782,603207,86,254501,103,233227,0.0,34686,1.0,36699,14.0,13647,73,196937,7.0,14120,9.0,8523,594,131974
405,1/23/2022,210,603417,24,254525,53,233280,1.0,34687,0.0,36699,5.0,13652,41,196978,7.0,14127,0.0,8523,134,132108
406,1/24/2022,490,603907,75,254600,107,233387,1.0,34688,1.0,36700,14.0,13666,78,197056,8.0,14135,7.0,8530,311,132419
407,1/25/2022,662,604569,116,254716,143,233530,3.0,34691,2.0,36702,15.0,13681,100,197156,21.0,14156,7.0,8537,404,132823
408,1/26/2022,643,605212,100,254816,140,233670,8.0,34699,2.0,36704,13.0,13694,106,197262,13.0,14169,8.0,8545,412,133235
409,1/27/2022,619,605831,114,254930,173,233843,5.0,34704,1.0,36705,29.0,13723,128,197390,10.0,14179,6.0,8551,338,133573
410,1/28/2022,969,606800,163,255093,169,234012,6.0,34710,6.0,36711,20.0,13743,119,197509,14.0,14193,16.0,8567,640,134213
411,1/29/2022,558,607358,65,255158,87,234099,1.0,34711,4.0,36715,10.0,13753,64,197573,8.0,14201,5.0,8572,406,134619
412,1/30/2022,193,607551,33,255191,45,234144,1.0,34712,1.0,36716,14.0,13767,27,197600,1.0,14202,3.0,8575,117,134736
413,1/31/2022,558,608109,138,255329,120,234264,2.0,34714,2.0,36718,17.0,13784,79,197679,13.0,14215,11.0,8586,304,135040
414,2/1/2022,549,608658,99,255428,137,234401,0.0,34714,4.0,36722,19.0,13803,102,197781,11.0,14226,5.0,8591,315,135355
415,2/2/2022,127,608785,18,255446,45,234446,0.0,34714,1.0,36723,2.0,13805,41,197822,1.0,14227,1.0,8592,67,135422
416,2/3/2022,371,609156,77,255523,117,234563,1.0,34715,3.0,36726,24.0,13829,81,197903,6.0,14233,6.0,8598,182,135604
417,2/4/2022,644,609800,109,255632,147,234710,6.0,34721,3.0,36729,17.0,13846,115,198018,9.0,14242,6.0,8604,390,135994
418,2/5/2022,456,610256,57,255689,112,234822,2.0,34723,0.0,36729,7.0,13853,90,198108,6.0,14248,9.0,8613,289,136283
419,2/6/2022,124,610380,21,255710,34,234856,0.0,34723,1.0,36730,1.0,13854,23,198131,6.0,14254,4.0,8617,70,136353
420,2/7/2022,362,610742,61,255771,109,234965,0.0,34723,0.0,36730,12.0,13866,84,198215,5.0,14259,8.0,8625,194,136547
421,2/8/2022,441,611183,85,255856,115,235080,0.0,34723,3.0,36733,19.0,13885,84,198299,5.0,14264,7.0,8632,251,136798
422,2/9/2022,353,611536,63,255919,98,235178,3.0,34726,1.0,36734,18.0,13903,65,198364,3.0,14267,12.0,8644,195,136993
423,2/10/2022,374,611910,84,256003,88,235266,1.0,34727,3.0,36737,15.0,13918,60,198424,8.0,14275,5.0,8649,203,137196
424,2/11/2022,542,612452,95,256098,155,235421,3.0,34730,0.0,36737,28.0,13946,106,198530,9.0,14284,12.0,8661,297,137493
425,2/12/2022,249,612701,41,256139,51,235472,0.0,34730,0.0,36737,5.0,13951,39,198569,5.0,14289,2.0,8663,160,137653
426,2/13/2022,75,612776,18,256157,16,235488,0.0,34730,1.0,36738,0.0,13951,10,198579,4.0,14293,2.0,8665,43,137696
427,2/14/2022,238,613014,42,256199,51,235539,4.0,34734,2.0,36740,8.0,13959,37,198616,2.0,14295,4.0,8669,147,137843
428,2/15/2022,302,613316,44,256243,95,235634,0.0,34734,0.0,36740,16.0,13975,65,198681,7.0,14302,7.0,8676,167,138010
429,2/16/2022,222,613538,43,256286,63,235697,2.0,34736,0.0,36740,12.0,13987,43,198724,5.0,14307,3.0,8679,119,138129
430,2/17/2022,163,613701,30,256316,43,235740,1.0,34737,1.0,36741,8.0,13995,31,198755,3.0,14310,1.0,8680,92,138221
431,2/18/2022,487,614188,106,256422,110,235850,3.0,34740,2.0,36743,15.0,14010,64,198819,20.0,14330,11.0,8691,271,138492
432,2/19/2022,212,614400,26,256448,61,235911,0.0,34740,0.0,36743,12.0,14022,41,198860,2.0,14332,6.0,8697,127,138619
433,2/20/2022,67,614467,16,256464,12,235923,0.0,34740,0.0,36743,0.0,14022,10,198870,0.0,14332,2.0,8699,40,138659
434,2/21/2022,134,614601,28,256492,43,235966,0.0,34740,1.0,36744,9.0,14031,28,198898,4.0,14336,2.0,8701,67,138726
