,Date,daily number of doses received by Larimer County residents,total number of doses recevied by residents,daily number of residents receiving first dose,total number of residents receiving first dose,daily number of residents vaccinated,total number of residents vaccinated,daily number of 70+ vaccinated,total number of 70+ vaccinated,daily number of 70+ at least one dose,total number of 70+ at least one dose,daily number of Latinx residents vaccinated,total of Latinx residents vaccinated,daily number of White non-Latinx residents vaccinated,total of White non-Latinx residents vaccinated,daily number of non-White non-Latinx residents vaccinated,total of non-White non-Latinx residents vaccinated,dailyUnknown,totalUnknown,daily_additional_doses,total_additional_doses
0,2020-12-14,32,32,32,32,1,1,0.0,0,1.0,1,0.0,0,1,1,0.0,0,,0,0,0
1,2020-12-15,15,47,15,47,1,2,,0,,1,,0,1,2,0.0,0,,0,0,0
2,2020-12-16,309,356,309,356,0,2,0.0,0,2.0,3,0.0,0,0,2,0.0,0,0.0,0,0,0
3,2020-12-17,996,1352,996,1352,0,2,0.0,0,11.0,14,0.0,0,0,2,0.0,0,0.0,0,0,0
4,2020-12-18,1052,2404,1052,2404,2,4,0.0,0,15.0,29,0.0,0,2,4,0.0,0,0.0,0,0,0
5,2020-12-19,723,3127,723,3127,0,4,0.0,0,14.0,43,0.0,0,0,4,0.0,0,0.0,0,0,0
6,2020-12-20,268,3395,268,3395,0,4,0.0,0,4.0,47,0.0,0,0,4,0.0,0,0.0,0,0,0
7,2020-12-21,360,3755,360,3755,2,6,0.0,0,3.0,50,0.0,0,2,6,0.0,0,0.0,0,0,0
8,2020-12-22,364,4119,364,4119,0,6,0.0,0,7.0,57,0.0,0,0,6,0.0,0,0.0,0,0,0
9,2020-12-23,439,4558,439,4558,0,6,0.0,0,6.0,63,0.0,0,0,6,0.0,0,0.0,0,0,0
10,2020-12-24,103,4661,103,4661,0,6,0.0,0,3.0,66,0.0,0,0,6,0.0,0,0.0,0,0,0
11,2020-12-25,1,4662,1,4662,0,6,,0,,66,,0,0,6,,0,,0,0,0
12,2020-12-26,224,4886,224,4886,1,7,0.0,0,3.0,69,0.0,0,1,7,0.0,0,0.0,0,0,0
13,2020-12-27,280,5166,280,5166,0,7,0.0,0,197.0,266,0.0,0,0,7,0.0,0,0.0,0,0,0
14,2020-12-28,710,5876,710,5876,0,7,0.0,0,386.0,652,0.0,0,0,7,0.0,0,0.0,0,0,0
15,2020-12-29,918,6794,917,6793,1,8,0.0,0,463.0,1115,0.0,0,1,8,0.0,0,0.0,0,0,0
16,2020-12-30,878,7672,878,7671,0,8,0.0,0,273.0,1388,0.0,0,0,8,0.0,0,0.0,0,0,0
17,2020-12-31,898,8570,898,8569,0,8,0.0,0,344.0,1732,0.0,0,0,8,0.0,0,0.0,0,0,0
18,2021-01-01,4,8574,3,8572,1,9,,0,,1732,,0,1,9,,0,,0,0,0
19,2021-01-02,389,8963,389,8961,1,10,0.0,0,142.0,1874,0.0,0,1,10,0.0,0,0.0,0,0,0
20,2021-01-03,121,9084,121,9082,0,10,0.0,0,52.0,1926,0.0,0,0,10,0.0,0,0.0,0,0,0
21,2021-01-04,587,9671,574,9656,13,23,0.0,0,320.0,2246,0.0,0,11,21,2.0,2,0.0,0,0,0
22,2021-01-05,647,10318,638,10294,10,33,0.0,0,409.0,2655,0.0,0,9,30,1.0,3,0.0,0,0,0
23,2021-01-06,1234,11552,913,11207,320,353,4.0,4,516.0,3171,17.0,17,282,312,17.0,20,4.0,4,0,0
24,2021-01-07,1663,13215,704,11911,955,1308,12.0,16,407.0,3578,33.0,50,865,1177,42.0,62,15.0,19,0,0
25,2021-01-08,1990,15205,981,12892,1006,2314,12.0,28,477.0,4055,45.0,95,899,2076,42.0,104,20.0,39,1,1
26,2021-01-09,1223,16428,523,13415,691,3005,14.0,42,303.0,4358,16.0,111,627,2703,36.0,140,12.0,51,0,1
27,2021-01-10,703,17131,426,13841,276,3281,4.0,46,261.0,4619,10.0,121,249,2952,14.0,154,3.0,54,0,1
28,2021-01-11,1149,18280,798,14639,351,3632,1.0,47,535.0,5154,10.0,131,319,3271,18.0,172,4.0,58,0,1
29,2021-01-12,1175,19455,879,15518,295,3927,8.0,55,518.0,5672,12.0,143,257,3528,18.0,190,8.0,66,1,2
30,2021-01-13,1076,20531,831,16349,245,4172,1.0,56,378.0,6050,23.0,166,199,3727,15.0,205,8.0,74,0,2
31,2021-01-14,867,21398,833,17182,35,4207,1.0,57,495.0,6545,2.0,168,31,3758,1.0,206,1.0,75,0,2
32,2021-01-15,1210,22608,1197,18379,13,4220,0.0,57,756.0,7301,0.0,168,13,3771,0.0,206,0.0,75,0,2
33,2021-01-16,988,23596,973,19352,15,4235,1.0,58,588.0,7889,0.0,168,14,3785,1.0,207,0.0,75,0,2
34,2021-01-17,49,23645,44,19396,5,4240,0.0,58,18.0,7907,0.0,168,3,3788,2.0,209,0.0,75,0,2
35,2021-01-18,1024,24669,821,20217,201,4441,48.0,106,606.0,8513,8.0,176,177,3965,10.0,219,6.0,81,2,4
36,2021-01-19,1251,25920,1111,21328,140,4581,9.0,115,736.0,9249,7.0,183,120,4085,6.0,225,7.0,88,0,4
37,2021-01-20,1427,27347,1208,22536,217,4798,17.0,132,574.0,9823,15.0,198,175,4260,9.0,234,18.0,106,1,5
38,2021-01-21,2251,29598,2043,24579,208,5006,7.0,139,1586.0,11409,12.0,210,174,4434,14.0,248,8.0,114,0,5
39,2021-01-22,1732,31330,1456,26035,276,5282,91.0,230,1093.0,12502,35.0,245,221,4655,13.0,261,7.0,121,0,5
40,2021-01-23,894,32224,559,26594,333,5615,59.0,289,414.0,12916,7.0,252,304,4959,13.0,274,9.0,130,0,5
41,2021-01-24,394,32618,103,26697,290,5905,208.0,497,60.0,12976,8.0,260,272,5231,9.0,283,1.0,131,0,5
42,2021-01-25,1407,34025,784,27481,618,6523,368.0,865,555.0,13531,14.0,274,576,5807,15.0,298,13.0,144,1,6
43,2021-01-26,1622,35647,689,28170,929,7452,464.0,1329,439.0,13970,30.0,304,852,6659,34.0,332,13.0,157,0,6
44,2021-01-27,1835,37482,770,28940,1062,8514,537.0,1866,332.0,14302,39.0,343,966,7625,44.0,376,13.0,170,0,6
45,2021-01-28,1347,38829,538,29478,807,9321,357.0,2223,294.0,14596,25.0,368,738,8363,26.0,402,18.0,188,2,8
46,2021-01-29,1619,40448,1147,30625,469,9790,158.0,2381,827.0,15423,22.0,390,404,8767,31.0,433,12.0,200,0,8
47,2021-01-30,1229,41677,738,31363,486,10276,213.0,2594,601.0,16024,23.0,413,438,9205,20.0,453,5.0,205,2,10
48,2021-01-31,620,42297,399,31762,220,10496,75.0,2669,355.0,16379,5.0,418,193,9398,15.0,468,7.0,212,1,11
49,2021-02-01,1605,43902,900,32662,705,11201,468.0,3137,654.0,17033,17.0,435,651,10049,24.0,492,13.0,225,1,12
50,2021-02-02,1864,45766,732,33394,1132,12333,737.0,3874,582.0,17615,42.0,477,1045,11094,35.0,527,10.0,235,0,12
51,2021-02-03,1268,47034,584,33978,684,13017,326.0,4200,228.0,17843,47.0,524,583,11677,41.0,568,13.0,248,0,12
52,2021-02-04,2533,49567,1793,35771,737,13754,493.0,4693,1550.0,19393,30.0,554,660,12337,37.0,605,10.0,258,1,13
53,2021-02-05,2569,52136,1529,37300,1033,14787,683.0,5376,1305.0,20698,38.0,592,947,13284,27.0,632,21.0,279,1,14
54,2021-02-06,2213,54349,1593,38893,616,15403,446.0,5822,1242.0,21940,7.0,599,585,13869,21.0,653,3.0,282,0,14
55,2021-02-07,230,54579,88,38981,140,15543,95.0,5917,26.0,21966,7.0,606,125,13994,4.0,657,4.0,286,2,16
56,2021-02-08,2490,57069,1593,40574,897,16440,609.0,6526,1135.0,23101,26.0,632,824,14818,28.0,685,19.0,305,0,16
57,2021-02-09,2376,59445,1534,42108,840,17280,514.0,7040,994.0,24095,25.0,657,753,15571,32.0,717,30.0,335,0,16
58,2021-02-10,1589,61034,972,43080,612,17892,325.0,7365,291.0,24386,25.0,682,546,16117,25.0,742,16.0,351,6,22
59,2021-02-11,3535,64569,2002,45082,1529,19421,1062.0,8427,809.0,25195,57.0,739,1396,17513,47.0,789,29.0,380,2,24
60,2021-02-12,3252,67821,1800,46882,1449,20870,953.0,9380,797.0,25992,58.0,797,1328,18841,45.0,834,18.0,398,0,24
61,2021-02-13,3002,70823,2370,49252,627,21497,311.0,9691,671.0,26663,14.0,811,574,19415,25.0,859,14.0,412,2,26
62,2021-02-14,424,71247,353,49605,71,21568,49.0,9740,45.0,26708,2.0,813,64,19479,3.0,862,2.0,414,0,26
63,2021-02-15,2615,73862,2126,51731,488,22056,326.0,10066,256.0,26964,17.0,830,457,19936,11.0,873,3.0,417,0,26
64,2021-02-16,2755,76617,1923,53654,832,22888,504.0,10570,230.0,27194,34.0,864,758,20694,23.0,896,17.0,434,0,26
65,2021-02-17,1628,78245,653,54307,972,23860,481.0,11051,155.0,27349,27.0,891,887,21581,39.0,935,19.0,453,1,27
66,2021-02-18,2646,80891,1679,55986,965,24825,741.0,11792,276.0,27625,37.0,928,889,22470,30.0,965,9.0,462,1,28
67,2021-02-19,2424,83315,1037,57023,1377,26202,1025.0,12817,154.0,27779,44.0,972,1276,23746,42.0,1007,15.0,477,4,32
68,2021-02-20,1654,84969,687,57710,965,27167,787.0,13604,133.0,27912,23.0,995,902,24648,30.0,1037,10.0,487,1,33
69,2021-02-21,109,85078,39,57749,68,27235,37.0,13641,8.0,27920,1.0,996,65,24713,2.0,1039,0.0,487,1,34
70,2021-02-22,2025,87103,762,58511,1257,28492,929.0,14570,147.0,28067,38.0,1034,1170,25883,39.0,1078,10.0,497,1,35
71,2021-02-23,1221,88324,514,59025,708,29200,471.0,15041,158.0,28225,21.0,1055,638,26521,34.0,1112,15.0,512,0,35
72,2021-02-24,1400,89724,748,59773,648,29848,277.0,15318,134.0,28359,31.0,1086,593,27114,18.0,1130,6.0,518,1,36
73,2021-02-25,3865,93589,2066,61839,1797,31645,1510.0,16828,351.0,28710,47.0,1133,1695,28809,37.0,1167,18.0,536,0,36
74,2021-02-26,3268,96857,1159,62998,2105,33750,1748.0,18576,201.0,28911,32.0,1165,1986,30795,57.0,1224,30.0,566,2,38
75,2021-02-27,3492,100349,1660,64658,1828,35578,1568.0,20144,549.0,29460,35.0,1200,1714,32509,52.0,1276,27.0,593,2,40
76,2021-02-28,427,100776,357,65015,69,35647,41.0,20185,117.0,29577,2.0,1202,62,32571,2.0,1278,3.0,596,0,40
77,2021-03-01,2834,103610,1364,66379,1466,37113,1076.0,21261,303.0,29880,53.0,1255,1356,33927,45.0,1323,12.0,608,7,47
78,2021-03-02,3263,106873,1736,68115,1525,38638,1053.0,22314,385.0,30265,38.0,1293,1414,35341,44.0,1367,29.0,637,0,47
79,2021-03-03,1647,108520,1083,69198,563,39201,176.0,22490,203.0,30468,34.0,1327,502,35843,22.0,1389,5.0,642,0,47
80,2021-03-04,3006,111526,1582,70780,1432,40633,820.0,23310,171.0,30639,43.0,1370,1315,37158,52.0,1441,22.0,664,21,68
81,2021-03-05,3493,115019,2060,72840,1449,42082,820.0,24130,427.0,31066,40.0,1410,1339,38497,45.0,1486,25.0,689,20,88
82,2021-03-06,4095,119114,2312,75152,2099,44181,779.0,24909,267.0,31333,104.0,1514,1876,40373,81.0,1567,38.0,727,500,588
83,2021-03-07,415,119529,295,75447,129,44310,37.0,24946,20.0,31353,2.0,1516,122,40495,3.0,1570,2.0,729,22,610
84,2021-03-08,2812,122341,1049,76496,1784,46094,260.0,25206,74.0,31427,50.0,1566,1645,42140,63.0,1633,26.0,755,113,723
85,2021-03-09,3176,125517,1648,78144,1555,47649,259.0,25465,95.0,31522,48.0,1614,1416,43556,63.0,1696,28.0,783,66,789
86,2021-03-10,2371,127888,1355,79499,1034,48683,304.0,25769,83.0,31605,54.0,1668,928,44484,34.0,1730,18.0,801,57,846
87,2021-03-11,4184,132072,2382,81881,1820,50503,399.0,26168,134.0,31739,64.0,1732,1663,46147,66.0,1796,27.0,828,62,908
88,2021-03-12,3933,136005,2572,84453,1395,51898,196.0,26364,66.0,31805,71.0,1803,1236,47383,53.0,1849,35.0,863,59,967
89,2021-03-13,216,136221,134,84587,105,52003,20.0,26384,7.0,31812,1.0,1804,97,47480,4.0,1853,3.0,866,24,991
90,2021-03-14,99,136320,61,84648,37,52040,9.0,26393,0.0,31812,1.0,1805,34,47514,1.0,1854,1.0,867,2,993
91,2021-03-15,896,137216,359,85007,540,52580,86.0,26479,14.0,31826,19.0,1824,499,48013,15.0,1869,7.0,874,18,1011
92,2021-03-16,3288,140504,2122,87129,1180,53760,223.0,26702,45.0,31871,65.0,1889,1050,49063,42.0,1911,23.0,897,25,1036
93,2021-03-17,2893,143397,1775,88904,1133,54893,238.0,26940,87.0,31958,40.0,1929,1033,50096,38.0,1949,22.0,919,29,1065
94,2021-03-18,4013,147410,2099,91003,1925,56818,340.0,27280,93.0,32051,97.0,2026,1737,51833,64.0,2013,27.0,946,23,1088
95,2021-03-19,3014,150424,1750,92753,1271,58089,221.0,27501,42.0,32093,62.0,2088,1142,52975,45.0,2058,22.0,968,14,1102
96,2021-03-20,3079,153503,1964,94717,1122,59211,316.0,27817,54.0,32147,37.0,2125,1010,53985,53.0,2111,22.0,990,32,1134
97,2021-03-21,656,154159,394,95111,262,59473,27.0,27844,5.0,32152,11.0,2136,234,54219,15.0,2126,2.0,992,19,1153
98,2021-03-22,3103,157262,2233,97344,876,60349,189.0,28033,56.0,32208,18.0,2154,808,55027,37.0,2163,13.0,1005,22,1175
99,2021-03-23,4437,161699,3558,100902,1343,61692,197.0,28230,75.0,32283,54.0,2208,1177,56204,65.0,2228,47.0,1052,336,1511
100,2021-03-24,3138,164837,2417,103319,743,62435,115.0,28345,36.0,32319,41.0,2249,662,56866,26.0,2254,14.0,1066,27,1538
101,2021-03-25,5072,169909,3054,106373,2024,64459,313.0,28658,70.0,32389,70.0,2319,1852,58718,66.0,2320,36.0,1102,14,1552
102,2021-03-26,4585,174494,2736,109109,1855,66314,325.0,28983,67.0,32456,119.0,2438,1592,60310,113.0,2433,31.0,1133,27,1579
103,2021-03-27,3337,177831,1911,111020,1424,67738,327.0,29310,21.0,32477,46.0,2484,1313,61623,46.0,2479,19.0,1152,3,1582
104,2021-03-28,1166,178997,807,111827,361,68099,94.0,29404,14.0,32491,12.0,2496,331,61954,16.0,2495,2.0,1154,2,1584
105,2021-03-29,4002,182999,2694,114521,1311,69410,232.0,29636,54.0,32545,42.0,2538,1225,63179,27.0,2522,17.0,1171,10,1594
106,2021-03-30,4379,187378,2758,117279,1666,71076,240.0,29876,75.0,32620,56.0,2594,1521,64700,66.0,2588,23.0,1194,37,1631
107,2021-03-31,3549,190927,2537,119816,1055,72131,168.0,30044,47.0,32667,38.0,2632,944,65644,49.0,2637,24.0,1218,21,1652
108,2021-04-01,5105,196032,3324,123140,1802,73933,148.0,30192,76.0,32743,70.0,2702,1648,67292,60.0,2697,24.0,1242,28,1680
109,2021-04-02,4711,200743,2523,125663,2204,76137,246.0,30438,49.0,32792,83.0,2785,2003,69295,88.0,2785,30.0,1272,18,1698
110,2021-04-03,4264,205007,3530,129193,781,76918,94.0,30532,39.0,32831,38.0,2823,695,69990,27.0,2812,21.0,1293,54,1752
111,2021-04-04,371,205378,256,129449,138,77056,6.0,30538,7.0,32838,3.0,2826,121,70111,10.0,2822,4.0,1297,28,1780
112,2021-04-05,4681,210059,3749,133198,969,78025,75.0,30613,46.0,32884,71.0,2897,831,70942,46.0,2868,21.0,1318,77,1857
113,2021-04-06,5149,215208,3014,136212,2416,80441,84.0,30697,59.0,32943,81.0,2978,2132,73074,133.0,3001,70.0,1388,185,2042
114,2021-04-07,4923,220131,3657,139869,2602,83043,63.0,30760,107.0,33050,128.0,3106,2228,75302,154.0,3155,92.0,1480,744,2786
115,2021-04-08,6676,226807,4489,144358,3232,86275,147.0,30907,123.0,33173,142.0,3248,2827,78129,168.0,3323,95.0,1575,621,3407
116,2021-04-09,5740,232547,3276,147634,3549,89824,81.0,30988,69.0,33242,172.0,3420,3082,81211,191.0,3514,104.0,1679,555,3962
117,2021-04-10,4412,236959,3144,150778,1984,91808,59.0,31047,71.0,33313,113.0,3533,1673,82884,136.0,3650,62.0,1741,302,4264
118,2021-04-11,1034,237993,791,151569,307,92115,5.0,31052,11.0,33324,15.0,3548,254,83138,27.0,3677,11.0,1752,39,4303
119,2021-04-12,5031,243024,3634,155203,2245,94360,83.0,31135,96.0,33420,80.0,3628,1950,85088,146.0,3823,69.0,1821,312,4615
120,2021-04-13,5027,248051,3562,158765,1487,95847,55.0,31190,76.0,33496,70.0,3698,1298,86386,95.0,3918,24.0,1845,19,4634
121,2021-04-14,2927,250978,1403,160168,1516,97363,87.0,31277,26.0,33522,92.0,3790,1316,87702,70.0,3988,38.0,1883,4,4638
122,2021-04-15,4934,255912,2311,162479,2609,99972,100.0,31377,56.0,33578,220.0,4010,2161,89863,162.0,4150,66.0,1949,4,4642
123,2021-04-16,3904,259816,2075,164554,1819,101791,44.0,31421,32.0,33610,64.0,4074,1587,91450,126.0,4276,42.0,1991,6,4648
124,2021-04-17,4558,264374,2377,166931,2173,103964,38.0,31459,57.0,33667,98.0,4172,1888,93338,129.0,4405,58.0,2049,3,4651
125,2021-04-18,1030,265404,403,167334,622,104586,12.0,31471,11.0,33678,42.0,4214,514,93852,32.0,4437,34.0,2083,3,4654
126,2021-04-19,3839,269243,1391,168725,2431,107017,45.0,31516,41.0,33719,166.0,4380,2043,95895,158.0,4595,64.0,2147,4,4658
127,2021-04-20,4695,273938,1861,170586,2821,109838,47.0,31563,68.0,33787,155.0,4535,2395,98290,191.0,4786,80.0,2227,6,4664
128,2021-04-21,3135,277073,696,171282,2429,112267,33.0,31596,32.0,33819,142.0,4677,2042,100332,161.0,4947,84.0,2311,8,4672
129,2021-04-22,4645,281718,1757,173039,2874,115141,46.0,31642,62.0,33881,139.0,4816,2460,102792,195.0,5142,80.0,2391,7,4679
130,2021-04-23,3592,285310,1176,174215,2401,117542,40.0,31682,31.0,33912,74.0,4890,2117,104909,122.0,5264,88.0,2479,6,4685
131,2021-04-24,3356,288666,1104,175319,2244,119786,14.0,31696,21.0,33933,102.0,4992,1900,106809,188.0,5452,54.0,2533,7,4692
132,2021-04-25,789,289455,345,175664,442,120228,6.0,31702,5.0,33938,102.0,5094,260,107069,37.0,5489,43.0,2576,3,4695
133,2021-04-26,4343,293798,1105,176769,3233,123461,35.0,31737,31.0,33969,141.0,5235,2787,109856,208.0,5697,97.0,2673,4,4699
134,2021-04-27,3343,297141,1183,177952,2154,125615,36.0,31773,37.0,34006,80.0,5315,1889,111745,135.0,5832,50.0,2723,12,4711
135,2021-04-28,2977,300118,712,178664,2267,127882,46.0,31819,20.0,34026,162.0,5477,1836,113581,191.0,6023,78.0,2801,14,4725
136,2021-04-29,3954,304072,818,179482,3135,131017,68.0,31887,32.0,34058,216.0,5693,2575,116156,223.0,6246,121.0,2922,8,4733
137,2021-04-30,2858,306930,633,180115,2229,133246,47.0,31934,24.0,34082,70.0,5763,1895,118051,186.0,6432,78.0,3000,10,4743
138,2021-05-01,3602,310532,805,180920,2781,136027,34.0,31968,18.0,34100,265.0,6028,2157,120208,195.0,6627,164.0,3164,16,4759
139,2021-05-02,515,311047,229,181149,304,136331,7.0,31975,2.0,34102,8.0,6036,250,120458,36.0,6663,10.0,3174,5,4764
140,2021-05-03,3418,314465,633,181782,2793,139124,45.0,32020,34.0,34136,105.0,6141,2389,122847,208.0,6871,91.0,3265,9,4773
141,2021-05-04,4337,318802,689,182471,3678,142802,68.0,32088,27.0,34163,136.0,6277,3160,126007,254.0,7125,128.0,3393,23,4796
142,2021-05-05,2199,321001,468,182939,1781,144583,63.0,32151,24.0,34187,77.0,6354,1471,127478,143.0,7268,90.0,3483,9,4805
143,2021-05-06,3665,324666,810,183749,2998,147581,99.0,32250,40.0,34227,177.0,6531,2474,129952,195.0,7463,152.0,3635,27,4832
144,2021-05-07,2935,327601,542,184291,2508,150089,44.0,32294,11.0,34238,132.0,6663,2056,132008,201.0,7664,119.0,3754,25,4857
145,2021-05-08,2990,330591,551,184842,2575,152664,45.0,32339,16.0,34254,162.0,6825,2074,134082,189.0,7853,150.0,3904,26,4883
146,2021-05-09,363,330954,136,184978,242,152906,4.0,32343,2.0,34256,11.0,6836,199,134281,22.0,7875,10.0,3914,1,4884
147,2021-05-10,2402,333356,366,185344,2084,154990,62.0,32405,16.0,34272,82.0,6918,1689,135970,205.0,8080,108.0,4022,11,4895
148,2021-05-11,2714,336070,541,185885,2223,157213,91.0,32496,25.0,34297,192.0,7110,1717,137687,200.0,8280,114.0,4136,12,4907
149,2021-05-12,1190,337260,454,186339,807,158020,22.0,32518,14.0,34311,46.0,7156,641,138328,85.0,8365,35.0,4171,11,4918
150,2021-05-13,3235,340495,1027,187366,2228,160248,81.0,32599,24.0,34335,143.0,7299,1811,140139,158.0,8523,116.0,4287,14,4932
151,2021-05-14,2462,342957,1280,188646,1302,161550,52.0,32651,30.0,34365,60.0,7359,1084,141223,97.0,8620,61.0,4348,20,4952
152,2021-05-15,2982,345939,1498,190144,1590,163140,40.0,32691,15.0,34380,104.0,7463,1263,142486,141.0,8761,82.0,4430,17,4969
153,2021-05-16,944,346883,572,190716,413,163553,7.0,32698,9.0,34389,79.0,7542,259,142745,30.0,8791,45.0,4475,4,4973
154,2021-05-17,2417,349300,1203,191919,1298,164851,37.0,32735,26.0,34415,45.0,7587,1086,143831,102.0,8893,65.0,4540,12,4985
155,2021-05-18,2559,351859,1165,193084,1436,166287,43.0,32778,22.0,34437,64.0,7651,1196,145027,87.0,8980,89.0,4629,17,5002
156,2021-05-19,1874,353733,1153,194237,794,167081,26.0,32804,19.0,34456,40.0,7691,648,145675,64.0,9044,42.0,4671,9,5011
157,2021-05-20,1950,355683,908,195145,1090,168171,46.0,32850,27.0,34483,93.0,7784,865,146540,79.0,9123,53.0,4724,15,5026
158,2021-05-21,1617,357300,912,196057,795,168966,19.0,32869,16.0,34499,44.0,7828,633,147173,56.0,9179,62.0,4786,18,5044
159,2021-05-22,1667,358967,788,196845,912,169878,9.0,32878,13.0,34512,116.0,7944,631,147804,73.0,9252,92.0,4878,9,5053
160,2021-05-23,669,359636,340,197185,362,170240,2.0,32880,5.0,34517,68.0,8012,221,148025,20.0,9272,53.0,4931,0,5053
161,2021-05-24,1332,360968,536,197721,867,171107,38.0,32918,18.0,34535,44.0,8056,698,148723,78.0,9350,47.0,4978,14,5067
162,2021-05-25,1204,362172,495,198216,746,171853,21.0,32939,20.0,34555,55.0,8111,565,149288,58.0,9408,68.0,5046,11,5078
163,2021-05-26,945,363117,545,198761,528,172381,17.0,32956,25.0,34580,33.0,8144,421,149709,43.0,9451,31.0,5077,12,5090
164,2021-05-27,1243,364360,646,199407,671,173052,32.0,32988,19.0,34599,53.0,8197,542,150251,47.0,9498,29.0,5106,12,5102
165,2021-05-28,1040,365400,602,200009,489,173541,19.0,33007,22.0,34621,31.0,8228,381,150632,46.0,9544,31.0,5137,18,5120
166,2021-05-29,1018,366418,491,200500,566,174107,18.0,33025,8.0,34629,31.0,8259,446,151078,43.0,9587,46.0,5183,9,5129
167,2021-05-30,319,366737,216,200716,138,174245,5.0,33030,3.0,34632,12.0,8271,99,151177,15.0,9602,12.0,5195,6,5135
168,2021-05-31,329,367066,185,200901,174,174419,8.0,33038,6.0,34638,8.0,8279,141,151318,12.0,9614,13.0,5208,9,5144
169,2021-06-01,960,368026,389,201290,609,175028,29.0,33067,18.0,34656,49.0,8328,467,151785,43.0,9657,50.0,5258,16,5160
170,2021-06-02,704,368730,357,201647,408,175436,16.0,33083,8.0,34664,32.0,8360,329,152114,21.0,9678,26.0,5284,4,5164
171,2021-06-03,1288,370018,516,202163,833,176269,22.0,33105,12.0,34676,45.0,8405,693,152807,50.0,9728,45.0,5329,7,5171
172,2021-06-04,1507,371525,404,202567,1149,177418,16.0,33121,8.0,34684,66.0,8471,964,153771,71.0,9799,48.0,5377,6,5177
173,2021-06-05,1409,372934,354,202921,1083,178501,12.0,33133,6.0,34690,59.0,8530,890,154661,87.0,9886,47.0,5424,8,5185
174,2021-06-06,523,373457,140,203061,399,178900,5.0,33138,3.0,34693,40.0,8570,323,154984,23.0,9909,13.0,5437,2,5187
175,2021-06-07,1187,374644,331,203392,908,179808,15.0,33153,12.0,34705,67.0,8637,729,155713,80.0,9989,32.0,5469,11,5198
176,2021-06-08,1077,375721,249,203641,854,180662,16.0,33169,5.0,34710,57.0,8694,694,156407,64.0,10053,39.0,5508,5,5203
177,2021-06-09,1072,376793,284,203925,845,181507,15.0,33184,12.0,34722,75.0,8769,657,157064,64.0,10117,49.0,5557,5,5208
178,2021-06-10,1296,378089,335,204260,1001,182508,20.0,33204,4.0,34726,93.0,8862,787,157851,65.0,10182,56.0,5613,11,5219
179,2021-06-11,1104,379193,328,204588,825,183333,19.0,33223,13.0,34739,57.0,8919,645,158496,74.0,10256,49.0,5662,9,5228
180,2021-06-12,1035,380228,288,204876,797,184130,17.0,33240,10.0,34749,70.0,8989,621,159117,60.0,10316,46.0,5708,4,5232
181,2021-06-13,368,380596,96,204972,287,184417,4.0,33244,1.0,34750,36.0,9025,206,159323,23.0,10339,22.0,5730,1,5233
182,2021-06-14,814,381410,274,205246,589,185006,15.0,33259,4.0,34754,43.0,9068,445,159768,42.0,10381,59.0,5789,1,5234
183,2021-06-15,682,382092,239,205485,469,185475,21.0,33280,10.0,34764,39.0,9107,383,160151,31.0,10412,16.0,5805,0,5234
184,2021-06-16,617,382709,202,205687,445,185920,12.0,33292,4.0,34768,37.0,9144,336,160487,32.0,10444,40.0,5845,2,5236
185,2021-06-17,682,383391,241,205928,464,186384,14.0,33306,9.0,34777,40.0,9184,349,160836,49.0,10493,26.0,5871,10,5246
186,2021-06-18,1017,384408,371,206299,678,187062,23.0,33329,11.0,34788,48.0,9232,546,161382,52.0,10545,32.0,5903,10,5256
187,2021-06-19,628,385036,153,206452,490,187552,9.0,33338,6.0,34794,48.0,9280,363,161745,50.0,10595,29.0,5932,9,5265
188,2021-06-20,294,385330,111,206563,191,187743,3.0,33341,2.0,34796,35.0,9315,117,161862,14.0,10609,25.0,5957,3,5268
189,2021-06-21,507,385837,212,206775,325,188068,4.0,33345,8.0,34804,27.0,9342,244,162106,33.0,10642,21.0,5978,5,5273
190,2021-06-22,595,386432,247,207022,384,188452,12.0,33357,7.0,34811,30.0,9372,303,162409,22.0,10664,29.0,6007,2,5275
191,2021-06-23,506,386938,189,207211,350,188802,7.0,33364,10.0,34821,37.0,9409,253,162662,36.0,10700,24.0,6031,7,5282
192,2021-06-24,515,387453,209,207420,332,189134,12.0,33376,9.0,34830,28.0,9437,259,162921,22.0,10722,23.0,6054,2,5284
193,2021-06-25,686,388139,271,207691,442,189576,12.0,33388,8.0,34838,42.0,9479,329,163250,38.0,10760,33.0,6087,2,5286
194,2021-06-26,595,388734,162,207853,448,190024,9.0,33397,8.0,34846,77.0,9556,292,163542,41.0,10801,38.0,6125,2,5288
195,2021-06-27,175,388909,70,207923,106,190130,2.0,33399,3.0,34849,9.0,9565,77,163619,10.0,10811,10.0,6135,2,5290
196,2021-06-28,481,389390,205,208128,284,190414,7.0,33406,5.0,34854,38.0,9603,206,163825,24.0,10835,16.0,6151,2,5292
197,2021-06-29,547,389937,251,208379,322,190736,17.0,33423,11.0,34865,42.0,9645,235,164060,18.0,10853,27.0,6178,8,5300
198,2021-06-30,408,390345,202,208581,221,190957,8.0,33431,11.0,34876,19.0,9664,166,164226,16.0,10869,20.0,6198,12,5312
199,2021-07-01,482,390827,203,208784,298,191255,8.0,33439,7.0,34883,21.0,9685,224,164450,32.0,10901,21.0,6219,4,5316
200,2021-07-02,558,391385,270,209054,300,191555,4.0,33443,7.0,34890,26.0,9711,237,164687,21.0,10922,16.0,6235,2,5318
201,2021-07-03,304,391689,118,209172,194,191749,4.0,33447,3.0,34893,29.0,9740,126,164813,20.0,10942,19.0,6254,4,5322
202,2021-07-04,55,391744,20,209192,35,191784,1.0,33448,0.0,34893,4.0,9744,22,164835,1.0,10943,8.0,6262,0,5322
203,2021-07-05,305,392049,138,209330,165,191949,3.0,33451,1.0,34894,17.0,9761,113,164948,24.0,10967,11.0,6273,4,5326
204,2021-07-06,444,392493,187,209517,267,192216,4.0,33455,5.0,34899,44.0,9805,188,165136,17.0,10984,18.0,6291,1,5327
205,2021-07-07,369,392862,208,209725,178,192394,7.0,33462,6.0,34905,19.0,9824,133,165269,11.0,10995,15.0,6306,3,5330
206,2021-07-08,421,393283,200,209925,243,192637,9.0,33471,8.0,34913,24.0,9848,172,165441,23.0,11018,24.0,6330,3,5333
207,2021-07-09,479,393762,194,210119,291,192928,9.0,33480,2.0,34915,37.0,9885,211,165652,24.0,11042,19.0,6349,6,5339
208,2021-07-10,252,394014,140,210259,127,193055,5.0,33485,2.0,34917,5.0,9890,105,165757,11.0,11053,6.0,6355,2,5341
209,2021-07-11,225,394239,121,210380,126,193181,6.0,33491,6.0,34923,11.0,9901,93,165850,9.0,11062,13.0,6368,5,5346
210,2021-07-12,380,394619,201,210581,192,193373,6.0,33497,4.0,34927,26.0,9927,126,165976,22.0,11084,18.0,6386,3,5349
211,2021-07-13,430,395049,223,210804,223,193596,16.0,33513,10.0,34937,24.0,9951,175,166151,12.0,11096,12.0,6398,3,5352
212,2021-07-14,277,395326,146,210950,157,193753,8.0,33521,5.0,34942,18.0,9969,115,166266,9.0,11105,15.0,6413,5,5357
213,2021-07-15,364,395690,191,211141,182,193935,1.0,33522,4.0,34946,15.0,9984,137,166403,13.0,11118,17.0,6430,5,5362
214,2021-07-16,507,396197,242,211383,277,194212,8.0,33530,9.0,34955,23.0,10007,215,166618,18.0,11136,21.0,6451,3,5365
215,2021-07-17,279,396476,157,211540,138,194350,12.0,33542,5.0,34960,13.0,10020,104,166722,10.0,11146,11.0,6462,1,5366
216,2021-07-18,193,396669,119,211659,88,194438,3.0,33545,3.0,34963,14.0,10034,61,166783,7.0,11153,6.0,6468,3,5369
217,2021-07-19,403,397072,204,211863,206,194644,8.0,33553,8.0,34971,27.0,10061,150,166933,16.0,11169,13.0,6481,6,5375
218,2021-07-20,411,397483,207,212070,212,194856,7.0,33560,8.0,34979,12.0,10073,163,167096,21.0,11190,16.0,6497,4,5379
219,2021-07-21,328,397811,179,212249,170,195026,13.0,33573,14.0,34993,11.0,10084,128,167224,13.0,11203,18.0,6515,3,5382
220,2021-07-22,392,398203,233,212482,168,195194,8.0,33581,19.0,35012,17.0,10101,122,167346,18.0,11221,11.0,6526,8,5390
221,2021-07-23,545,398748,319,212801,232,195426,7.0,33588,10.0,35022,35.0,10136,162,167508,16.0,11237,19.0,6545,4,5394
222,2021-07-24,350,399098,214,213015,155,195581,8.0,33596,10.0,35032,20.0,10156,112,167620,9.0,11246,14.0,6559,5,5399
223,2021-07-25,202,399300,145,213160,67,195648,0.0,33596,4.0,35036,7.0,10163,49,167669,5.0,11251,6.0,6565,2,5401
224,2021-07-26,344,399644,201,213361,142,195790,1.0,33597,7.0,35043,9.0,10172,99,167768,15.0,11266,19.0,6584,4,5405
225,2021-07-27,414,400058,234,213595,169,195959,5.0,33602,16.0,35059,17.0,10189,122,167890,17.0,11283,13.0,6597,21,5426
226,2021-07-28,462,400520,281,213876,221,196180,3.0,33605,10.0,35069,28.0,10217,143,168033,16.0,11299,34.0,6631,4,5430
227,2021-07-29,506,401026,301,214177,241,196421,8.0,33613,6.0,35075,25.0,10242,183,168216,13.0,11312,20.0,6651,5,5435
228,2021-07-30,684,401710,477,214654,245,196666,10.0,33623,15.0,35090,26.0,10268,184,168400,16.0,11328,19.0,6670,5,5440
229,2021-07-31,328,402038,201,214855,130,196796,4.0,33627,1.0,35091,12.0,10280,103,168503,9.0,11337,6.0,6676,7,5447
230,2021-08-01,259,402297,166,215021,102,196898,0.0,33627,2.0,35093,15.0,10295,62,168565,8.0,11345,17.0,6693,6,5453
231,2021-08-02,447,402744,299,215320,175,197073,4.0,33631,13.0,35106,20.0,10315,119,168684,20.0,11365,16.0,6709,4,5457
232,2021-08-03,565,403309,349,215669,245,197318,6.0,33637,13.0,35119,36.0,10351,168,168852,15.0,11380,26.0,6735,4,5461
233,2021-08-04,387,403696,272,215941,144,197462,6.0,33643,14.0,35133,10.0,10361,109,168961,4.0,11384,21.0,6756,4,5465
234,2021-08-05,443,404139,286,216227,172,197634,5.0,33648,11.0,35144,20.0,10381,121,169082,18.0,11402,13.0,6769,4,5469
235,2021-08-06,676,404815,460,216687,267,197901,12.0,33660,16.0,35160,22.0,10403,199,169281,23.0,11425,23.0,6792,1,5470
236,2021-08-07,437,405252,304,216991,159,198060,3.0,33663,10.0,35170,13.0,10416,126,169407,4.0,11429,16.0,6808,5,5475
237,2021-08-08,217,405469,127,217118,98,198158,3.0,33666,5.0,35175,8.0,10424,71,169478,6.0,11435,13.0,6821,7,5482
238,2021-08-09,464,405933,283,217401,215,198373,4.0,33670,6.0,35181,22.0,10446,159,169637,11.0,11446,23.0,6844,6,5488
239,2021-08-10,499,406432,298,217699,229,198602,6.0,33676,14.0,35195,27.0,10473,178,169815,11.0,11457,13.0,6857,6,5494
240,2021-08-11,412,406844,264,217963,175,198777,11.0,33687,5.0,35200,14.0,10487,135,169950,14.0,11471,12.0,6869,2,5496
241,2021-08-12,541,407385,318,218281,262,199039,7.0,33694,13.0,35213,31.0,10518,184,170134,24.0,11495,23.0,6892,9,5505
242,2021-08-13,657,408042,380,218661,297,199336,11.0,33705,9.0,35222,29.0,10547,219,170353,19.0,11514,30.0,6922,9,5514
243,2021-08-14,506,408548,258,218919,257,199593,7.0,33712,10.0,35232,9.0,10556,221,170574,10.0,11524,17.0,6939,52,5566
244,2021-08-15,267,408815,128,219047,126,199719,2.0,33714,3.0,35235,11.0,10567,92,170666,6.0,11530,17.0,6956,21,5587
245,2021-08-16,536,409351,306,219353,172,199891,5.0,33719,11.0,35246,14.0,10581,131,170797,13.0,11543,14.0,6970,88,5675
246,2021-08-17,479,409830,223,219576,191,200082,18.0,33737,10.0,35256,17.0,10598,144,170941,10.0,11553,20.0,6990,91,5766
247,2021-08-18,590,410420,323,219899,262,200344,5.0,33742,15.0,35271,33.0,10631,178,171119,11.0,11564,40.0,7030,77,5843
248,2021-08-19,561,410981,280,220179,254,200598,7.0,33749,9.0,35280,20.0,10651,202,171321,17.0,11581,15.0,7045,85,5928
249,2021-08-20,848,411829,341,220520,459,201057,17.0,33766,11.0,35291,44.0,10695,365,171686,29.0,11610,21.0,7066,98,6026
250,2021-08-21,643,412472,209,220729,210,201267,5.0,33771,7.0,35298,15.0,10710,171,171857,13.0,11623,11.0,7077,232,6258
251,2021-08-22,314,412786,150,220879,142,201409,1.0,33772,2.0,35300,18.0,10728,101,171958,9.0,11632,14.0,7091,31,6289
252,2021-08-23,526,413312,261,221140,222,201631,10.0,33782,9.0,35309,19.0,10747,167,172125,13.0,11645,23.0,7114,66,6355
253,2021-08-24,569,413881,270,221410,283,201914,10.0,33792,8.0,35317,27.0,10774,224,172349,14.0,11659,18.0,7132,58,6413
254,2021-08-25,590,414471,320,221730,258,202172,11.0,33803,13.0,35330,19.0,10793,196,172545,10.0,11669,33.0,7165,50,6463
255,2021-08-26,533,415004,263,221993,253,202425,9.0,33812,14.0,35344,18.0,10811,193,172738,22.0,11691,20.0,7185,46,6509
256,2021-08-27,888,415892,351,222344,406,202831,15.0,33827,11.0,35355,35.0,10846,302,173040,23.0,11714,46.0,7231,173,6682
257,2021-08-28,1461,417353,203,222547,244,203075,7.0,33834,5.0,35360,23.0,10869,180,173220,14.0,11728,27.0,7258,1018,7700
258,2021-08-29,1085,418438,158,222705,141,203216,4.0,33838,4.0,35364,9.0,10878,114,173334,12.0,11740,6.0,7264,790,8490
259,2021-08-30,611,419049,266,222971,282,203498,9.0,33847,13.0,35377,25.0,10903,215,173549,8.0,11748,34.0,7298,95,8585
260,2021-08-31,813,419862,235,223206,235,203733,7.0,33854,13.0,35390,18.0,10921,186,173735,18.0,11766,13.0,7311,352,8937
261,2021-09-01,944,420806,246,223452,221,203954,12.0,33866,16.0,35406,21.0,10942,167,173902,13.0,11779,20.0,7331,497,9434
262,2021-09-02,829,421635,186,223638,206,204160,13.0,33879,15.0,35421,19.0,10961,152,174054,16.0,11795,19.0,7350,462,9896
263,2021-09-03,857,422492,340,223978,374,204534,13.0,33892,12.0,35433,46.0,11007,272,174326,20.0,11815,36.0,7386,165,10061
264,2021-09-04,374,422866,162,224140,165,204699,6.0,33898,8.0,35441,13.0,11020,127,174453,12.0,11827,13.0,7399,57,10118
265,2021-09-05,250,423116,133,224273,107,204806,2.0,33900,5.0,35446,12.0,11032,75,174528,9.0,11836,11.0,7410,21,10139
266,2021-09-06,109,423225,46,224319,56,204862,1.0,33901,0.0,35446,3.0,11035,42,174570,8.0,11844,3.0,7413,12,10151
267,2021-09-07,947,424172,198,224517,274,205136,19.0,33920,13.0,35459,23.0,11058,208,174778,19.0,11863,24.0,7437,486,10637
268,2021-09-08,790,424962,219,224736,226,205362,11.0,33931,12.0,35471,24.0,11082,167,174945,10.0,11873,25.0,7462,372,11009
269,2021-09-09,400,425362,177,224913,192,205554,9.0,33940,8.0,35479,21.0,11103,140,175085,14.0,11887,17.0,7479,54,11063
270,2021-09-10,752,426114,340,225253,303,205857,9.0,33949,23.0,35502,26.0,11129,229,175314,20.0,11907,28.0,7507,151,11214
271,2021-09-11,1631,427745,162,225415,207,206064,10.0,33959,19.0,35521,18.0,11147,157,175471,15.0,11922,17.0,7524,1276,12490
272,2021-09-12,229,427974,100,225515,112,206176,1.0,33960,2.0,35523,11.0,11158,71,175542,10.0,11932,20.0,7544,16,12506
273,2021-09-13,491,428465,220,225735,249,206425,9.0,33969,8.0,35531,24.0,11182,187,175729,12.0,11944,26.0,7570,40,12546
274,2021-09-14,843,429308,206,225941,272,206697,13.0,33982,17.0,35548,16.0,11198,219,175948,14.0,11958,23.0,7593,402,12948
275,2021-09-15,827,430135,190,226131,266,206963,15.0,33997,15.0,35563,21.0,11219,196,176144,16.0,11974,33.0,7626,396,13344
276,2021-09-16,359,430494,136,226267,195,207158,9.0,34006,8.0,35571,33.0,11252,139,176283,11.0,11985,12.0,7638,43,13387
277,2021-09-17,745,431239,282,226549,388,207546,13.0,34019,13.0,35584,29.0,11281,289,176572,39.0,12024,31.0,7669,123,13510
278,2021-09-18,1842,433081,130,226679,172,207718,7.0,34026,20.0,35604,10.0,11291,127,176699,15.0,12039,20.0,7689,1547,15057
279,2021-09-19,183,433264,75,226754,107,207825,3.0,34029,2.0,35606,6.0,11297,82,176781,6.0,12045,13.0,7702,12,15069
280,2021-09-20,385,433649,143,226897,218,208043,8.0,34037,9.0,35615,26.0,11323,163,176944,10.0,12055,19.0,7721,54,15123
281,2021-09-21,763,434412,164,227061,192,208235,9.0,34046,14.0,35629,21.0,11344,147,177091,8.0,12063,16.0,7737,423,15546
282,2021-09-22,716,435128,162,227223,228,208463,6.0,34052,12.0,35641,15.0,11359,179,177270,16.0,12079,18.0,7755,364,15910
283,2021-09-23,346,435474,142,227365,179,208642,8.0,34060,3.0,35644,9.0,11368,132,177402,12.0,12091,26.0,7781,48,15958
284,2021-09-24,696,436170,208,227573,275,208917,17.0,34077,16.0,35660,20.0,11388,218,177620,11.0,12102,26.0,7807,234,16192
285,2021-09-25,1735,437905,139,227712,173,209090,12.0,34089,21.0,35681,15.0,11403,135,177755,12.0,12114,11.0,7818,1429,17621
286,2021-09-26,267,438172,68,227780,89,209179,3.0,34092,3.0,35684,11.0,11414,67,177822,4.0,12118,7.0,7825,109,17730
287,2021-09-27,566,438738,157,227937,125,209304,7.0,34099,11.0,35695,7.0,11421,96,177918,8.0,12126,14.0,7839,301,18031
288,2021-09-28,1128,439866,157,228094,203,209507,20.0,34119,23.0,35718,15.0,11436,153,178071,9.0,12135,26.0,7865,790,18821
289,2021-09-29,1139,441005,175,228269,173,209680,13.0,34132,19.0,35737,15.0,11451,129,178200,7.0,12142,22.0,7887,808,19629
290,2021-09-30,703,441708,159,228428,168,209848,15.0,34147,7.0,35744,11.0,11462,128,178328,10.0,12152,19.0,7906,407,20036
291,2021-10-01,1043,442751,174,228602,301,210149,19.0,34166,16.0,35760,20.0,11482,237,178565,21.0,12173,23.0,7929,587,20623
292,2021-10-02,1815,444566,120,228722,115,210264,13.0,34179,14.0,35774,8.0,11490,97,178662,5.0,12178,5.0,7934,1588,22211
293,2021-10-03,389,444955,64,228786,112,210376,1.0,34180,2.0,35776,18.0,11508,76,178738,7.0,12185,11.0,7945,225,22436
294,2021-10-04,791,445746,113,228899,155,210531,7.0,34187,12.0,35788,26.0,11534,102,178840,14.0,12199,13.0,7958,530,22966
295,2021-10-05,1108,446854,140,229039,133,210664,12.0,34199,17.0,35805,13.0,11547,101,178941,5.0,12204,14.0,7972,847,23813
296,2021-10-06,994,447848,106,229145,154,210818,8.0,34207,15.0,35820,11.0,11558,122,179063,5.0,12209,16.0,7988,750,24563
297,2021-10-07,776,448624,133,229278,107,210925,8.0,34215,14.0,35834,9.0,11567,83,179146,5.0,12214,10.0,7998,557,25120
298,2021-10-08,1032,449656,159,229437,240,211165,19.0,34234,13.0,35847,20.0,11587,187,179333,11.0,12225,22.0,8020,644,25764
299,2021-10-09,1678,451334,107,229544,134,211299,11.0,34245,8.0,35855,22.0,11609,100,179433,4.0,12229,8.0,8028,1441,27205
300,2021-10-10,241,451575,50,229594,63,211362,2.0,34247,2.0,35857,4.0,11613,48,179481,5.0,12234,6.0,8034,129,27334
301,2021-10-11,813,452388,119,229713,134,211496,16.0,34263,18.0,35875,3.0,11616,110,179591,10.0,12244,11.0,8045,571,27905
302,2021-10-12,1025,453413,120,229833,135,211631,8.0,34271,20.0,35895,16.0,11632,105,179696,5.0,12249,9.0,8054,783,28688
303,2021-10-13,970,454383,119,229952,149,211780,15.0,34286,8.0,35903,15.0,11647,113,179809,12.0,12261,9.0,8063,722,29410
304,2021-10-14,707,455090,101,230053,129,211909,15.0,34301,9.0,35912,20.0,11667,96,179905,8.0,12269,5.0,8068,486,29896
305,2021-10-15,1020,456110,172,230225,216,212125,11.0,34312,7.0,35919,15.0,11682,170,180075,13.0,12282,18.0,8086,664,30560
306,2021-10-16,805,456915,66,230291,81,212206,4.0,34316,3.0,35922,6.0,11688,70,180145,2.0,12284,3.0,8089,658,31218
307,2021-10-17,198,457113,48,230339,65,212271,1.0,34317,2.0,35924,5.0,11693,47,180192,3.0,12287,10.0,8099,83,31301
308,2021-10-18,647,457760,115,230454,137,212408,9.0,34326,5.0,35929,13.0,11706,108,180300,6.0,12293,10.0,8109,410,31711
309,2021-10-19,1043,458803,123,230577,133,212541,4.0,34330,12.0,35941,8.0,11714,106,180406,8.0,12301,11.0,8120,798,32509
310,2021-10-20,891,459694,122,230699,122,212663,6.0,34336,11.0,35952,10.0,11724,91,180497,7.0,12308,14.0,8134,664,33173
311,2021-10-21,533,460227,108,230807,129,212792,9.0,34345,8.0,35960,14.0,11738,87,180584,11.0,12319,17.0,8151,319,33492
312,2021-10-22,1465,461692,199,231006,229,213021,10.0,34355,13.0,35973,21.0,11759,169,180753,14.0,12333,25.0,8176,1060,34552
313,2021-10-23,1880,463572,91,231097,195,213216,14.0,34369,15.0,35988,4.0,11763,170,180923,11.0,12344,10.0,8186,1599,36151
314,2021-10-24,564,464136,82,231179,153,213369,8.0,34377,11.0,35999,12.0,11775,128,181051,7.0,12351,6.0,8192,343,36494
315,2021-10-25,1364,465500,137,231316,298,213667,26.0,34403,17.0,36016,12.0,11787,254,181305,20.0,12371,12.0,8204,946,37440
316,2021-10-26,2117,467617,181,231497,298,213965,15.0,34418,18.0,36034,19.0,11806,246,181551,19.0,12390,14.0,8218,1652,39092
317,2021-10-27,1965,469582,158,231655,271,214236,19.0,34437,20.0,36054,9.0,11815,238,181789,14.0,12404,10.0,8228,1546,40638
318,2021-10-28,1702,471284,141,231796,264,214500,10.0,34447,20.0,36074,11.0,11826,223,182012,17.0,12421,13.0,8241,1309,41947
319,2021-10-29,1646,472930,184,231980,279,214779,12.0,34459,14.0,36088,10.0,11836,244,182256,12.0,12433,13.0,8254,1197,43144
320,2021-10-30,1586,474516,82,232062,150,214929,13.0,34472,8.0,36096,6.0,11842,130,182386,9.0,12442,5.0,8259,1364,44508
321,2021-10-31,462,474978,46,232108,75,215004,3.0,34475,5.0,36101,6.0,11848,63,182449,4.0,12446,2.0,8261,340,44848
322,2021-11-01,1218,476196,139,232247,210,215214,8.0,34483,11.0,36112,10.0,11858,169,182618,12.0,12458,19.0,8280,883,45731
323,2021-11-02,1808,478004,133,232380,199,215413,8.0,34491,16.0,36128,13.0,11871,162,182780,13.0,12471,11.0,8291,1492,47223
324,2021-11-03,1737,479741,158,232538,233,215646,12.0,34503,17.0,36145,15.0,11886,185,182965,16.0,12487,17.0,8308,1366,48589
325,2021-11-04,1402,481143,146,232684,184,215830,4.0,34507,15.0,36160,1.0,11887,159,183124,12.0,12499,12.0,8320,1098,49687
326,2021-11-05,2005,483148,230,232914,297,216127,14.0,34521,13.0,36173,18.0,11905,247,183371,14.0,12513,18.0,8338,1511,51198
327,2021-11-06,1572,484720,217,233131,139,216266,3.0,34524,9.0,36182,6.0,11911,112,183483,15.0,12528,6.0,8344,1224,52422
328,2021-11-07,521,485241,117,233248,79,216345,1.0,34525,8.0,36190,5.0,11916,65,183548,3.0,12531,6.0,8350,326,52748
329,2021-11-08,1503,486744,382,233630,195,216540,7.0,34532,9.0,36199,11.0,11927,161,183709,9.0,12540,14.0,8364,945,53693
330,2021-11-09,2612,489356,943,234573,222,216762,10.0,34542,22.0,36221,15.0,11942,163,183872,16.0,12556,28.0,8392,1466,55159
331,2021-11-10,2462,491818,810,235383,222,216984,12.0,34554,18.0,36239,11.0,11953,176,184048,22.0,12578,13.0,8405,1453,56612
332,2021-11-11,2314,494132,950,236333,190,217174,17.0,34571,8.0,36247,15.0,11968,154,184202,13.0,12591,8.0,8413,1198,57810
333,2021-11-12,2524,496656,751,237084,241,217415,13.0,34584,19.0,36266,23.0,11991,191,184393,14.0,12605,13.0,8426,1545,59355
334,2021-11-13,1892,498548,382,237466,139,217554,3.0,34587,14.0,36280,7.0,11998,103,184496,15.0,12620,14.0,8440,1381,60736
335,2021-11-14,1484,500032,914,238380,108,217662,1.0,34588,2.0,36282,12.0,12010,72,184568,14.0,12634,10.0,8450,472,61208
336,2021-11-15,1944,501976,459,238839,198,217860,7.0,34595,11.0,36293,12.0,12022,158,184726,12.0,12646,16.0,8466,1309,62517
337,2021-11-16,2385,504361,449,239288,212,218072,5.0,34600,21.0,36314,26.0,12048,155,184881,17.0,12663,14.0,8480,1739,64256
338,2021-11-17,2689,507050,635,239923,271,218343,12.0,34612,17.0,36331,16.0,12064,224,185105,17.0,12680,14.0,8494,1815,66071
339,2021-11-18,1860,508910,377,240300,175,218518,7.0,34619,10.0,36341,16.0,12080,140,185245,15.0,12695,4.0,8498,1322,67393
340,2021-11-19,2526,511436,715,241015,281,218799,13.0,34632,14.0,36355,9.0,12089,235,185480,20.0,12715,17.0,8515,1552,68945
341,2021-11-20,1825,513261,492,241507,109,218908,5.0,34637,5.0,36360,8.0,12097,92,185572,4.0,12719,5.0,8520,1227,70172
342,2021-11-21,543,513804,112,241619,77,218985,0.0,34637,1.0,36361,3.0,12100,62,185634,7.0,12726,5.0,8525,356,70528
343,2021-11-22,1891,515695,414,242033,199,219184,11.0,34648,22.0,36383,10.0,12110,163,185797,10.0,12736,16.0,8541,1293,71821
344,2021-11-23,1801,517496,276,242309,181,219365,8.0,34656,15.0,36398,14.0,12124,147,185944,14.0,12750,6.0,8547,1354,73175
345,2021-11-24,1494,518990,216,242525,160,219525,6.0,34662,11.0,36409,14.0,12138,129,186073,11.0,12761,6.0,8553,1133,74308
346,2021-11-25,46,519036,9,242534,2,219527,0.0,34662,0.0,36409,0.0,12138,1,186074,1.0,12762,,8553,35,74343
347,2021-11-26,1238,520274,195,242729,198,219725,3.0,34665,4.0,36413,17.0,12155,160,186234,12.0,12774,9.0,8562,864,75207
348,2021-11-27,945,521219,140,242869,152,219877,2.0,34667,2.0,36415,7.0,12162,130,186364,8.0,12782,7.0,8569,655,75862
349,2021-11-28,535,521754,100,242969,101,219978,2.0,34669,2.0,36417,9.0,12171,80,186444,5.0,12787,7.0,8576,340,76202
350,2021-11-29,1743,523497,221,243190,365,220343,8.0,34677,14.0,36431,32.0,12203,296,186740,21.0,12808,16.0,8592,1167,77369
351,2021-11-30,2593,526090,350,243540,778,221121,8.0,34685,15.0,36446,49.0,12252,657,187397,61.0,12869,11.0,8603,1485,78854
352,2021-12-01,2384,528474,255,243795,729,221850,12.0,34697,9.0,36455,27.0,12279,643,188040,56.0,12925,3.0,8606,1411,80265
353,2021-12-02,2299,530773,261,244056,763,222613,8.0,34705,8.0,36463,40.0,12319,637,188677,62.0,12987,24.0,8630,1294,81559
354,2021-12-03,2415,533188,265,244321,692,223305,11.0,34716,5.0,36468,57.0,12376,541,189218,67.0,13054,27.0,8657,1471,83030
355,2021-12-04,1964,535152,113,244434,349,223654,3.0,34719,1.0,36469,13.0,12389,289,189507,27.0,13081,20.0,8677,1508,84538
356,2021-12-05,1230,536382,79,244513,806,224460,1.0,34720,0.0,36469,61.0,12450,643,190150,68.0,13149,34.0,8711,350,84888
357,2021-12-06,1527,537909,154,244667,301,224761,7.0,34727,4.0,36473,27.0,12477,242,190392,24.0,13173,8.0,8719,1083,85971
358,2021-12-07,1861,539770,189,244856,298,225059,10.0,34737,7.0,36480,23.0,12500,241,190633,23.0,13196,11.0,8730,1386,87357
359,2021-12-08,2213,541983,275,245131,506,225565,9.0,34746,11.0,36491,28.0,12528,424,191057,40.0,13236,14.0,8744,1453,88810
360,2021-12-09,1613,543596,200,245331,286,225851,6.0,34752,6.0,36497,13.0,12541,227,191284,32.0,13268,14.0,8758,1134,89944
361,2021-12-10,1969,545565,219,245550,380,226231,9.0,34761,10.0,36507,35.0,12576,294,191578,32.0,13300,19.0,8777,1379,91323
362,2021-12-11,1567,547132,105,245655,417,226648,5.0,34766,3.0,36510,42.0,12618,325,191903,31.0,13331,19.0,8796,1046,92369
363,2021-12-12,391,547523,53,245708,80,226728,1.0,34767,3.0,36513,2.0,12620,66,191969,7.0,13338,5.0,8801,260,92629
364,2021-12-13,1402,548925,226,245934,283,227011,9.0,34776,10.0,36523,16.0,12636,239,192208,21.0,13359,7.0,8808,909,93538
365,2021-12-14,1595,550520,158,246092,260,227271,8.0,34784,5.0,36528,24.0,12660,212,192420,13.0,13372,11.0,8819,1197,94735
366,2021-12-15,1572,552092,191,246283,206,227477,6.0,34790,3.0,36531,9.0,12669,170,192590,15.0,13387,12.0,8831,1186,95921
367,2021-12-16,1233,553325,188,246471,144,227621,5.0,34795,6.0,36537,10.0,12679,116,192706,13.0,13400,5.0,8836,915,96836
368,2021-12-17,1841,555166,268,246739,410,228031,5.0,34800,10.0,36547,26.0,12705,340,193046,33.0,13433,11.0,8847,1174,98010
369,2021-12-18,1555,556721,131,246870,187,228218,4.0,34804,4.0,36551,13.0,12718,158,193204,8.0,13441,8.0,8855,1238,99248
370,2021-12-19,415,557136,41,246911,77,228295,1.0,34805,3.0,36554,5.0,12723,64,193268,2.0,13443,6.0,8861,297,99545
371,2021-12-20,635,557771,73,246984,98,228393,3.0,34808,7.0,36561,17.0,12740,72,193340,6.0,13449,3.0,8864,466,100011
