,Date,daily number of doses received by Larimer County residents,total number of doses recevied by residents,daily number of residents receiving first dose,total number of residents receiving first dose,daily number of residents vaccinated,total number of residents vaccinated,daily number of 70+ vaccinated,total number of 70+ vaccinated,daily number of 70+ at least one dose,total number of 70+ at least one dose,daily number of Latinx residents vaccinated,total of Latinx residents vaccinated,daily number of White non-Latinx residents vaccinated,total of White non-Latinx residents vaccinated,daily number of non-White non-Latinx residents vaccinated,total of non-White non-Latinx residents vaccinated,dailyUnknown,totalUnknown,daily_additional_doses,total_additional_doses,daily_second_booster ,total_second_boosters
0,12/14/2020,31,31,31,31,0,0,0.0,0,1.0,1,0.0,0,0,0,0.0,0,,0,0,0,0,0
1,12/15/2020,15,46,15,46,0,0,,0,,1,,0,0,0,0.0,0,,0,0,0,0,0
2,12/16/2020,308,354,308,354,0,0,0.0,0,1.0,2,0.0,0,0,0,0.0,0,0.0,0,0,0,0,0
3,12/17/2020,988,1342,988,1342,0,0,0.0,0,11.0,13,0.0,0,0,0,0.0,0,0.0,0,0,0,0,0
4,12/18/2020,1058,2400,1058,2400,0,0,0.0,0,15.0,28,0.0,0,0,0,0.0,0,0.0,0,0,0,0,0
5,12/19/2020,722,3122,722,3122,0,0,0.0,0,13.0,41,0.0,0,0,0,0.0,0,0.0,0,0,0,0,0
6,12/20/2020,266,3388,266,3388,0,0,0.0,0,4.0,45,0.0,0,0,0,0.0,0,0.0,0,0,0,0,0
7,12/21/2020,358,3746,358,3746,0,0,0.0,0,3.0,48,0.0,0,0,0,0.0,0,0.0,0,0,0,0,0
8,12/22/2020,358,4104,358,4104,0,0,0.0,0,7.0,55,0.0,0,0,0,0.0,0,0.0,0,0,0,0,0
9,12/23/2020,449,4553,449,4553,0,0,0.0,0,7.0,62,0.0,0,0,0,0.0,0,0.0,0,0,0,0,0
10,12/24/2020,107,4660,107,4660,0,0,0.0,0,3.0,65,0.0,0,0,0,0.0,0,0.0,0,0,0,0,0
11,12/25/2020,1,4661,1,4661,0,0,,0,,65,,0,0,0,,0,,0,0,0,0,0
12,12/26/2020,231,4892,231,4892,0,0,0.0,0,3.0,68,0.0,0,0,0,0.0,0,0.0,0,0,0,0,0
13,12/27/2020,277,5169,277,5169,0,0,0.0,0,195.0,263,0.0,0,0,0,0.0,0,,0,0,0,0,0
14,12/28/2020,721,5890,721,5890,0,0,0.0,0,388.0,651,0.0,0,0,0,0.0,0,0.0,0,0,0,0,0
15,12/29/2020,908,6798,907,6797,1,1,0.0,0,456.0,1107,0.0,0,1,1,0.0,0,0.0,0,0,0,0,0
16,12/30/2020,888,7686,887,7684,1,2,0.0,0,269.0,1376,0.0,0,1,2,0.0,0,0.0,0,0,0,0,0
17,12/31/2020,906,8592,904,8588,3,5,1.0,1,342.0,1718,0.0,0,3,5,0.0,0,0.0,0,0,0,0,0
18,1/1/2021,6,8598,5,8593,2,7,,1,,1718,,0,2,7,,0,,0,0,0,0,0
19,1/2/2021,387,8985,387,8980,0,7,0.0,1,139.0,1857,0.0,0,0,7,0.0,0,0.0,0,0,0,0,0
20,1/3/2021,131,9116,130,9110,2,9,0.0,1,58.0,1915,0.0,0,2,9,0.0,0,0.0,0,0,0,0,0
21,1/4/2021,594,9710,579,9689,15,24,0.0,1,317.0,2232,0.0,0,12,21,2.0,2,1.0,1,0,0,0,0
22,1/5/2021,646,10356,634,10323,12,36,0.0,1,405.0,2637,0.0,0,12,33,0.0,2,0.0,1,0,0,0,0
23,1/6/2021,1256,11612,938,11261,317,353,3.0,4,533.0,3170,18.0,18,278,311,17.0,19,4.0,5,1,1,0,0
24,1/7/2021,1670,13282,711,11972,958,1311,12.0,16,410.0,3580,34.0,52,866,1177,43.0,62,15.0,20,1,2,0,0
25,1/8/2021,2002,15284,993,12965,1008,2319,12.0,28,489.0,4069,48.0,100,897,2074,43.0,105,20.0,40,1,3,0,0
26,1/9/2021,1238,16522,544,13509,694,3013,16.0,44,311.0,4380,17.0,117,628,2702,35.0,140,14.0,54,0,3,0,0
27,1/10/2021,709,17231,432,13941,277,3290,4.0,48,265.0,4645,10.0,127,251,2953,13.0,153,3.0,57,0,3,0,0
28,1/11/2021,1145,18376,796,14737,349,3639,1.0,49,535.0,5180,10.0,137,316,3269,19.0,172,4.0,61,0,3,0,0
29,1/12/2021,1176,19552,877,15614,299,3938,8.0,57,513.0,5693,15.0,152,258,3527,18.0,190,8.0,69,0,3,0,0
30,1/13/2021,1076,20628,831,16445,245,4183,1.0,58,372.0,6065,23.0,175,199,3726,15.0,205,8.0,77,0,3,0,0
31,1/14/2021,871,21499,835,17280,36,4219,1.0,59,496.0,6561,2.0,177,32,3758,1.0,206,1.0,78,0,3,0,0
32,1/15/2021,1222,22721,1206,18486,16,4235,0.0,59,757.0,7318,0.0,177,16,3774,0.0,206,0.0,78,0,3,0,0
33,1/16/2021,981,23702,967,19453,14,4249,1.0,60,580.0,7898,0.0,177,13,3787,1.0,207,0.0,78,0,3,0,0
34,1/17/2021,62,23764,56,19509,6,4255,0.0,60,21.0,7919,0.0,177,4,3791,2.0,209,0.0,78,0,3,0,0
35,1/18/2021,1024,24788,816,20325,205,4460,49.0,109,597.0,8516,8.0,185,178,3969,13.0,222,6.0,84,3,6,0,0
36,1/19/2021,1258,26046,1112,21437,143,4603,9.0,118,728.0,9244,7.0,192,123,4092,6.0,228,7.0,91,2,8,1,1
37,1/20/2021,1432,27478,1210,22647,220,4823,18.0,136,571.0,9815,14.0,206,180,4272,9.0,237,17.0,108,1,9,1,2
38,1/21/2021,2267,29745,2048,24695,218,5041,10.0,146,1587.0,11402,14.0,220,182,4454,15.0,252,7.0,115,3,12,0,2
39,1/22/2021,1743,31488,1458,26153,285,5326,98.0,244,1089.0,12491,34.0,254,231,4685,13.0,265,7.0,122,0,12,0,2
40,1/23/2021,909,32397,574,26727,335,5661,57.0,301,427.0,12918,9.0,263,306,4991,13.0,278,7.0,129,0,12,0,2
41,1/24/2021,388,32785,102,26829,286,5947,207.0,508,60.0,12978,8.0,271,269,5260,9.0,287,,129,0,12,0,2
42,1/25/2021,1414,34199,790,27619,620,6567,372.0,880,552.0,13530,14.0,285,581,5841,16.0,303,9.0,138,4,16,0,2
43,1/26/2021,1625,35824,698,28317,924,7491,459.0,1339,438.0,13968,30.0,315,845,6686,38.0,341,11.0,149,2,18,1,3
44,1/27/2021,1851,37675,776,29093,1074,8565,537.0,1876,338.0,14306,41.0,356,977,7663,47.0,388,9.0,158,1,19,0,3
45,1/28/2021,1355,39030,550,29643,804,9369,353.0,2229,301.0,14607,25.0,381,739,8402,27.0,415,13.0,171,1,20,0,3
46,1/29/2021,1654,40684,1165,30808,486,9855,169.0,2398,828.0,15435,22.0,403,421,8823,33.0,448,10.0,181,3,23,0,3
47,1/30/2021,1221,41905,730,31538,489,10344,210.0,2608,595.0,16030,24.0,427,440,9263,19.0,467,6.0,187,2,25,0,3
48,1/31/2021,658,42563,427,31965,227,10571,77.0,2685,367.0,16397,5.0,432,201,9464,15.0,482,6.0,193,3,28,1,4
49,2/1/2021,1673,44236,956,32921,712,11283,467.0,3152,666.0,17063,19.0,451,655,10119,27.0,509,11.0,204,7,35,0,4
50,2/2/2021,1865,46101,733,33654,1132,12415,735.0,3887,579.0,17642,44.0,495,1043,11162,35.0,544,10.0,214,0,35,0,4
51,2/3/2021,1278,47379,595,34249,684,13099,323.0,4210,231.0,17873,47.0,542,583,11745,45.0,589,9.0,223,0,35,0,4
52,2/4/2021,2534,49913,1786,36035,747,13846,500.0,4710,1540.0,19413,31.0,573,669,12414,38.0,627,9.0,232,1,36,0,4
53,2/5/2021,2576,52489,1529,37564,1042,14888,684.0,5394,1304.0,20717,38.0,611,954,13368,31.0,658,19.0,251,6,42,0,4
54,2/6/2021,2225,54714,1601,39165,624,15512,451.0,5845,1236.0,21953,11.0,622,583,13951,22.0,680,8.0,259,0,42,0,4
55,2/7/2021,240,54954,91,39256,146,15658,99.0,5944,29.0,21982,7.0,629,131,14082,4.0,684,4.0,263,3,45,0,4
56,2/8/2021,2463,57417,1582,40838,882,16540,598.0,6542,1129.0,23111,26.0,655,812,14894,27.0,711,17.0,280,0,45,0,4
57,2/9/2021,2386,59803,1532,42370,853,17393,520.0,7062,987.0,24098,26.0,681,768,15662,38.0,749,21.0,301,2,47,0,4
58,2/10/2021,1594,61397,970,43340,615,18008,314.0,7376,288.0,24386,25.0,706,548,16210,27.0,776,15.0,316,9,56,0,4
59,2/11/2021,3528,64925,2000,45340,1527,19535,1052.0,8428,806.0,25192,55.0,761,1394,17604,53.0,829,25.0,341,3,59,0,4
60,2/12/2021,3279,68204,1822,47162,1453,20988,962.0,9390,800.0,25992,60.0,821,1336,18940,44.0,873,13.0,354,4,63,0,4
61,2/13/2021,3000,71204,2366,49528,632,21620,310.0,9700,673.0,26665,14.0,835,580,19520,26.0,899,12.0,366,2,65,0,4
62,2/14/2021,422,71626,347,49875,74,21694,51.0,9751,44.0,26709,2.0,837,67,19587,3.0,902,2.0,368,1,66,0,4
63,2/15/2021,2624,74250,2127,52002,496,22190,320.0,10071,258.0,26967,18.0,855,463,20050,12.0,914,3.0,371,1,67,0,4
64,2/16/2021,2750,77000,1911,53913,838,23028,495.0,10566,230.0,27197,36.0,891,763,20813,22.0,936,17.0,388,1,68,0,4
65,2/17/2021,1632,78632,650,54563,978,24006,480.0,11046,153.0,27350,31.0,922,891,21704,37.0,973,19.0,407,4,72,0,4
66,2/18/2021,2644,81276,1677,56240,963,24969,735.0,11781,276.0,27626,37.0,959,889,22593,31.0,1004,6.0,413,4,76,0,4
67,2/19/2021,2433,83709,1037,57277,1392,26361,1029.0,12810,161.0,27787,43.0,1002,1289,23882,46.0,1050,14.0,427,4,80,0,4
68,2/20/2021,1655,85364,681,57958,972,27333,792.0,13602,130.0,27917,23.0,1025,911,24793,28.0,1078,10.0,437,2,82,0,4
69,2/21/2021,117,85481,43,58001,72,27405,40.0,13642,8.0,27925,1.0,1026,68,24861,2.0,1080,1.0,438,2,84,0,4
70,2/22/2021,2036,87517,764,58765,1268,28673,931.0,14573,148.0,28073,38.0,1064,1179,26040,41.0,1121,10.0,448,4,88,0,4
71,2/23/2021,1228,88745,521,59286,706,29379,469.0,15042,160.0,28233,21.0,1085,635,26675,37.0,1158,13.0,461,1,89,0,4
72,2/24/2021,1424,90169,759,60045,663,30042,281.0,15323,140.0,28373,29.0,1114,611,27286,19.0,1177,4.0,465,2,91,0,4
73,2/25/2021,3872,94041,2071,62116,1798,31840,1505.0,16828,352.0,28725,49.0,1163,1695,28981,38.0,1215,16.0,481,2,93,1,5
74,2/26/2021,3273,97314,1157,63273,2113,33953,1742.0,18570,199.0,28924,33.0,1196,1992,30973,58.0,1273,30.0,511,3,96,0,5
75,2/27/2021,3494,100808,1665,64938,1825,35778,1558.0,20128,546.0,29470,35.0,1231,1704,32677,56.0,1329,30.0,541,4,100,0,5
76,2/28/2021,431,101239,358,65296,70,35848,43.0,20171,116.0,29586,2.0,1233,65,32742,1.0,1330,2.0,543,3,103,0,5
77,3/1/2021,2973,104212,1476,66772,1501,37349,1078.0,21249,300.0,29886,56.0,1289,1388,34130,46.0,1376,11.0,554,14,117,0,5
78,3/2/2021,3252,107464,1729,68501,1521,38870,1044.0,22293,384.0,30270,37.0,1326,1414,35544,43.0,1419,27.0,581,2,119,0,5
79,3/3/2021,1668,109132,1096,69597,576,39446,176.0,22469,207.0,30477,33.0,1359,513,36057,25.0,1444,5.0,586,0,119,0,5
80,3/4/2021,3020,112152,1593,71190,1460,40906,822.0,23291,172.0,30649,44.0,1403,1338,37395,58.0,1502,20.0,606,2,121,0,5
81,3/5/2021,3500,115652,2067,73257,1478,42384,823.0,24114,425.0,31074,42.0,1445,1369,38764,42.0,1544,25.0,631,3,124,0,5
82,3/6/2021,4120,119772,2335,75592,2706,45090,863.0,24977,270.0,31344,172.0,1617,2373,41137,126.0,1670,35.0,666,3,127,0,5
83,3/7/2021,428,120200,313,75905,151,45241,37.0,25014,23.0,31367,4.0,1621,142,41279,2.0,1672,3.0,669,0,127,0,5
84,3/8/2021,2825,123025,1064,76969,1918,47159,274.0,25288,75.0,31442,54.0,1675,1776,43055,65.0,1737,23.0,692,3,130,0,5
85,3/9/2021,3206,126231,1663,78632,1647,48806,265.0,25553,95.0,31537,54.0,1729,1498,44553,70.0,1807,25.0,717,13,143,0,5
86,3/10/2021,2403,128634,1386,80018,1099,49905,308.0,25861,86.0,31623,56.0,1785,992,45545,34.0,1841,17.0,734,3,146,0,5
87,3/11/2021,4188,132822,2384,82402,1909,51814,402.0,26263,134.0,31757,64.0,1849,1758,47303,68.0,1909,19.0,753,6,152,0,5
88,3/12/2021,3963,136785,2579,84981,1486,53300,206.0,26469,67.0,31824,94.0,1943,1302,48605,59.0,1968,31.0,784,7,159,0,5
89,3/13/2021,220,137005,135,85116,136,53436,22.0,26491,6.0,31830,1.0,1944,128,48733,5.0,1973,2.0,786,1,160,0,5
90,3/14/2021,103,137108,61,85177,42,53478,9.0,26500,0.0,31830,1.0,1945,39,48772,1.0,1974,1.0,787,1,161,0,5
91,3/15/2021,921,138029,376,85553,569,54047,90.0,26590,15.0,31845,20.0,1965,523,49295,17.0,1991,9.0,796,3,164,0,5
92,3/16/2021,3304,141333,2125,87678,1224,55271,229.0,26819,47.0,31892,69.0,2034,1092,50387,45.0,2036,18.0,814,1,165,0,5
93,3/17/2021,2918,144251,1786,89464,1182,56453,237.0,27056,87.0,31979,41.0,2075,1082,51469,41.0,2077,18.0,832,8,173,0,5
94,3/18/2021,4023,148274,2087,91551,1958,58411,341.0,27397,90.0,32069,99.0,2174,1774,53243,65.0,2142,20.0,852,15,188,0,5
95,3/19/2021,3016,151290,1747,93298,1282,59693,223.0,27620,43.0,32112,64.0,2238,1153,54396,46.0,2188,19.0,871,14,202,1,6
96,3/20/2021,3083,154373,1963,95261,1163,60856,316.0,27936,52.0,32164,37.0,2275,1042,55438,61.0,2249,23.0,894,7,209,0,6
97,3/21/2021,679,155052,405,95666,291,61147,27.0,27963,5.0,32169,13.0,2288,257,55695,18.0,2267,3.0,897,6,215,0,6
98,3/22/2021,3123,158175,2249,97915,897,62044,192.0,28155,57.0,32226,19.0,2307,827,56522,38.0,2305,13.0,910,9,224,0,6
99,3/23/2021,4468,162643,3571,101486,1753,63797,201.0,28356,75.0,32301,67.0,2374,1527,58049,107.0,2412,52.0,962,3,227,0,6
100,3/24/2021,3173,165816,2430,103916,799,64596,122.0,28478,37.0,32338,46.0,2420,706,58755,29.0,2441,18.0,980,7,234,0,6
101,3/25/2021,5071,170887,3044,106960,2042,66638,313.0,28791,69.0,32407,67.0,2487,1866,60621,74.0,2515,35.0,1015,11,245,3,9
102,3/26/2021,4596,175483,2721,109681,1908,68546,328.0,29119,66.0,32473,122.0,2609,1640,62261,114.0,2629,32.0,1047,12,257,0,9
103,3/27/2021,3353,178836,1908,111589,1447,69993,330.0,29449,20.0,32493,49.0,2658,1330,63591,48.0,2677,20.0,1067,5,262,0,9
104,3/28/2021,1192,180028,827,112416,367,70360,94.0,29543,17.0,32510,12.0,2670,338,63929,15.0,2692,2.0,1069,1,263,0,9
105,3/29/2021,4008,184036,2697,115113,1329,71689,233.0,29776,53.0,32563,42.0,2712,1243,65172,32.0,2724,12.0,1081,4,267,0,9
106,3/30/2021,4374,188410,2743,117856,1712,73401,248.0,30024,74.0,32637,57.0,2769,1557,66729,77.0,2801,21.0,1102,7,274,0,9
107,3/31/2021,3612,192022,2575,120431,1103,74504,173.0,30197,47.0,32684,46.0,2815,982,67711,52.0,2853,23.0,1125,8,282,0,9
108,4/1/2021,5190,197212,3369,123800,1863,76367,153.0,30350,78.0,32762,77.0,2892,1697,69408,67.0,2920,22.0,1147,25,307,1,10
109,4/2/2021,4727,201939,2526,126326,2243,78610,244.0,30594,51.0,32813,82.0,2974,2035,71443,96.0,3016,30.0,1177,6,313,1,11
110,4/3/2021,4281,206220,3528,129854,869,79479,99.0,30693,41.0,32854,38.0,3012,776,72219,36.0,3052,19.0,1196,6,319,0,11
111,4/4/2021,387,206607,268,130122,172,79651,6.0,30699,7.0,32861,3.0,3015,154,72373,13.0,3065,2.0,1198,2,321,0,11
112,4/5/2021,4728,211335,3783,133905,1085,80736,78.0,30777,46.0,32907,71.0,3086,936,73309,55.0,3120,23.0,1221,3,324,0,11
113,4/6/2021,5189,216524,3046,136951,2665,83401,92.0,30869,62.0,32969,91.0,3177,2339,75648,171.0,3291,64.0,1285,12,336,1,12
114,4/7/2021,5001,221525,3690,140641,3521,86922,83.0,30952,109.0,33078,155.0,3332,3026,78674,249.0,3540,91.0,1376,13,349,0,12
115,4/8/2021,6701,228226,4510,145151,4009,90931,165.0,31117,121.0,33199,170.0,3502,3530,82204,219.0,3759,90.0,1466,18,367,0,12
116,4/9/2021,5738,233964,3282,148433,4185,95116,95.0,31212,69.0,33268,196.0,3698,3643,85847,243.0,4002,103.0,1569,14,381,2,14
117,4/10/2021,4449,238413,3176,151609,2372,97488,70.0,31282,70.0,33338,131.0,3829,2009,87856,165.0,4167,67.0,1636,5,386,0,14
118,4/11/2021,1050,239463,799,152408,364,97852,7.0,31289,11.0,33349,16.0,3845,298,88154,38.0,4205,12.0,1648,0,386,0,14
119,4/12/2021,5048,244511,3630,156038,2671,100523,98.0,31387,97.0,33446,102.0,3947,2325,90479,175.0,4380,69.0,1717,12,398,0,14
120,4/13/2021,5055,249566,3567,159605,1519,102042,58.0,31445,77.0,33523,70.0,4017,1323,91802,101.0,4481,25.0,1742,11,409,0,14
121,4/14/2021,2965,252531,1432,161037,1521,103563,85.0,31530,25.0,33548,93.0,4110,1325,93127,72.0,4553,31.0,1773,12,421,0,14
122,4/15/2021,4960,257491,2327,163364,2618,106181,101.0,31631,61.0,33609,218.0,4328,2176,95303,163.0,4716,61.0,1834,16,437,1,15
123,4/16/2021,3924,261415,2077,165441,1830,108011,45.0,31676,35.0,33644,65.0,4393,1598,96901,131.0,4847,36.0,1870,16,453,1,16
124,4/17/2021,4595,266010,2398,167839,2187,110198,38.0,31714,57.0,33701,104.0,4497,1903,98804,133.0,4980,47.0,1917,10,463,1,17
125,4/18/2021,1057,267067,403,168242,647,110845,14.0,31728,10.0,33711,45.0,4542,539,99343,34.0,5014,29.0,1946,6,469,1,18
126,4/19/2021,3872,270939,1409,169651,2448,113293,44.0,31772,39.0,33750,168.0,4710,2057,101400,165.0,5179,58.0,2004,14,483,1,19
127,4/20/2021,4707,275646,1851,171502,2828,116121,45.0,31817,69.0,33819,159.0,4869,2408,103808,197.0,5376,64.0,2068,24,507,4,23
128,4/21/2021,3212,278858,719,172221,2472,118593,35.0,31852,33.0,33852,150.0,5019,2078,105886,166.0,5542,78.0,2146,23,530,0,23
129,4/22/2021,4661,283519,1775,173996,2866,121459,46.0,31898,62.0,33914,144.0,5163,2461,108347,192.0,5734,69.0,2215,20,550,0,23
130,4/23/2021,3600,287119,1178,175174,2411,123870,41.0,31939,31.0,33945,74.0,5237,2125,110472,131.0,5865,81.0,2296,13,563,0,23
131,4/24/2021,3362,290481,1118,176292,2233,126103,14.0,31953,20.0,33965,107.0,5344,1894,112366,193.0,6058,39.0,2335,11,574,0,23
132,4/25/2021,830,291311,364,176656,464,126567,6.0,31959,8.0,33973,107.0,5451,280,112646,39.0,6097,38.0,2373,3,577,0,23
133,4/26/2021,4375,295686,1109,177765,3256,129823,36.0,31995,30.0,34003,151.0,5602,2799,115445,214.0,6311,92.0,2465,12,589,0,23
134,4/27/2021,3357,299043,1187,178952,2174,131997,41.0,32036,37.0,34040,80.0,5682,1912,117357,139.0,6450,43.0,2508,15,604,1,24
135,4/28/2021,3005,302048,716,179668,2299,134296,45.0,32081,20.0,34060,168.0,5850,1864,119221,202.0,6652,65.0,2573,19,623,1,25
136,4/29/2021,3988,306036,823,180491,3173,137469,72.0,32153,32.0,34092,229.0,6079,2600,121821,234.0,6886,110.0,2683,10,633,0,25
137,4/30/2021,2901,308937,640,181131,2267,139736,50.0,32203,24.0,34116,76.0,6155,1924,123745,204.0,7090,63.0,2746,24,657,0,25
138,5/1/2021,3687,312624,818,181949,2845,142581,36.0,32239,19.0,34135,285.0,6440,2219,125964,203.0,7293,138.0,2884,38,695,1,26
139,5/2/2021,546,313170,239,182188,324,142905,7.0,32246,2.0,34137,12.0,6452,260,126224,42.0,7335,10.0,2894,5,700,0,26
140,5/3/2021,3431,316601,638,182826,2804,145709,48.0,32294,33.0,34170,110.0,6562,2407,128631,215.0,7550,72.0,2966,14,714,0,26
141,5/4/2021,4370,320971,694,183520,3727,149436,72.0,32366,27.0,34197,148.0,6710,3200,131831,261.0,7811,118.0,3084,10,724,3,29
142,5/5/2021,2236,323207,475,183995,1814,151250,63.0,32429,24.0,34221,87.0,6797,1504,133335,145.0,7956,78.0,3162,7,731,2,31
143,5/6/2021,3695,326902,821,184816,3044,154294,101.0,32530,39.0,34260,178.0,6975,2528,135863,200.0,8156,138.0,3300,9,740,5,36
144,5/7/2021,2945,329847,537,185353,2543,156837,45.0,32575,11.0,34271,136.0,7111,2094,137957,213.0,8369,100.0,3400,15,755,1,37
145,5/8/2021,3003,332850,561,185914,2608,159445,47.0,32622,16.0,34287,168.0,7279,2115,140072,194.0,8563,131.0,3531,11,766,0,37
146,5/9/2021,374,333224,141,186055,247,159692,4.0,32626,2.0,34289,11.0,7290,206,140278,21.0,8584,9.0,3540,3,769,0,37
147,5/10/2021,2447,335671,380,186435,2127,161819,65.0,32691,16.0,34305,91.0,7381,1732,142010,205.0,8789,99.0,3639,8,777,3,40
148,5/11/2021,2730,338401,535,186970,2248,164067,95.0,32786,23.0,34328,192.0,7573,1755,143765,205.0,8994,96.0,3735,16,793,1,41
149,5/12/2021,1243,339644,463,187433,865,164932,28.0,32814,14.0,34342,53.0,7626,689,144454,85.0,9079,38.0,3773,6,799,0,41
150,5/13/2021,3269,342913,1032,188465,2267,167199,86.0,32900,25.0,34367,149.0,7775,1849,146303,164.0,9243,105.0,3878,10,809,4,45
151,5/14/2021,2482,345395,1282,189747,1333,168532,58.0,32958,30.0,34397,66.0,7841,1114,147417,100.0,9343,53.0,3931,12,821,2,47
152,5/15/2021,3036,348431,1511,191258,1653,170185,44.0,33002,17.0,34414,118.0,7959,1314,148731,147.0,9490,74.0,4005,6,827,3,50
153,5/16/2021,945,349376,546,191804,443,170628,11.0,33013,5.0,34419,87.0,8046,282,149013,32.0,9522,42.0,4047,1,828,2,52
154,5/17/2021,2438,351814,1207,193011,1329,171957,36.0,33049,27.0,34446,51.0,8097,1112,150125,107.0,9629,59.0,4106,5,833,1,53
155,5/18/2021,2579,354393,1167,194178,1455,173412,45.0,33094,22.0,34468,70.0,8167,1229,151354,83.0,9712,73.0,4179,7,840,4,57
156,5/19/2021,1890,356283,1155,195333,815,174227,28.0,33122,20.0,34488,43.0,8210,662,152016,70.0,9782,40.0,4219,4,844,1,58
157,5/20/2021,1995,358278,934,196267,1118,175345,45.0,33167,28.0,34516,96.0,8306,894,152910,79.0,9861,49.0,4268,9,853,2,60
158,5/21/2021,1655,359933,927,197194,829,176174,21.0,33188,15.0,34531,44.0,8350,662,153572,65.0,9926,58.0,4326,16,869,3,63
159,5/22/2021,1695,361628,796,197990,938,177112,9.0,33197,13.0,34544,123.0,8473,656,154228,76.0,10002,83.0,4409,9,878,3,66
160,5/23/2021,683,362311,341,198331,373,177485,2.0,33199,5.0,34549,67.0,8540,230,154458,21.0,10023,55.0,4464,1,879,0,66
161,5/24/2021,1348,363659,538,198869,883,178368,36.0,33235,20.0,34569,41.0,8581,713,155171,85.0,10108,44.0,4508,12,891,2,68
162,5/25/2021,1233,364892,509,199378,767,179135,25.0,33260,20.0,34589,57.0,8638,579,155750,66.0,10174,65.0,4573,8,899,0,68
163,5/26/2021,967,365859,547,199925,559,179694,20.0,33280,25.0,34614,41.0,8679,441,156191,45.0,10219,32.0,4605,3,902,1,69
164,5/27/2021,1315,367174,671,200596,730,180424,32.0,33312,21.0,34635,58.0,8737,588,156779,54.0,10273,30.0,4635,6,908,1,70
165,5/28/2021,1047,368221,604,201200,505,180929,20.0,33332,22.0,34657,34.0,8771,393,157172,52.0,10325,26.0,4661,10,918,0,70
166,5/29/2021,1021,369242,492,201692,573,181502,19.0,33351,8.0,34665,32.0,8803,456,157628,44.0,10369,41.0,4702,7,925,0,70
167,5/30/2021,333,369575,219,201911,151,181653,5.0,33356,3.0,34668,14.0,8817,109,157737,17.0,10386,11.0,4713,3,928,2,72
168,5/31/2021,342,369917,192,202103,177,181830,8.0,33364,6.0,34674,7.0,8824,147,157884,11.0,10397,12.0,4725,11,939,1,73
169,6/1/2021,1016,370933,408,202511,635,182465,29.0,33393,18.0,34692,51.0,8875,490,158374,47.0,10444,47.0,4772,34,973,1,74
170,6/2/2021,721,371654,369,202880,419,182884,16.0,33409,8.0,34700,35.0,8910,334,158708,24.0,10468,26.0,4798,2,975,1,75
171,6/3/2021,1321,372975,526,203406,861,183745,23.0,33432,12.0,34712,51.0,8961,710,159418,60.0,10528,40.0,4838,4,979,0,75
172,6/4/2021,1503,374478,400,203806,1156,184901,15.0,33447,10.0,34722,71.0,9032,969,160387,69.0,10597,47.0,4885,3,982,1,76
173,6/5/2021,1424,375902,362,204168,1092,185993,12.0,33459,6.0,34728,63.0,9095,891,161278,96.0,10693,42.0,4927,10,992,1,77
174,6/6/2021,562,376464,147,204315,435,186428,5.0,33464,3.0,34731,50.0,9145,344,161622,28.0,10721,13.0,4940,1,993,0,77
175,6/7/2021,1197,377661,340,204655,914,187342,16.0,33480,12.0,34743,67.0,9212,733,162355,82.0,10803,32.0,4972,7,1000,1,78
176,6/8/2021,1093,378754,251,204906,872,188214,18.0,33498,5.0,34748,59.0,9271,709,163064,71.0,10874,33.0,5005,7,1007,0,78
177,6/9/2021,1084,379838,282,205188,857,189071,15.0,33513,11.0,34759,77.0,9348,661,163725,76.0,10950,43.0,5048,4,1011,1,79
178,6/10/2021,1330,381168,344,205532,1032,190103,21.0,33534,4.0,34763,95.0,9443,814,164539,69.0,11019,54.0,5102,11,1022,1,80
179,6/11/2021,1113,382281,320,205852,847,190950,20.0,33554,13.0,34776,60.0,9503,661,165200,81.0,11100,45.0,5147,2,1024,1,81
180,6/12/2021,1051,383332,288,206140,814,191764,16.0,33570,9.0,34785,72.0,9575,632,165832,68.0,11168,42.0,5189,1,1025,0,81
181,6/13/2021,371,383703,97,206237,292,192056,4.0,33574,1.0,34786,35.0,9610,212,166044,25.0,11193,20.0,5209,3,1028,0,81
182,6/14/2021,844,384547,289,206526,611,192667,15.0,33589,4.0,34790,47.0,9657,464,166508,44.0,11237,56.0,5265,3,1031,0,81
183,6/15/2021,708,385255,244,206770,489,193156,21.0,33610,10.0,34800,43.0,9700,394,166902,34.0,11271,18.0,5283,1,1032,1,82
184,6/16/2021,638,385893,207,206977,467,193623,13.0,33623,5.0,34805,39.0,9739,350,167252,39.0,11310,39.0,5322,4,1036,0,82
185,6/17/2021,702,386595,254,207231,475,194098,15.0,33638,9.0,34814,44.0,9783,351,167603,51.0,11361,29.0,5351,7,1043,1,83
186,6/18/2021,1048,387643,379,207610,705,194803,22.0,33660,11.0,34825,55.0,9838,563,168166,57.0,11418,30.0,5381,12,1055,0,83
187,6/19/2021,640,388283,152,207762,509,195312,10.0,33670,6.0,34831,51.0,9889,377,168543,54.0,11472,27.0,5408,4,1059,0,83
188,6/20/2021,296,388579,111,207873,193,195505,3.0,33673,2.0,34833,37.0,9926,119,168662,15.0,11487,22.0,5430,5,1064,0,83
189,6/21/2021,521,389100,216,208089,338,195843,5.0,33678,7.0,34840,30.0,9956,252,168914,34.0,11521,22.0,5452,4,1068,0,83
190,6/22/2021,619,389719,255,208344,402,196245,12.0,33690,8.0,34848,32.0,9988,314,169228,28.0,11549,28.0,5480,2,1070,0,83
191,6/23/2021,510,390229,185,208529,350,196595,8.0,33698,10.0,34858,40.0,10028,253,169481,34.0,11583,23.0,5503,11,1081,1,84
192,6/24/2021,538,390767,209,208738,356,196951,13.0,33711,9.0,34867,35.0,10063,275,169756,24.0,11607,22.0,5525,2,1083,0,84
193,6/25/2021,691,391458,273,209011,442,197393,13.0,33724,9.0,34876,44.0,10107,330,170086,42.0,11649,26.0,5551,3,1086,0,84
194,6/26/2021,606,392064,165,209176,454,197847,9.0,33733,9.0,34885,79.0,10186,299,170385,47.0,11696,29.0,5580,3,1089,2,86
195,6/27/2021,183,392247,67,209243,118,197965,2.0,33735,3.0,34888,10.0,10196,86,170471,12.0,11708,10.0,5590,2,1091,0,86
196,6/28/2021,488,392735,206,209449,290,198255,7.0,33742,6.0,34894,40.0,10236,206,170677,26.0,11734,18.0,5608,7,1098,0,86
197,6/29/2021,563,393298,254,209703,340,198595,17.0,33759,11.0,34905,43.0,10279,250,170927,23.0,11757,24.0,5632,8,1106,2,88
198,6/30/2021,422,393720,206,209909,230,198825,8.0,33767,11.0,34916,20.0,10299,173,171100,17.0,11774,20.0,5652,7,1113,2,90
199,7/1/2021,508,394228,213,210122,308,199133,9.0,33776,7.0,34923,23.0,10322,230,171330,35.0,11809,20.0,5672,13,1126,2,92
200,7/2/2021,571,394799,272,210394,312,199445,7.0,33783,7.0,34930,28.0,10350,245,171575,24.0,11833,15.0,5687,6,1132,0,92
201,7/3/2021,306,395105,120,210514,193,199638,4.0,33787,3.0,34933,28.0,10378,126,171701,20.0,11853,19.0,5706,5,1137,0,92
202,7/4/2021,55,395160,20,210534,35,199673,1.0,33788,0.0,34933,4.0,10382,22,171723,1.0,11854,8.0,5714,0,1137,0,92
203,7/5/2021,320,395480,141,210675,176,199849,3.0,33791,1.0,34934,18.0,10400,122,171845,26.0,11880,10.0,5724,9,1146,0,92
204,7/6/2021,467,395947,191,210866,287,200136,4.0,33795,5.0,34939,46.0,10446,207,172052,20.0,11900,14.0,5738,3,1149,0,92
205,7/7/2021,383,396330,212,211078,189,200325,8.0,33803,6.0,34945,24.0,10470,136,172188,13.0,11913,16.0,5754,5,1154,0,92
206,7/8/2021,430,396760,202,211280,252,200577,9.0,33812,8.0,34953,25.0,10495,177,172365,26.0,11939,24.0,5778,3,1157,1,93
207,7/9/2021,480,397240,193,211473,298,200875,10.0,33822,2.0,34955,39.0,10534,216,172581,25.0,11964,18.0,5796,2,1159,2,95
208,7/10/2021,266,397506,153,211626,133,201008,5.0,33827,2.0,34957,5.0,10539,110,172691,10.0,11974,8.0,5804,2,1161,0,95
209,7/11/2021,223,397729,120,211746,125,201133,6.0,33833,7.0,34964,11.0,10550,93,172784,9.0,11983,12.0,5816,8,1169,2,97
210,7/12/2021,389,398118,203,211949,199,201332,6.0,33839,4.0,34968,27.0,10577,133,172917,22.0,12005,17.0,5833,4,1173,0,97
211,7/13/2021,438,398556,225,212174,234,201566,17.0,33856,9.0,34977,28.0,10605,182,173099,12.0,12017,12.0,5845,4,1177,0,97
212,7/14/2021,290,398846,155,212329,162,201728,8.0,33864,5.0,34982,20.0,10625,118,173217,9.0,12026,15.0,5860,4,1181,1,98
213,7/15/2021,367,399213,189,212518,186,201914,1.0,33865,4.0,34986,16.0,10641,139,173356,14.0,12040,17.0,5877,6,1187,0,98
214,7/16/2021,512,399725,245,212763,283,202197,8.0,33873,9.0,34995,25.0,10666,214,173570,22.0,12062,22.0,5899,1,1188,0,98
215,7/17/2021,274,399999,157,212920,136,202333,12.0,33885,4.0,34999,13.0,10679,105,173675,8.0,12070,10.0,5909,3,1191,0,98
216,7/18/2021,196,400195,118,213038,94,202427,4.0,33889,3.0,35002,13.0,10692,67,173742,7.0,12077,7.0,5916,3,1194,0,98
217,7/19/2021,408,400603,207,213245,210,202637,9.0,33898,8.0,35010,26.0,10718,154,173896,18.0,12095,12.0,5928,3,1197,2,100
218,7/20/2021,424,401027,213,213458,221,202858,6.0,33904,8.0,35018,13.0,10731,169,174065,24.0,12119,15.0,5943,6,1203,1,101
219,7/21/2021,342,401369,187,213645,175,203033,14.0,33918,14.0,35032,13.0,10744,131,174196,14.0,12133,17.0,5960,4,1207,1,102
220,7/22/2021,403,401772,235,213880,178,203211,7.0,33925,17.0,35049,21.0,10765,131,174327,18.0,12151,8.0,5968,6,1213,1,103
221,7/23/2021,554,402326,323,214203,239,203450,7.0,33932,10.0,35059,37.0,10802,165,174492,19.0,12170,18.0,5986,6,1219,0,103
222,7/24/2021,350,402676,213,214416,159,203609,9.0,33941,9.0,35068,20.0,10822,116,174608,9.0,12179,14.0,6000,3,1222,1,104
223,7/25/2021,192,402868,139,214555,65,203674,0.0,33941,4.0,35072,7.0,10829,47,174655,5.0,12184,6.0,6006,4,1226,0,104
224,7/26/2021,356,403224,208,214763,150,203824,2.0,33943,6.0,35078,11.0,10840,102,174757,18.0,12202,19.0,6025,10,1236,0,104
225,7/27/2021,430,403654,235,214998,182,204006,5.0,33948,16.0,35094,23.0,10863,126,174883,20.0,12222,13.0,6038,27,1263,0,104
226,7/28/2021,472,404126,284,215282,226,204232,4.0,33952,10.0,35104,30.0,10893,148,175031,17.0,12239,31.0,6069,4,1267,2,106
227,7/29/2021,513,404639,310,215592,234,204466,8.0,33960,6.0,35110,25.0,10918,178,175209,13.0,12252,18.0,6087,13,1280,1,107
228,7/30/2021,699,405338,483,216075,254,204720,10.0,33970,14.0,35124,29.0,10947,190,175399,17.0,12269,18.0,6105,9,1289,1,108
229,7/31/2021,337,405675,201,216276,138,204858,4.0,33974,1.0,35125,16.0,10963,109,175508,8.0,12277,5.0,6110,10,1299,0,108
230,8/1/2021,300,405975,176,216452,106,204964,0.0,33974,2.0,35127,14.0,10977,67,175575,9.0,12286,16.0,6126,33,1332,3,111
231,8/2/2021,451,406426,298,216750,182,205146,5.0,33979,14.0,35141,23.0,11000,126,175701,19.0,12305,14.0,6140,7,1339,2,113
232,8/3/2021,565,406991,347,217097,247,205393,6.0,33985,14.0,35155,40.0,11040,165,175866,15.0,12320,27.0,6167,5,1344,1,114
233,8/4/2021,400,407391,278,217375,154,205547,6.0,33991,14.0,35169,11.0,11051,115,175981,7.0,12327,21.0,6188,2,1346,1,115
234,8/5/2021,449,407840,289,217664,173,205720,6.0,33997,11.0,35180,21.0,11072,126,176107,16.0,12343,10.0,6198,8,1354,0,115
235,8/6/2021,686,408526,461,218125,277,205997,13.0,34010,16.0,35196,23.0,11095,207,176314,24.0,12367,23.0,6221,8,1362,0,115
236,8/7/2021,446,408972,311,218436,159,206156,4.0,34014,11.0,35207,12.0,11107,127,176441,5.0,12372,15.0,6236,5,1367,1,116
237,8/8/2021,219,409191,126,218562,100,206256,3.0,34017,5.0,35212,8.0,11115,71,176512,9.0,12381,12.0,6248,5,1372,3,119
238,8/9/2021,464,409655,277,218839,222,206478,4.0,34021,6.0,35218,21.0,11136,167,176679,11.0,12392,23.0,6271,6,1378,2,121
239,8/10/2021,500,410155,295,219134,230,206708,6.0,34027,13.0,35231,26.0,11162,178,176857,12.0,12404,14.0,6285,5,1383,4,125
240,8/11/2021,418,410573,260,219394,182,206890,11.0,34038,5.0,35236,18.0,11180,137,176994,14.0,12418,13.0,6298,5,1388,0,125
241,8/12/2021,540,411113,318,219712,265,207155,7.0,34045,15.0,35251,32.0,11212,187,177181,22.0,12440,24.0,6322,8,1396,2,127
242,8/13/2021,659,411772,376,220088,303,207458,10.0,34055,10.0,35261,30.0,11242,224,177405,18.0,12458,31.0,6353,7,1403,1,128
243,8/14/2021,511,412283,259,220347,258,207716,7.0,34062,8.0,35269,11.0,11253,219,177624,10.0,12468,18.0,6371,53,1456,2,130
244,8/15/2021,268,412551,131,220478,123,207839,2.0,34064,2.0,35271,11.0,11264,89,177713,6.0,12474,17.0,6388,22,1478,0,130
245,8/16/2021,541,413092,311,220789,179,208018,4.0,34068,11.0,35282,15.0,11279,140,177853,12.0,12486,12.0,6400,81,1559,3,133
246,8/17/2021,489,413581,229,221018,195,208213,17.0,34085,10.0,35292,17.0,11296,146,177999,11.0,12497,21.0,6421,91,1650,0,133
247,8/18/2021,593,414174,324,221342,272,208485,6.0,34091,14.0,35306,32.0,11328,184,178183,14.0,12511,42.0,6463,73,1723,4,137
248,8/19/2021,573,414747,281,221623,268,208753,7.0,34098,9.0,35315,21.0,11349,210,178393,22.0,12533,15.0,6478,84,1807,1,138
249,8/20/2021,851,415598,337,221960,470,209223,16.0,34114,12.0,35327,45.0,11394,372,178765,30.0,12563,23.0,6501,98,1905,1,139
250,8/21/2021,649,416247,212,222172,214,209437,6.0,34120,7.0,35334,15.0,11409,176,178941,13.0,12576,10.0,6511,234,2139,0,139
251,8/22/2021,311,416558,149,222321,138,209575,1.0,34121,2.0,35336,19.0,11428,98,179039,9.0,12585,12.0,6523,32,2171,2,141
252,8/23/2021,530,417088,261,222582,226,209801,10.0,34131,10.0,35346,20.0,11448,170,179209,13.0,12598,23.0,6546,66,2237,1,142
253,8/24/2021,572,417660,274,222856,283,210084,12.0,34143,8.0,35354,29.0,11477,223,179432,14.0,12612,17.0,6563,58,2295,2,144
254,8/25/2021,607,418267,325,223181,270,210354,13.0,34156,13.0,35367,22.0,11499,205,179637,10.0,12622,33.0,6596,55,2350,2,146
255,8/26/2021,544,418811,259,223440,261,210615,10.0,34166,13.0,35380,18.0,11517,202,179839,23.0,12645,18.0,6614,56,2406,0,146
256,8/27/2021,899,419710,355,223795,405,211020,15.0,34181,11.0,35391,38.0,11555,298,180137,25.0,12670,44.0,6658,177,2583,6,152
257,8/28/2021,1457,421167,200,223995,248,211268,8.0,34189,5.0,35396,23.0,11578,185,180322,13.0,12683,27.0,6685,1002,3585,13,165
258,8/29/2021,1076,422243,159,224154,140,211408,4.0,34193,4.0,35400,9.0,11587,114,180436,12.0,12695,5.0,6690,773,4358,9,174
259,8/30/2021,618,422861,268,224422,284,211692,10.0,34203,13.0,35413,24.0,11611,219,180655,8.0,12703,33.0,6723,96,4454,5,179
260,8/31/2021,804,423665,232,224654,231,211923,7.0,34210,12.0,35425,20.0,11631,182,180837,17.0,12720,12.0,6735,344,4798,9,188
261,9/1/2021,991,424656,254,224908,229,212152,13.0,34223,16.0,35441,21.0,11652,174,181011,14.0,12734,20.0,6755,526,5324,3,191
262,9/2/2021,827,425483,183,225091,205,212357,14.0,34237,13.0,35454,19.0,11671,151,181162,17.0,12751,18.0,6773,461,5785,4,195
263,9/3/2021,850,426333,335,225426,373,212730,14.0,34251,11.0,35465,44.0,11715,274,181436,21.0,12772,34.0,6807,163,5948,2,197
264,9/4/2021,378,426711,163,225589,175,212905,7.0,34258,8.0,35473,14.0,11729,138,181574,11.0,12783,12.0,6819,48,5996,2,199
265,9/5/2021,249,426960,130,225719,108,213013,2.0,34260,4.0,35477,13.0,11742,79,181653,8.0,12791,8.0,6827,22,6018,0,199
266,9/6/2021,114,427074,45,225764,61,213074,1.0,34261,0.0,35477,4.0,11746,45,181698,8.0,12799,4.0,6831,13,6031,0,199
267,9/7/2021,951,428025,198,225962,279,213353,18.0,34279,12.0,35489,22.0,11768,216,181914,17.0,12816,24.0,6855,484,6515,4,203
268,9/8/2021,786,428811,220,226182,228,213581,11.0,34290,12.0,35501,25.0,11793,170,182084,11.0,12827,22.0,6877,359,6874,5,208
269,9/9/2021,403,429214,176,226358,194,213775,10.0,34300,8.0,35509,22.0,11815,143,182227,14.0,12841,15.0,6892,55,6929,1,209
270,9/10/2021,768,429982,346,226704,320,214095,9.0,34309,23.0,35532,28.0,11843,242,182469,21.0,12862,29.0,6921,141,7070,4,213
271,9/11/2021,1619,431601,161,226865,206,214301,11.0,34320,19.0,35551,17.0,11860,157,182626,16.0,12878,16.0,6937,1261,8331,6,219
272,9/12/2021,233,431834,102,226967,113,214414,0.0,34320,2.0,35553,11.0,11871,73,182699,10.0,12888,19.0,6956,16,8347,2,221
273,9/13/2021,498,432332,218,227185,253,214667,9.0,34329,8.0,35561,24.0,11895,191,182890,12.0,12900,26.0,6982,48,8395,0,221
274,9/14/2021,848,433180,205,227390,278,214945,13.0,34342,14.0,35575,17.0,11912,225,183115,14.0,12914,22.0,7004,398,8793,2,223
275,9/15/2021,828,434008,189,227579,270,215215,15.0,34357,14.0,35589,21.0,11933,199,183314,17.0,12931,33.0,7037,394,9187,3,226
276,9/16/2021,370,434378,138,227717,201,215416,9.0,34366,8.0,35597,33.0,11966,145,183459,12.0,12943,11.0,7048,47,9234,0,226
277,9/17/2021,751,435129,288,228005,396,215812,15.0,34381,13.0,35610,29.0,11995,297,183756,39.0,12982,31.0,7079,119,9353,2,228
278,9/18/2021,1810,436939,127,228132,171,215983,5.0,34386,19.0,35629,11.0,12006,127,183883,16.0,12998,17.0,7096,1511,10864,11,239
279,9/19/2021,186,437125,78,228210,107,216090,3.0,34389,2.0,35631,7.0,12013,83,183966,5.0,13003,12.0,7108,14,10878,0,239
280,9/20/2021,387,437512,143,228353,221,216311,8.0,34397,9.0,35640,28.0,12041,163,184129,10.0,13013,20.0,7128,55,10933,0,239
281,9/21/2021,778,438290,163,228516,204,216515,8.0,34405,13.0,35653,22.0,12063,156,184285,10.0,13023,16.0,7144,424,11357,3,242
282,9/22/2021,728,439018,163,228679,235,216750,5.0,34410,11.0,35664,14.0,12077,188,184473,16.0,13039,17.0,7161,364,11721,6,248
283,9/23/2021,351,439369,144,228823,179,216929,8.0,34418,3.0,35667,9.0,12086,132,184605,14.0,13053,24.0,7185,48,11769,2,250
284,9/24/2021,691,440060,204,229027,277,217206,16.0,34434,15.0,35682,20.0,12106,218,184823,12.0,13065,27.0,7212,232,12001,2,252
285,9/25/2021,1713,441773,132,229159,177,217383,11.0,34445,21.0,35703,15.0,12121,139,184962,11.0,13076,12.0,7224,1408,13409,5,257
286,9/26/2021,259,442032,66,229225,85,217468,3.0,34448,3.0,35706,11.0,12132,63,185025,4.0,13080,7.0,7231,106,13515,2,259
287,9/27/2021,569,442601,155,229380,122,217590,7.0,34455,10.0,35716,7.0,12139,94,185119,8.0,13088,13.0,7244,308,13823,1,260
288,9/28/2021,1135,443736,158,229538,201,217791,19.0,34474,23.0,35739,14.0,12153,153,185272,9.0,13097,25.0,7269,796,14619,4,264
289,9/29/2021,1128,444864,173,229711,166,217957,10.0,34484,21.0,35760,15.0,12168,123,185395,8.0,13105,20.0,7289,802,15421,4,268
290,9/30/2021,713,445577,161,229872,171,218128,15.0,34499,7.0,35767,11.0,12179,132,185527,11.0,13116,17.0,7306,406,15827,8,276
291,10/1/2021,1188,446765,178,230050,311,218439,20.0,34519,15.0,35782,25.0,12204,243,185770,21.0,13137,22.0,7328,708,16535,12,288
292,10/2/2021,1803,448568,113,230163,112,218551,10.0,34529,13.0,35795,9.0,12213,92,185862,6.0,13143,5.0,7333,1573,18108,9,297
293,10/3/2021,396,448964,64,230227,113,218664,1.0,34530,2.0,35797,19.0,12232,77,185939,7.0,13150,10.0,7343,232,18340,0,297
294,10/4/2021,805,449769,114,230341,159,218823,7.0,34537,13.0,35810,27.0,12259,102,186041,17.0,13167,13.0,7356,536,18876,5,302
295,10/5/2021,1126,450895,137,230478,137,218960,11.0,34548,18.0,35828,13.0,12272,102,186143,9.0,13176,13.0,7369,866,19742,1,303
296,10/6/2021,1011,451906,110,230588,156,219116,7.0,34555,16.0,35844,11.0,12283,125,186268,5.0,13181,15.0,7384,759,20501,5,308
297,10/7/2021,803,452709,137,230725,113,219229,8.0,34563,16.0,35860,8.0,12291,89,186357,6.0,13187,10.0,7394,573,21074,2,310
298,10/8/2021,1039,453748,161,230886,247,219476,19.0,34582,10.0,35870,22.0,12313,192,186549,11.0,13198,22.0,7416,648,21722,0,310
299,10/9/2021,1681,455429,108,230994,132,219608,11.0,34593,6.0,35876,22.0,12335,98,186647,4.0,13202,8.0,7424,1438,23160,7,317
300,10/10/2021,246,455675,51,231045,66,219674,2.0,34595,3.0,35879,5.0,12340,51,186698,5.0,13207,5.0,7429,128,23288,2,319
301,10/11/2021,823,456498,118,231163,135,219809,16.0,34611,19.0,35898,3.0,12343,111,186809,9.0,13216,12.0,7441,576,23864,5,324
302,10/12/2021,1019,457517,113,231276,133,219942,8.0,34619,17.0,35915,17.0,12360,104,186913,4.0,13220,8.0,7449,782,24646,4,328
303,10/13/2021,974,458491,123,231399,152,220094,16.0,34635,10.0,35925,16.0,12376,113,187026,14.0,13234,9.0,7458,714,25360,9,337
304,10/14/2021,715,459206,99,231498,124,220218,14.0,34649,8.0,35933,19.0,12395,92,187118,8.0,13242,5.0,7463,498,25858,5,342
305,10/15/2021,1035,460241,176,231674,216,220434,12.0,34661,8.0,35941,15.0,12410,170,187288,12.0,13254,19.0,7482,671,26529,9,351
306,10/16/2021,806,461047,67,231741,81,220515,4.0,34665,3.0,35944,7.0,12417,69,187357,2.0,13256,3.0,7485,654,27183,7,358
307,10/17/2021,194,461241,47,231788,62,220577,1.0,34666,2.0,35946,4.0,12421,47,187404,2.0,13258,9.0,7494,83,27266,2,360
308,10/18/2021,659,461900,117,231905,136,220713,10.0,34676,3.0,35949,13.0,12434,106,187510,7.0,13265,10.0,7504,420,27686,4,364
309,10/19/2021,1057,462957,122,232027,132,220845,4.0,34680,11.0,35960,7.0,12441,107,187617,8.0,13273,10.0,7514,810,28496,5,369
310,10/20/2021,899,463856,122,232149,121,220966,7.0,34687,13.0,35973,9.0,12450,90,187707,7.0,13280,15.0,7529,667,29163,8,377
311,10/21/2021,540,464396,110,232259,127,221093,10.0,34697,8.0,35981,13.0,12463,85,187792,11.0,13291,18.0,7547,323,29486,5,382
312,10/22/2021,1484,465880,195,232454,160,221253,7.0,34704,13.0,35994,18.0,12481,109,187901,8.0,13299,25.0,7572,1145,30631,9,391
313,10/23/2021,1863,467743,88,232542,76,221329,9.0,34713,14.0,36008,1.0,12482,63,187964,4.0,13303,8.0,7580,1691,32322,13,404
314,10/24/2021,593,468336,81,232623,74,221403,7.0,34720,10.0,36018,7.0,12489,58,188022,4.0,13307,5.0,7585,445,32767,5,409
315,10/25/2021,1476,469812,140,232763,113,221516,19.0,34739,18.0,36036,8.0,12497,90,188112,7.0,13314,8.0,7593,1226,33993,13,422
316,10/26/2021,2127,471939,172,232935,135,221651,7.0,34746,16.0,36052,15.0,12512,100,188212,8.0,13322,12.0,7605,1813,35806,20,442
317,10/27/2021,1978,473917,148,233083,110,221761,6.0,34752,17.0,36069,5.0,12517,88,188300,10.0,13332,7.0,7612,1727,37533,9,451
318,10/28/2021,1784,475701,139,233222,114,221875,4.0,34756,22.0,36091,6.0,12523,92,188392,4.0,13336,12.0,7624,1524,39057,16,467
319,10/29/2021,1730,477431,180,233402,131,222006,4.0,34760,15.0,36106,8.0,12531,106,188498,5.0,13341,12.0,7636,1417,40474,14,481
320,10/30/2021,1585,479016,79,233481,80,222086,5.0,34765,8.0,36114,6.0,12537,62,188560,7.0,13348,5.0,7641,1418,41892,17,498
321,10/31/2021,464,479480,48,233529,37,222123,1.0,34766,6.0,36120,7.0,12544,27,188587,1.0,13349,2.0,7643,375,42267,4,502
322,11/1/2021,1334,480814,144,233673,112,222235,3.0,34769,11.0,36131,10.0,12554,77,188664,7.0,13356,18.0,7661,1075,43342,15,517
323,11/2/2021,1844,482658,128,233801,103,222338,7.0,34776,16.0,36147,11.0,12565,75,188739,7.0,13363,10.0,7671,1610,44952,18,535
324,11/3/2021,1754,484412,159,233960,119,222457,9.0,34785,19.0,36166,10.0,12575,84,188823,6.0,13369,19.0,7690,1476,46428,19,554
325,11/4/2021,1417,485829,145,234105,92,222549,4.0,34789,13.0,36179,1.0,12576,75,188898,5.0,13374,11.0,7701,1200,47628,9,563
326,11/5/2021,2034,487863,222,234327,170,222719,11.0,34800,11.0,36190,11.0,12587,138,189036,8.0,13382,13.0,7714,1660,49288,15,578
327,11/6/2021,1586,489449,216,234543,77,222796,2.0,34802,8.0,36198,5.0,12592,62,189098,5.0,13387,5.0,7719,1283,50571,18,596
328,11/7/2021,535,489984,125,234668,41,222837,1.0,34803,8.0,36206,4.0,12596,31,189129,0.0,13387,6.0,7725,362,50933,8,604
329,11/8/2021,1524,491508,383,235051,107,222944,6.0,34809,9.0,36215,8.0,12604,87,189216,2.0,13389,10.0,7735,1045,51978,8,612
330,11/9/2021,2656,494164,944,235995,131,223075,5.0,34814,19.0,36234,11.0,12615,86,189302,9.0,13398,25.0,7760,1588,53566,15,627
331,11/10/2021,2519,496683,822,236817,113,223188,7.0,34821,15.0,36249,9.0,12624,84,189386,10.0,13408,10.0,7770,1585,55151,19,646
332,11/11/2021,2354,499037,959,237776,98,223286,6.0,34827,8.0,36257,11.0,12635,70,189456,11.0,13419,6.0,7776,1298,56449,21,667
333,11/12/2021,2581,501618,751,238527,141,223427,9.0,34836,19.0,36276,14.0,12649,107,189563,9.0,13428,11.0,7787,1678,58127,25,692
334,11/13/2021,1932,503550,405,238932,69,223496,2.0,34838,10.0,36286,4.0,12653,46,189609,7.0,13435,12.0,7799,1454,59581,13,705
335,11/14/2021,1493,505043,910,239842,57,223553,1.0,34839,2.0,36288,7.0,12660,35,189644,6.0,13441,9.0,7808,534,60115,2,707
336,11/15/2021,1988,507031,441,240283,100,223653,5.0,34844,11.0,36299,12.0,12672,69,189713,6.0,13447,13.0,7821,1449,61564,12,719
337,11/16/2021,2438,509469,451,240734,106,223759,3.0,34847,20.0,36319,16.0,12688,73,189786,7.0,13454,10.0,7831,1867,63431,27,746
338,11/17/2021,2749,512218,632,241366,130,223889,7.0,34854,19.0,36338,9.0,12697,105,189891,6.0,13460,10.0,7841,1979,65410,31,777
339,11/18/2021,2029,514247,384,241750,106,223995,6.0,34860,11.0,36349,10.0,12707,81,189972,10.0,13470,5.0,7846,1525,66935,29,806
340,11/19/2021,2589,516836,717,242467,157,224152,3.0,34863,16.0,36365,11.0,12718,125,190097,10.0,13480,11.0,7857,1709,68644,26,832
341,11/20/2021,1895,518731,538,243005,46,224198,2.0,34865,5.0,36370,4.0,12722,36,190133,2.0,13482,4.0,7861,1298,69942,16,848
342,11/21/2021,661,519392,122,243127,43,224241,0.0,34865,1.0,36371,2.0,12724,31,190164,3.0,13485,7.0,7868,492,70434,6,854
343,11/22/2021,2007,521399,425,243552,112,224353,8.0,34873,20.0,36391,1.0,12725,91,190255,6.0,13491,14.0,7882,1462,71896,27,881
344,11/23/2021,1876,523275,286,243838,94,224447,4.0,34877,15.0,36406,9.0,12734,69,190324,9.0,13500,7.0,7889,1493,73389,13,894
345,11/24/2021,1541,524816,215,244053,94,224541,4.0,34881,11.0,36417,10.0,12744,73,190397,5.0,13505,6.0,7895,1238,74627,9,903
346,11/25/2021,49,524865,9,244062,0,224541,0.0,34881,0.0,36417,0.0,12744,0,190397,0.0,13505,,7895,38,74665,2,905
347,11/26/2021,1278,526143,191,244253,146,224687,2.0,34883,4.0,36421,14.0,12758,114,190511,11.0,13516,7.0,7902,953,75618,6,911
348,11/27/2021,969,527112,135,244388,121,224808,2.0,34885,2.0,36423,9.0,12767,100,190611,5.0,13521,7.0,7909,710,76328,7,918
349,11/28/2021,549,527661,93,244481,84,224892,2.0,34887,1.0,36424,6.0,12773,66,190677,5.0,13526,7.0,7916,371,76699,5,923
350,11/29/2021,1884,529545,262,244743,334,225226,7.0,34894,13.0,36437,25.0,12798,273,190950,23.0,13549,13.0,7929,1280,77979,19,942
351,11/30/2021,2708,532253,336,245079,715,225941,2.0,34896,12.0,36449,46.0,12844,607,191557,50.0,13599,12.0,7941,1639,79618,35,977
352,12/1/2021,2537,534790,267,245346,659,226600,6.0,34902,11.0,36460,28.0,12872,575,192132,52.0,13651,4.0,7945,1593,81211,31,1008
353,12/2/2021,2864,537654,356,245702,837,227437,6.0,34908,14.0,36474,64.0,12936,680,192812,69.0,13720,24.0,7969,1656,82867,34,1042
354,12/3/2021,2622,540276,281,245983,676,228113,9.0,34917,4.0,36478,58.0,12994,532,193344,64.0,13784,22.0,7991,1668,84535,13,1055
355,12/4/2021,2202,542478,158,246141,356,228469,3.0,34920,1.0,36479,18.0,13012,277,193621,30.0,13814,31.0,8022,1682,86217,11,1066
356,12/5/2021,1391,543869,98,246239,817,229286,1.0,34921,0.0,36479,66.0,13078,647,194268,71.0,13885,33.0,8055,479,86696,4,1070
357,12/6/2021,1958,545827,238,246477,386,229672,5.0,34926,6.0,36485,48.0,13126,292,194560,30.0,13915,16.0,8071,1334,88030,12,1082
358,12/7/2021,2481,548308,304,246781,375,230047,6.0,34932,8.0,36493,42.0,13168,294,194854,23.0,13938,16.0,8087,1797,89827,22,1104
359,12/8/2021,2257,550565,268,247049,437,230484,5.0,34937,12.0,36505,32.0,13200,359,195213,35.0,13973,11.0,8098,1556,91383,13,1117
360,12/9/2021,2193,552758,305,247354,397,230881,1.0,34938,8.0,36513,24.0,13224,305,195518,35.0,14008,33.0,8131,1487,92870,14,1131
361,12/10/2021,2105,554863,233,247587,328,231209,7.0,34945,8.0,36521,33.0,13257,245,195763,27.0,14035,23.0,8154,1534,94404,18,1149
362,12/11/2021,1799,556662,135,247722,457,231666,3.0,34948,1.0,36522,60.0,13317,336,196099,37.0,14072,24.0,8178,1199,95603,8,1157
363,12/12/2021,426,557088,54,247776,63,231729,1.0,34949,3.0,36525,4.0,13321,46,196145,7.0,14079,6.0,8184,309,95912,2,1159
364,12/13/2021,1769,558857,293,248069,344,232073,3.0,34952,8.0,36533,26.0,13347,273,196418,33.0,14112,12.0,8196,1140,97052,10,1169
365,12/14/2021,2216,561073,273,248342,256,232329,5.0,34957,4.0,36537,26.0,13373,202,196620,13.0,14125,15.0,8211,1688,98740,21,1190
366,12/15/2021,1766,562839,203,248545,153,232482,2.0,34959,4.0,36541,8.0,13381,119,196739,14.0,14139,12.0,8223,1412,100152,12,1202
367,12/16/2021,1837,564676,322,248867,172,232654,3.0,34962,8.0,36549,17.0,13398,140,196879,9.0,14148,6.0,8229,1340,101492,18,1220
368,12/17/2021,2133,566809,304,249171,349,233003,3.0,34965,9.0,36558,26.0,13424,277,197156,36.0,14184,10.0,8239,1473,102965,17,1237
369,12/18/2021,1821,568630,175,249346,178,233181,3.0,34968,4.0,36562,17.0,13441,148,197304,6.0,14190,7.0,8246,1446,104411,22,1259
370,12/19/2021,443,569073,42,249388,49,233230,1.0,34969,3.0,36565,5.0,13446,37,197341,3.0,14193,4.0,8250,350,104761,2,1261
371,12/20/2021,1594,570667,201,249589,174,233404,2.0,34971,9.0,36574,27.0,13473,128,197469,9.0,14202,10.0,8260,1212,105973,14,1275
372,12/21/2021,2222,572889,311,249900,170,233574,6.0,34977,9.0,36583,27.0,13500,115,197584,15.0,14217,13.0,8273,1735,107708,16,1291
373,12/22/2021,1918,574807,220,250120,198,233772,4.0,34981,9.0,36592,26.0,13526,148,197732,17.0,14234,7.0,8280,1488,109196,17,1308
374,12/23/2021,1262,576069,217,250337,144,233916,2.0,34983,4.0,36596,21.0,13547,97,197829,12.0,14246,14.0,8294,902,110098,11,1319
375,12/24/2021,323,576392,44,250381,49,233965,2.0,34985,2.0,36598,3.0,13550,41,197870,4.0,14250,1.0,8295,231,110329,1,1320
376,12/25/2021,15,576407,4,250385,1,233966,0.0,34985,0.0,36598,,13550,1,197871,0.0,14250,,8295,10,110339,0,1320
377,12/26/2021,360,576767,59,250444,56,234022,1.0,34986,0.0,36598,8.0,13558,41,197912,4.0,14254,3.0,8298,244,110583,4,1324
378,12/27/2021,1295,578062,181,250625,163,234185,4.0,34990,5.0,36603,17.0,13575,124,198036,15.0,14269,7.0,8305,943,111526,15,1339
379,12/28/2021,1930,579992,274,250899,199,234384,6.0,34996,12.0,36615,30.0,13605,139,198175,15.0,14284,15.0,8320,1439,112965,21,1360
380,12/29/2021,1724,581716,211,251110,173,234557,3.0,34999,7.0,36622,27.0,13632,123,198298,14.0,14298,9.0,8329,1335,114300,17,1377
381,12/30/2021,1401,583117,223,251333,169,234726,3.0,35002,8.0,36630,22.0,13654,126,198424,12.0,14310,9.0,8338,1002,115302,14,1391
382,12/31/2021,518,583635,95,251428,54,234780,0.0,35002,2.0,36632,7.0,13661,40,198464,3.0,14313,4.0,8342,360,115662,10,1401
383,1/1/2022,94,583729,11,251439,12,234792,0.0,35002,0.0,36632,0.0,13661,10,198474,1.0,14314,1.0,8343,66,115728,3,1404
384,1/2/2022,321,584050,46,251485,38,234830,0.0,35002,1.0,36633,7.0,13668,24,198498,7.0,14321,0.0,8343,236,115964,2,1406
385,1/3/2022,1622,585672,326,251811,291,235121,3.0,35005,5.0,36638,30.0,13698,233,198731,19.0,14340,9.0,8352,997,116961,16,1422
386,1/4/2022,1704,587376,263,252074,194,235315,7.0,35012,6.0,36644,27.0,13725,145,198876,13.0,14353,9.0,8361,1241,118202,17,1439
387,1/5/2022,1342,588718,203,252277,113,235428,2.0,35014,8.0,36652,8.0,13733,88,198964,5.0,14358,12.0,8373,1024,119226,13,1452
388,1/6/2022,1250,589968,257,252534,175,235603,2.0,35016,4.0,36656,24.0,13757,124,199088,6.0,14364,21.0,8394,815,120041,11,1463
389,1/7/2022,2066,592034,253,252787,243,235846,5.0,35021,8.0,36664,30.0,13787,182,199270,21.0,14385,10.0,8404,1567,121608,14,1477
390,1/8/2022,1590,593624,124,252911,88,235934,1.0,35022,3.0,36667,6.0,13793,69,199339,6.0,14391,7.0,8411,1361,122969,17,1494
391,1/9/2022,504,594128,90,253001,57,235991,0.0,35022,2.0,36669,13.0,13806,35,199374,3.0,14394,6.0,8417,353,123322,4,1498
392,1/10/2022,1573,595701,291,253292,132,236123,2.0,35024,6.0,36675,14.0,13820,98,199472,12.0,14406,8.0,8425,1149,124471,11,1509
393,1/11/2022,1584,597285,226,253518,200,236323,2.0,35026,4.0,36679,28.0,13848,149,199621,8.0,14414,15.0,8440,1154,125625,18,1527
394,1/12/2022,1406,598691,175,253693,106,236429,1.0,35027,5.0,36684,21.0,13869,66,199687,14.0,14428,5.0,8445,1118,126743,15,1542
395,1/13/2022,1110,599801,197,253890,126,236555,3.0,35030,3.0,36687,10.0,13879,87,199774,15.0,14443,14.0,8459,785,127528,8,1550
396,1/14/2022,1637,601438,272,254162,132,236687,1.0,35031,8.0,36695,19.0,13898,89,199863,16.0,14459,8.0,8467,1225,128753,20,1570
397,1/15/2022,1225,602663,139,254301,66,236753,0.0,35031,3.0,36698,6.0,13904,52,199915,7.0,14466,1.0,8468,1005,129758,15,1585
398,1/16/2022,290,602953,46,254347,25,236778,1.0,35032,0.0,36698,1.0,13905,20,199935,4.0,14470,0.0,8468,216,129974,2,1587
399,1/17/2022,802,603755,161,254508,91,236869,2.0,35034,5.0,36703,11.0,13916,69,200004,8.0,14478,3.0,8471,540,130514,12,1599
400,1/18/2022,889,604644,156,254664,113,236982,2.0,35036,5.0,36708,22.0,13938,81,200085,4.0,14482,6.0,8477,610,131124,17,1616
401,1/19/2022,764,605408,124,254788,93,237075,4.0,35040,7.0,36715,9.0,13947,67,200152,6.0,14488,11.0,8488,548,131672,9,1625
402,1/20/2022,837,606245,152,254940,126,237201,0.0,35040,11.0,36726,16.0,13963,90,200242,9.0,14497,11.0,8499,557,132229,8,1633
403,1/21/2022,1227,607472,176,255116,105,237306,2.0,35042,2.0,36728,11.0,13974,76,200318,7.0,14504,11.0,8510,941,133170,10,1643
404,1/22/2022,827,608299,93,255209,73,237379,0.0,35042,1.0,36729,12.0,13986,50,200368,4.0,14508,7.0,8517,635,133805,23,1666
405,1/23/2022,236,608535,29,255238,38,237417,1.0,35043,0.0,36729,4.0,13990,27,200395,7.0,14515,0.0,8517,169,133974,1,1667
406,1/24/2022,541,609076,85,255323,95,237512,1.0,35044,1.0,36730,14.0,14004,67,200462,7.0,14522,7.0,8524,356,134330,8,1675
407,1/25/2022,674,609750,116,255439,118,237630,3.0,35047,2.0,36732,11.0,14015,80,200542,20.0,14542,7.0,8531,421,134751,19,1694
408,1/26/2022,655,610405,104,255543,109,237739,5.0,35052,3.0,36735,11.0,14026,79,200621,11.0,14553,8.0,8539,439,135190,8,1702
409,1/27/2022,628,611033,115,255658,145,237884,3.0,35055,1.0,36736,26.0,14052,105,200726,7.0,14560,7.0,8546,358,135548,14,1716
410,1/28/2022,980,612013,161,255819,128,238012,4.0,35059,6.0,36742,18.0,14070,80,200806,12.0,14572,18.0,8564,672,136220,24,1740
411,1/29/2022,562,612575,65,255884,71,238083,1.0,35060,3.0,36745,9.0,14079,51,200857,8.0,14580,3.0,8567,416,136636,9,1749
412,1/30/2022,196,612771,33,255917,42,238125,1.0,35061,1.0,36746,15.0,14094,23,200880,1.0,14581,3.0,8570,121,136757,2,1751
413,1/31/2022,563,613334,134,256051,95,238220,3.0,35064,1.0,36747,15.0,14109,62,200942,9.0,14590,9.0,8579,325,137082,12,1763
414,2/1/2022,571,613905,100,256151,116,238336,1.0,35065,4.0,36751,22.0,14131,81,201023,10.0,14600,3.0,8582,331,137413,24,1787
415,2/2/2022,134,614039,20,256171,37,238373,0.0,35065,1.0,36752,2.0,14133,31,201054,2.0,14602,2.0,8584,77,137490,3,1790
416,2/3/2022,380,614419,77,256248,110,238483,1.0,35066,3.0,36755,23.0,14156,75,201129,6.0,14608,6.0,8590,191,137681,6,1796
417,2/4/2022,649,615068,113,256361,133,238616,7.0,35073,5.0,36760,18.0,14174,105,201234,4.0,14612,6.0,8596,362,138043,43,1839
418,2/5/2022,459,615527,59,256420,99,238715,2.0,35075,0.0,36760,7.0,14181,78,201312,5.0,14617,9.0,8605,281,138324,21,1860
419,2/6/2022,123,615650,20,256440,22,238737,0.0,35075,1.0,36761,1.0,14182,12,201324,6.0,14623,3.0,8608,77,138401,4,1864
420,2/7/2022,364,616014,62,256502,92,238829,1.0,35076,0.0,36761,10.0,14192,71,201395,4.0,14627,7.0,8615,204,138605,8,1872
421,2/8/2022,452,616466,86,256588,103,238932,2.0,35078,3.0,36764,19.0,14211,73,201468,4.0,14631,7.0,8622,232,138837,39,1911
422,2/9/2022,356,616822,61,256649,78,239010,3.0,35081,1.0,36765,16.0,14227,48,201516,2.0,14633,12.0,8634,204,139041,15,1926
423,2/10/2022,385,617207,86,256735,77,239087,2.0,35083,4.0,36769,15.0,14242,49,201565,6.0,14639,7.0,8641,212,139253,9,1935
424,2/11/2022,553,617760,82,256817,150,239237,3.0,35086,1.0,36770,27.0,14269,99,201664,9.0,14648,15.0,8656,293,139546,33,1968
425,2/12/2022,254,618014,41,256858,45,239282,0.0,35086,0.0,36770,5.0,14274,33,201697,5.0,14653,2.0,8658,153,139699,17,1985
426,2/13/2022,80,618094,19,256877,19,239301,0.0,35086,1.0,36771,0.0,14274,13,201710,4.0,14657,2.0,8660,39,139738,5,1990
427,2/14/2022,240,618334,38,256915,45,239346,2.0,35088,2.0,36773,10.0,14284,29,201739,2.0,14659,4.0,8664,149,139887,9,1999
428,2/15/2022,314,618648,48,256963,84,239430,0.0,35088,0.0,36773,15.0,14299,56,201795,6.0,14665,7.0,8671,151,140038,33,2032
429,2/16/2022,230,618878,42,257005,60,239490,3.0,35091,1.0,36774,12.0,14311,40,201835,5.0,14670,3.0,8674,108,140146,23,2055
430,2/17/2022,172,619050,30,257035,41,239531,0.0,35091,0.0,36774,8.0,14319,28,201863,4.0,14674,1.0,8675,90,140236,12,2067
431,2/18/2022,495,619545,105,257140,97,239628,1.0,35092,3.0,36777,14.0,14333,58,201921,14.0,14688,11.0,8686,265,140501,27,2094
432,2/19/2022,217,619762,26,257166,53,239681,0.0,35092,0.0,36777,9.0,14342,36,201957,2.0,14690,6.0,8692,121,140622,18,2112
433,2/20/2022,74,619836,17,257183,16,239697,0.0,35092,0.0,36777,0.0,14342,14,201971,0.0,14690,2.0,8694,37,140659,4,2116
434,2/21/2022,252,620088,56,257239,71,239768,2.0,35094,1.0,36778,17.0,14359,45,202016,4.0,14694,5.0,8699,118,140777,10,2126
435,2/22/2022,269,620357,48,257287,74,239842,5.0,35099,0.0,36778,6.0,14365,56,202072,4.0,14698,8.0,8707,121,140898,29,2155
436,2/23/2022,215,620572,45,257332,41,239883,1.0,35100,0.0,36778,4.0,14369,29,202101,4.0,14702,4.0,8711,117,141015,12,2167
437,2/24/2022,201,620773,30,257362,43,239926,0.0,35100,1.0,36779,8.0,14377,28,202129,1.0,14703,6.0,8717,116,141131,13,2180
438,2/25/2022,317,621090,55,257417,96,240022,2.0,35102,1.0,36780,13.0,14390,63,202192,12.0,14715,8.0,8725,146,141277,22,2202
439,2/26/2022,187,621277,26,257443,41,240063,1.0,35103,1.0,36781,2.0,14392,29,202221,6.0,14721,4.0,8729,107,141384,13,2215
440,2/27/2022,74,621351,16,257459,13,240076,0.0,35103,1.0,36782,0.0,14392,11,202232,1.0,14722,1.0,8730,43,141427,2,2217
441,2/28/2022,178,621529,48,257507,38,240114,0.0,35103,0.0,36782,8.0,14400,19,202251,5.0,14727,6.0,8736,83,141510,9,2226
442,3/1/2022,209,621738,32,257539,48,240162,4.0,35107,2.0,36784,3.0,14403,43,202294,2.0,14729,0.0,8736,104,141614,29,2255
443,3/2/2022,150,621888,27,257566,36,240198,2.0,35109,0.0,36784,4.0,14407,21,202315,6.0,14735,5.0,8741,77,141691,12,2267
444,3/3/2022,176,622064,36,257602,42,240240,3.0,35112,2.0,36786,10.0,14417,27,202342,3.0,14738,2.0,8743,90,141781,9,2276
445,3/4/2022,341,622405,52,257654,72,240312,4.0,35116,5.0,36791,13.0,14430,50,202392,4.0,14742,5.0,8748,180,141961,42,2318
446,3/5/2022,125,622530,22,257676,19,240331,0.0,35116,0.0,36791,5.0,14435,13,202405,1.0,14743,0.0,8748,72,142033,12,2330
447,3/6/2022,75,622605,28,257704,20,240351,0.0,35116,0.0,36791,2.0,14437,15,202420,1.0,14744,2.0,8750,25,142058,2,2332
448,3/7/2022,150,622755,26,257730,27,240378,1.0,35117,0.0,36791,9.0,14446,14,202434,2.0,14746,2.0,8752,88,142146,9,2341
449,3/8/2022,210,622965,32,257762,36,240414,0.0,35117,2.0,36793,5.0,14451,23,202457,3.0,14749,5.0,8757,104,142250,37,2378
450,3/9/2022,97,623062,12,257774,19,240433,2.0,35119,3.0,36796,3.0,14454,15,202472,0.0,14749,1.0,8758,62,142312,5,2383
451,3/10/2022,100,623162,26,257800,25,240458,1.0,35120,0.0,36796,2.0,14456,19,202491,1.0,14750,3.0,8761,47,142359,3,2386
452,3/11/2022,240,623402,39,257839,77,240535,5.0,35125,1.0,36797,15.0,14471,48,202539,8.0,14758,6.0,8767,89,142448,37,2423
453,3/12/2022,124,623526,25,257864,25,240560,1.0,35126,1.0,36798,1.0,14472,21,202560,1.0,14759,2.0,8769,60,142508,13,2436
454,3/13/2022,45,623571,6,257870,8,240568,0.0,35126,0.0,36798,0.0,14472,6,202566,2.0,14761,0.0,8769,30,142538,2,2438
455,3/14/2022,126,623697,14,257884,39,240607,0.0,35126,0.0,36798,7.0,14479,23,202589,8.0,14769,1.0,8770,65,142603,8,2446
456,3/15/2022,162,623859,30,257914,21,240628,0.0,35126,2.0,36800,4.0,14483,11,202600,4.0,14773,2.0,8772,74,142677,39,2485
457,3/16/2022,135,623994,30,257944,29,240657,0.0,35126,1.0,36801,2.0,14485,21,202621,3.0,14776,3.0,8775,68,142745,11,2496
458,3/17/2022,101,624095,20,257964,11,240668,0.0,35126,0.0,36801,1.0,14486,7,202628,2.0,14778,1.0,8776,61,142806,8,2504
459,3/18/2022,264,624359,21,257985,38,240706,1.0,35127,1.0,36802,2.0,14488,28,202656,6.0,14784,2.0,8778,118,142924,87,2591
460,3/19/2022,111,624470,6,257991,17,240723,1.0,35128,0.0,36802,3.0,14491,10,202666,2.0,14786,2.0,8780,58,142982,30,2621
461,3/20/2022,46,624516,5,257996,8,240731,0.0,35128,0.0,36802,,14491,8,202674,0.0,14786,0.0,8780,24,143006,9,2630
462,3/21/2022,111,624627,11,258007,33,240764,0.0,35128,1.0,36803,5.0,14496,16,202690,7.0,14793,5.0,8785,62,143068,7,2637
463,3/22/2022,163,624790,16,258023,21,240785,2.0,35130,2.0,36805,1.0,14497,18,202708,1.0,14794,1.0,8786,63,143131,64,2701
464,3/23/2022,109,624899,7,258030,25,240810,0.0,35130,0.0,36805,4.0,14501,15,202723,4.0,14798,2.0,8788,62,143193,15,2716
465,3/24/2022,116,625015,18,258048,24,240834,0.0,35130,2.0,36807,4.0,14505,18,202741,1.0,14799,1.0,8789,68,143261,7,2723
466,3/25/2022,211,625226,26,258074,32,240866,0.0,35130,1.0,36808,6.0,14511,20,202761,2.0,14801,4.0,8793,105,143366,48,2771
467,3/26/2022,98,625324,6,258080,13,240879,0.0,35130,0.0,36808,0.0,14511,12,202773,1.0,14802,0.0,8793,41,143407,36,2807
468,3/27/2022,31,625355,7,258087,4,240883,0.0,35130,0.0,36808,0.0,14511,3,202776,0.0,14802,1.0,8794,17,143424,3,2810
469,3/28/2022,88,625443,13,258100,15,240898,0.0,35130,0.0,36808,1.0,14512,12,202788,2.0,14804,0.0,8794,49,143473,11,2821
470,3/29/2022,241,625684,18,258118,20,240918,2.0,35132,0.0,36808,1.0,14513,14,202802,0.0,14804,5.0,8799,67,143540,137,2958
471,3/30/2022,374,626058,24,258142,23,240941,4.0,35136,2.0,36810,3.0,14516,17,202819,2.0,14806,1.0,8800,64,143604,262,3220
472,3/31/2022,592,626650,30,258172,41,240982,4.0,35140,1.0,36811,4.0,14520,32,202851,2.0,14808,3.0,8803,89,143693,433,3653
473,4/1/2022,849,627499,36,258208,36,241018,3.0,35143,3.0,36814,5.0,14525,26,202877,2.0,14810,3.0,8806,93,143786,680,4333
474,4/2/2022,648,628147,15,258223,25,241043,4.0,35147,1.0,36815,1.0,14526,21,202898,0.0,14810,3.0,8809,60,143846,548,4881
475,4/3/2022,143,628290,6,258229,5,241048,0.0,35147,1.0,36816,0.0,14526,3,202901,2.0,14812,0.0,8809,18,143864,114,4995
476,4/4/2022,484,628774,18,258247,24,241072,6.0,35153,1.0,36817,2.0,14528,21,202922,1.0,14813,0.0,8809,65,143929,377,5372
477,4/5/2022,860,629634,37,258284,30,241102,2.0,35155,5.0,36822,4.0,14532,23,202945,1.0,14814,2.0,8811,57,143986,736,6108
478,4/6/2022,503,630137,24,258308,31,241133,6.0,35161,5.0,36827,0.0,14532,28,202973,1.0,14815,2.0,8813,46,144032,405,6513
479,4/7/2022,640,630777,30,258338,23,241156,3.0,35164,7.0,36834,2.0,14534,14,202987,3.0,14818,4.0,8817,58,144090,531,7044
480,4/8/2022,1130,631907,46,258384,39,241195,5.0,35169,8.0,36842,5.0,14539,29,203016,3.0,14821,2.0,8819,97,144187,942,7986
481,4/9/2022,675,632582,35,258419,15,241210,4.0,35173,4.0,36846,3.0,14542,9,203025,2.0,14823,1.0,8820,41,144228,582,8568
482,4/10/2022,184,632766,14,258433,5,241215,1.0,35174,1.0,36847,0.0,14542,5,203030,0.0,14823,0.0,8820,33,144261,132,8700
483,4/11/2022,630,633396,21,258454,28,241243,2.0,35176,3.0,36850,3.0,14545,20,203050,2.0,14825,3.0,8823,54,144315,525,9225
484,4/12/2022,854,634250,30,258484,27,241270,9.0,35185,5.0,36855,4.0,14549,20,203070,3.0,14828,0.0,8823,61,144376,734,9959
485,4/13/2022,661,634911,32,258516,22,241292,5.0,35190,6.0,36861,0.0,14549,21,203091,0.0,14828,1.0,8824,63,144439,543,10502
486,4/14/2022,587,635498,25,258541,22,241314,4.0,35194,0.0,36861,4.0,14553,12,203103,2.0,14830,4.0,8828,91,144530,452,10954
487,4/15/2022,921,636419,41,258582,46,241360,6.0,35200,4.0,36865,10.0,14563,32,203135,3.0,14833,1.0,8829,88,144618,744,11698
488,4/16/2022,497,636916,20,258602,17,241377,2.0,35202,0.0,36865,2.0,14565,13,203148,2.0,14835,0.0,8829,37,144655,423,12121
489,4/17/2022,70,636986,8,258610,5,241382,2.0,35204,1.0,36866,0.0,14565,4,203152,0.0,14835,1.0,8830,12,144667,45,12166
490,4/18/2022,561,637547,39,258649,26,241408,9.0,35213,5.0,36871,3.0,14568,21,203173,1.0,14836,1.0,8831,59,144726,438,12604
491,4/19/2022,788,638335,40,258689,31,241439,10.0,35223,9.0,36880,1.0,14569,26,203199,3.0,14839,1.0,8832,80,144806,639,13243
492,4/20/2022,474,638809,21,258710,24,241463,3.0,35226,3.0,36883,6.0,14575,17,203216,1.0,14840,0.0,8832,47,144853,383,13626
493,4/21/2022,458,639267,22,258732,30,241493,8.0,35234,2.0,36885,2.0,14577,25,203241,2.0,14842,1.0,8833,43,144896,366,13992
494,4/22/2022,700,639967,25,258757,37,241530,1.0,35235,3.0,36888,4.0,14581,30,203271,3.0,14845,0.0,8833,66,144962,571,14563
495,4/23/2022,621,640588,20,258777,25,241555,9.0,35244,3.0,36891,1.0,14582,20,203291,2.0,14847,2.0,8835,62,145024,515,15078
496,4/24/2022,109,640697,8,258785,7,241562,0.0,35244,2.0,36893,0.0,14582,6,203297,0.0,14847,1.0,8836,19,145043,75,15153
497,4/25/2022,381,641078,28,258813,15,241577,3.0,35247,4.0,36897,4.0,14586,10,203307,0.0,14847,1.0,8837,43,145086,295,15448
498,4/26/2022,549,641627,25,258838,24,241601,3.0,35250,2.0,36899,3.0,14589,16,203323,2.0,14849,3.0,8840,73,145159,426,15874
499,4/27/2022,470,642097,22,258860,22,241623,8.0,35258,4.0,36903,2.0,14591,14,203337,2.0,14851,4.0,8844,64,145223,361,16235
500,4/28/2022,461,642558,30,258890,27,241650,7.0,35265,4.0,36907,3.0,14594,18,203355,2.0,14853,4.0,8848,42,145265,364,16599
501,4/29/2022,757,643315,29,258919,33,241683,4.0,35269,2.0,36909,6.0,14600,23,203378,2.0,14855,2.0,8850,70,145335,622,17221
502,4/30/2022,389,643704,6,258925,19,241702,1.0,35270,0.0,36909,1.0,14601,18,203396,0.0,14855,0.0,8850,45,145380,319,17540
503,5/1/2022,100,643804,12,258937,12,241714,0.0,35270,2.0,36911,1.0,14602,9,203405,0.0,14855,2.0,8852,16,145396,60,17600
504,5/2/2022,372,644176,19,258956,19,241733,0.0,35270,5.0,36916,2.0,14604,12,203417,3.0,14858,2.0,8854,55,145451,281,17881
505,5/3/2022,650,644826,29,258985,30,241763,5.0,35275,5.0,36921,3.0,14607,25,203442,2.0,14860,0.0,8854,75,145526,519,18400
506,5/4/2022,515,645341,25,259010,27,241790,4.0,35279,5.0,36926,4.0,14611,19,203461,2.0,14862,2.0,8856,64,145590,393,18793
507,5/5/2022,403,645744,19,259029,20,241810,3.0,35282,3.0,36929,2.0,14613,14,203475,3.0,14865,1.0,8857,50,145640,314,19107
508,5/6/2022,619,646363,35,259064,36,241846,3.0,35285,3.0,36932,5.0,14618,28,203503,2.0,14867,1.0,8858,64,145704,481,19588
509,5/7/2022,371,646734,17,259081,22,241868,1.0,35286,1.0,36933,2.0,14620,17,203520,1.0,14868,2.0,8860,41,145745,290,19878
510,5/8/2022,71,646805,4,259085,7,241875,0.0,35286,0.0,36933,0.0,14620,4,203524,1.0,14869,2.0,8862,13,145758,47,19925
511,5/9/2022,399,647204,25,259110,16,241891,3.0,35289,1.0,36934,1.0,14621,11,203535,2.0,14871,2.0,8864,54,145812,303,20228
512,5/10/2022,599,647803,28,259138,34,241925,13.0,35302,4.0,36938,3.0,14624,25,203560,2.0,14873,4.0,8868,83,145895,451,20679
513,5/11/2022,395,648198,29,259167,26,241951,8.0,35310,4.0,36942,6.0,14630,13,203573,3.0,14876,4.0,8872,32,145927,308,20987
514,5/12/2022,329,648527,19,259186,20,241971,3.0,35313,2.0,36944,0.0,14630,18,203591,2.0,14878,0.0,8872,47,145974,242,21229
515,5/13/2022,647,649174,22,259208,39,242010,6.0,35319,3.0,36947,4.0,14634,27,203618,2.0,14880,6.0,8878,84,146058,499,21728
516,5/14/2022,381,649555,16,259224,12,242022,1.0,35320,2.0,36949,1.0,14635,10,203628,1.0,14881,0.0,8878,33,146091,319,22047
517,5/15/2022,123,649678,6,259230,4,242026,0.0,35320,0.0,36949,0.0,14635,4,203632,0.0,14881,0.0,8878,17,146108,95,22142
518,5/16/2022,448,650126,25,259255,24,242050,0.0,35320,1.0,36950,5.0,14640,16,203648,1.0,14882,2.0,8880,73,146181,323,22465
519,5/17/2022,517,650643,29,259284,23,242073,6.0,35326,4.0,36954,0.0,14640,19,203667,0.0,14882,4.0,8884,63,146244,401,22866
520,5/18/2022,316,650959,11,259295,16,242089,4.0,35330,0.0,36954,4.0,14644,11,203678,0.0,14882,1.0,8885,39,146283,247,23113
521,5/19/2022,446,651405,24,259319,21,242110,2.0,35332,2.0,36956,5.0,14649,15,203693,0.0,14882,1.0,8886,51,146334,346,23459
522,5/20/2022,660,652065,22,259341,28,242138,1.0,35333,4.0,36960,3.0,14652,22,203715,2.0,14884,1.0,8887,106,146440,503,23962
523,5/21/2022,481,652546,19,259360,14,242152,3.0,35336,4.0,36964,0.0,14652,13,203728,1.0,14885,0.0,8887,68,146508,379,24341
524,5/22/2022,170,652716,6,259366,5,242157,1.0,35337,0.0,36964,0.0,14652,3,203731,2.0,14887,0.0,8887,36,146544,121,24462
525,5/23/2022,531,653247,23,259389,18,242175,1.0,35338,2.0,36966,1.0,14653,15,203746,0.0,14887,2.0,8889,111,146655,379,24841
526,5/24/2022,589,653836,48,259437,24,242199,5.0,35343,6.0,36972,2.0,14655,15,203761,0.0,14887,7.0,8896,74,146729,446,25287
527,5/25/2022,411,654247,23,259460,19,242218,3.0,35346,6.0,36978,0.0,14655,12,203773,6.0,14893,1.0,8897,70,146799,296,25583
528,5/26/2022,414,654661,18,259478,22,242240,4.0,35350,5.0,36983,2.0,14657,16,203789,1.0,14894,3.0,8900,98,146897,277,25860
529,5/27/2022,811,655472,22,259500,38,242278,6.0,35356,1.0,36984,5.0,14662,29,203818,3.0,14897,1.0,8901,149,147046,599,26459
530,5/28/2022,304,655776,9,259509,10,242288,1.0,35357,0.0,36984,0.0,14662,10,203828,0.0,14897,0.0,8901,29,147075,253,26712
531,5/29/2022,57,655833,1,259510,2,242290,0.0,35357,1.0,36985,0.0,14662,2,203830,0.0,14897,0.0,8901,12,147087,42,26754
