,Date,daily number of doses received by Larimer County residents,total number of doses recevied by residents,daily number of residents receiving first dose,total number of residents receiving first dose,daily number of residents vaccinated,total number of residents vaccinated,daily number of 70+ vaccinated,total number of 70+ vaccinated,daily number of 70+ at least one dose,total number of 70+ at least one dose,daily number of Latinx residents vaccinated,total of Latinx residents vaccinated,daily number of White non-Latinx residents vaccinated,total of White non-Latinx residents vaccinated,daily number of non-White non-Latinx residents vaccinated,total of non-White non-Latinx residents vaccinated,dailyUnknown,totalUnknown,daily_additional_doses,total_additional_doses
0,12/14/2020,32,32,32,32,1,1,0.0,0,1.0,1,0.0,0,1,1,0.0,0,,0,0,0
1,12/15/2020,14,46,14,46,0,1,,0,,1,,0,0,1,0.0,0,,0,0,0
2,12/16/2020,304,350,304,350,0,1,0.0,0,2.0,3,0.0,0,0,1,0.0,0,0.0,0,0,0
3,12/17/2020,991,1341,991,1341,0,1,0.0,0,11.0,14,0.0,0,0,1,0.0,0,0.0,0,0,0
4,12/18/2020,1055,2396,1055,2396,2,3,0.0,0,15.0,29,0.0,0,2,3,0.0,0,0.0,0,0,0
5,12/19/2020,722,3118,722,3118,0,3,0.0,0,14.0,43,0.0,0,0,3,0.0,0,0.0,0,0,0
6,12/20/2020,266,3384,266,3384,0,3,0.0,0,4.0,47,0.0,0,0,3,0.0,0,0.0,0,0,0
7,12/21/2020,358,3742,358,3742,3,6,0.0,0,3.0,50,0.0,0,3,6,0.0,0,0.0,0,0,0
8,12/22/2020,365,4107,365,4107,0,6,0.0,0,7.0,57,0.0,0,0,6,0.0,0,0.0,0,0,0
9,12/23/2020,440,4547,440,4547,0,6,0.0,0,6.0,63,0.0,0,0,6,0.0,0,0.0,0,0,0
10,12/24/2020,105,4652,105,4652,0,6,0.0,0,3.0,66,0.0,0,0,6,0.0,0,0.0,0,0,0
11,12/25/2020,1,4653,1,4653,0,6,,0,,66,,0,0,6,,0,,0,0,0
12,12/26/2020,228,4881,228,4881,1,7,0.0,0,3.0,69,0.0,0,1,7,0.0,0,0.0,0,0,0
13,12/27/2020,278,5159,278,5159,0,7,0.0,0,197.0,266,0.0,0,0,7,0.0,0,,0,0,0
14,12/28/2020,707,5866,707,5866,0,7,0.0,0,385.0,651,0.0,0,0,7,0.0,0,0.0,0,0,0
15,12/29/2020,914,6780,913,6779,1,8,0.0,0,462.0,1113,0.0,0,1,8,0.0,0,0.0,0,0,0
16,12/30/2020,883,7663,883,7662,0,8,0.0,0,273.0,1386,0.0,0,0,8,0.0,0,0.0,0,0,0
17,12/31/2020,895,8558,895,8557,0,8,0.0,0,343.0,1729,0.0,0,0,8,0.0,0,0.0,0,0,0
18,1/1/2021,4,8562,3,8560,1,9,,0,,1729,,0,1,9,,0,,0,0,0
19,1/2/2021,394,8956,394,8954,1,10,0.0,0,141.0,1870,0.0,0,1,10,0.0,0,0.0,0,0,0
20,1/3/2021,123,9079,123,9077,0,10,0.0,0,52.0,1922,0.0,0,0,10,0.0,0,0.0,0,0,0
21,1/4/2021,589,9668,576,9653,12,22,0.0,0,320.0,2242,0.0,0,10,20,2.0,2,0.0,0,0,0
22,1/5/2021,645,10313,636,10289,10,32,0.0,0,409.0,2651,0.0,0,9,29,1.0,3,0.0,0,0,0
23,1/6/2021,1231,11544,913,11202,313,345,4.0,4,516.0,3167,17.0,17,275,304,17.0,20,4.0,4,0,0
24,1/7/2021,1658,13202,702,11904,941,1286,12.0,16,406.0,3573,34.0,51,850,1154,42.0,62,15.0,19,0,0
25,1/8/2021,1991,15193,981,12885,996,2282,11.0,27,478.0,4051,47.0,98,886,2040,44.0,106,19.0,38,1,1
26,1/9/2021,1228,16421,528,13413,688,2970,14.0,41,302.0,4353,16.0,114,623,2663,37.0,143,12.0,50,0,1
27,1/10/2021,702,17123,427,13840,272,3242,4.0,45,260.0,4613,10.0,124,245,2908,14.0,157,3.0,53,0,1
28,1/11/2021,1150,18273,799,14639,348,3590,1.0,46,536.0,5149,10.0,134,316,3224,19.0,176,3.0,56,0,1
29,1/12/2021,1176,19449,878,15517,297,3887,8.0,54,516.0,5665,14.0,148,257,3481,18.0,194,8.0,64,1,2
30,1/13/2021,1076,20525,830,16347,244,4131,1.0,55,375.0,6040,23.0,171,198,3679,15.0,209,8.0,72,0,2
31,1/14/2021,871,21396,836,17183,35,4166,1.0,56,495.0,6535,2.0,173,31,3710,1.0,210,1.0,73,0,2
32,1/15/2021,1218,22614,1206,18389,12,4178,0.0,56,760.0,7295,0.0,173,12,3722,0.0,210,0.0,73,0,2
33,1/16/2021,986,23600,972,19361,14,4192,1.0,57,585.0,7880,0.0,173,13,3735,1.0,211,0.0,73,0,2
34,1/17/2021,52,23652,48,19409,4,4196,0.0,57,19.0,7899,0.0,173,2,3737,2.0,213,0.0,73,0,2
35,1/18/2021,1016,24668,814,20223,200,4396,48.0,105,601.0,8500,8.0,181,174,3911,13.0,226,5.0,78,2,4
36,1/19/2021,1255,25923,1114,21337,140,4536,9.0,114,736.0,9236,7.0,188,120,4031,6.0,232,7.0,85,0,4
37,1/20/2021,1422,27345,1202,22539,218,4754,17.0,131,569.0,9805,15.0,203,177,4208,9.0,241,17.0,102,1,5
38,1/21/2021,2251,29596,2041,24580,210,4964,7.0,138,1587.0,11392,13.0,216,175,4383,15.0,256,7.0,109,0,5
39,1/22/2021,1737,31333,1461,26041,275,5239,90.0,228,1091.0,12483,34.0,250,222,4605,13.0,269,6.0,115,0,5
40,1/23/2021,896,32229,560,26601,335,5574,58.0,286,416.0,12899,8.0,258,306,4911,13.0,282,8.0,123,0,5
41,1/24/2021,393,32622,104,26705,286,5860,206.0,492,61.0,12960,8.0,266,269,5180,9.0,291,,123,0,5
42,1/25/2021,1404,34026,784,27489,613,6473,363.0,855,554.0,13514,14.0,280,572,5752,15.0,306,12.0,135,0,5
43,1/26/2021,1622,35648,691,28180,923,7396,459.0,1314,441.0,13955,30.0,310,848,6600,32.0,338,13.0,148,0,5
44,1/27/2021,1838,37486,771,28951,1064,8460,538.0,1852,334.0,14289,39.0,349,970,7570,45.0,383,10.0,158,0,5
45,1/28/2021,1343,38829,537,29488,803,9263,356.0,2208,294.0,14583,25.0,374,734,8304,28.0,411,16.0,174,2,7
46,1/29/2021,1632,40461,1154,30642,475,9738,157.0,2365,825.0,15408,21.0,395,412,8716,32.0,443,10.0,184,0,7
47,1/30/2021,1231,41692,736,31378,491,10229,213.0,2578,599.0,16007,24.0,419,441,9157,20.0,463,6.0,190,0,7
48,1/31/2021,622,42314,398,31776,223,10452,76.0,2654,353.0,16360,5.0,424,197,9354,15.0,478,6.0,196,1,8
49,2/1/2021,1607,43921,902,32678,705,11157,469.0,3123,656.0,17016,17.0,441,651,10005,27.0,505,10.0,206,1,9
50,2/2/2021,1862,45783,729,33407,1132,12289,737.0,3860,582.0,17598,43.0,484,1045,11050,34.0,539,10.0,216,0,9
51,2/3/2021,1264,47047,583,33990,679,12968,321.0,4181,226.0,17824,48.0,532,577,11627,42.0,581,12.0,228,0,9
52,2/4/2021,2533,49580,1792,35782,737,13705,494.0,4675,1550.0,19374,29.0,561,661,12288,37.0,618,10.0,238,1,10
53,2/5/2021,2578,52158,1532,37314,1036,14741,684.0,5359,1306.0,20680,38.0,599,951,13239,29.0,647,18.0,256,2,12
54,2/6/2021,2218,54376,1597,38911,615,15356,443.0,5802,1241.0,21921,7.0,606,584,13823,22.0,669,2.0,258,0,12
55,2/7/2021,232,54608,89,39000,141,15497,94.0,5896,26.0,21947,7.0,613,125,13948,4.0,673,5.0,263,1,13
56,2/8/2021,2484,57092,1596,40596,886,16383,601.0,6497,1138.0,23085,26.0,639,815,14763,28.0,701,17.0,280,0,13
57,2/9/2021,2384,59476,1541,42137,841,17224,513.0,7010,993.0,24078,25.0,664,756,15519,32.0,733,28.0,308,0,13
58,2/10/2021,1582,61058,966,43103,612,17836,320.0,7330,288.0,24366,26.0,690,544,16063,26.0,759,16.0,324,4,17
59,2/11/2021,3531,64589,1998,45101,1526,19362,1056.0,8386,808.0,25174,55.0,745,1395,17458,49.0,808,27.0,351,1,18
60,2/12/2021,3263,67852,1810,46911,1443,20805,953.0,9339,800.0,25974,62.0,807,1326,18784,42.0,850,13.0,364,0,18
61,2/13/2021,2998,70850,2364,49275,629,21434,309.0,9648,672.0,26646,15.0,822,580,19364,23.0,873,11.0,375,1,19
62,2/14/2021,421,71271,350,49625,71,21505,49.0,9697,45.0,26691,2.0,824,64,19428,3.0,876,2.0,377,0,19
63,2/15/2021,2623,73894,2130,51755,491,21996,325.0,10022,256.0,26947,17.0,841,460,19888,12.0,888,2.0,379,0,19
64,2/16/2021,2747,76641,1917,53672,826,22822,500.0,10522,231.0,27178,35.0,876,751,20639,24.0,912,16.0,395,0,19
65,2/17/2021,1631,78272,654,54326,973,23795,480.0,11002,155.0,27333,29.0,905,888,21527,36.0,948,20.0,415,0,19
66,2/18/2021,2637,80909,1671,55997,958,24753,735.0,11737,275.0,27608,37.0,942,882,22409,30.0,978,9.0,424,1,20
67,2/19/2021,2424,83333,1030,57027,1379,26132,1019.0,12756,155.0,27763,45.0,987,1276,23685,43.0,1021,15.0,439,3,23
68,2/20/2021,1651,84984,688,57715,960,27092,785.0,13541,134.0,27897,22.0,1009,900,24585,28.0,1049,10.0,449,1,24
69,2/21/2021,108,85092,40,57755,67,27159,37.0,13578,8.0,27905,1.0,1010,64,24649,2.0,1051,0.0,449,0,24
70,2/22/2021,2021,87113,761,58516,1251,28410,927.0,14505,146.0,28051,37.0,1047,1167,25816,37.0,1088,10.0,459,1,25
71,2/23/2021,1221,88334,516,59032,705,29115,471.0,14976,160.0,28211,21.0,1068,636,26452,35.0,1123,13.0,472,0,25
72,2/24/2021,1407,89741,751,59783,650,29765,277.0,15253,135.0,28346,31.0,1099,595,27047,19.0,1142,5.0,477,1,26
73,2/25/2021,3862,93603,2069,61852,1789,31554,1509.0,16762,351.0,28697,47.0,1146,1689,28736,36.0,1178,17.0,494,0,26
74,2/26/2021,3267,96870,1154,63006,2108,33662,1747.0,18509,200.0,28897,33.0,1179,1986,30722,59.0,1237,30.0,524,2,28
75,2/27/2021,3494,100364,1662,64668,1827,35489,1565.0,20074,544.0,29441,36.0,1215,1713,32435,52.0,1289,26.0,550,1,29
76,2/28/2021,426,100790,357,65025,68,35557,42.0,20116,114.0,29555,2.0,1217,62,32497,2.0,1291,2.0,552,0,29
77,3/1/2021,2814,103604,1341,66366,1467,37024,1077.0,21193,300.0,29855,53.0,1270,1356,33853,46.0,1337,12.0,564,5,34
78,3/2/2021,3256,106860,1727,68093,1522,38546,1052.0,22245,383.0,30238,38.0,1308,1413,35266,44.0,1381,27.0,591,1,35
79,3/3/2021,1657,108517,1091,69184,564,39110,176.0,22421,203.0,30441,32.0,1340,504,35770,24.0,1405,4.0,595,0,35
80,3/4/2021,3003,111520,1581,70765,1424,40534,815.0,23236,171.0,30612,43.0,1383,1308,37078,53.0,1458,20.0,615,25,60
81,3/5/2021,3482,115002,2054,72819,1437,41971,814.0,24050,426.0,31038,38.0,1421,1332,38410,44.0,1502,23.0,638,26,86
82,3/6/2021,4104,119106,2321,75140,1999,43970,757.0,24807,268.0,31306,96.0,1517,1791,40201,78.0,1580,34.0,672,580,666
83,3/7/2021,417,119523,300,75440,126,44096,37.0,24844,20.0,31326,1.0,1518,120,40321,3.0,1583,2.0,674,23,689
84,3/8/2021,2818,122341,1053,76493,1774,45870,261.0,25105,74.0,31400,49.0,1567,1640,41961,62.0,1645,23.0,697,124,813
85,3/9/2021,3175,125516,1649,78142,1543,47413,258.0,25363,96.0,31496,51.0,1618,1403,43364,64.0,1709,25.0,722,73,886
86,3/10/2021,2382,127898,1367,79509,1023,48436,300.0,25663,83.0,31579,54.0,1672,921,44285,32.0,1741,16.0,738,63,949
87,3/11/2021,4175,132073,2380,81889,1802,50238,400.0,26063,135.0,31714,63.0,1735,1652,45937,67.0,1808,20.0,758,77,1026
88,3/12/2021,3946,136019,2576,84465,1394,51632,198.0,26261,67.0,31781,68.0,1803,1239,47176,53.0,1861,34.0,792,68,1094
89,3/13/2021,215,136234,132,84597,99,51731,20.0,26281,7.0,31788,1.0,1804,92,47268,4.0,1865,2.0,794,30,1124
90,3/14/2021,101,136335,61,84658,39,51770,9.0,26290,0.0,31788,1.0,1805,36,47304,1.0,1866,1.0,795,2,1126
91,3/15/2021,896,137231,360,85018,536,52306,85.0,26375,15.0,31803,19.0,1824,493,47797,17.0,1883,7.0,802,19,1145
92,3/16/2021,3287,140518,2115,87133,1177,53483,227.0,26602,45.0,31848,64.0,1888,1050,48847,41.0,1924,22.0,824,30,1175
93,3/17/2021,2902,143420,1784,88917,1124,54607,238.0,26840,88.0,31936,40.0,1928,1030,49877,35.0,1959,19.0,843,31,1206
94,3/18/2021,4001,147421,2089,91006,1924,56531,338.0,27178,91.0,32027,97.0,2025,1742,51619,64.0,2023,21.0,864,21,1227
95,3/19/2021,3003,150424,1750,92756,1255,57786,220.0,27398,42.0,32069,60.0,2085,1130,52749,46.0,2069,19.0,883,16,1243
96,3/20/2021,3079,153503,1963,94719,1118,58904,313.0,27711,54.0,32123,37.0,2122,1006,53755,54.0,2123,21.0,904,36,1279
97,3/21/2021,657,154160,396,95115,264,59168,26.0,27737,5.0,32128,11.0,2133,236,53991,15.0,2138,2.0,906,17,1296
98,3/22/2021,3111,157271,2246,97361,864,60032,188.0,27925,56.0,32184,19.0,2152,795,54786,37.0,2175,13.0,919,26,1322
99,3/23/2021,4437,161708,3564,100925,1179,61211,193.0,28118,75.0,32259,41.0,2193,1050,55836,50.0,2225,38.0,957,482,1804
100,3/24/2021,3161,164869,2427,103352,748,61959,117.0,28235,37.0,32296,40.0,2233,668,56504,26.0,2251,14.0,971,33,1837
101,3/25/2021,5066,169935,3052,106404,2016,63975,313.0,28548,71.0,32367,68.0,2301,1848,58352,69.0,2320,31.0,1002,15,1852
102,3/26/2021,4579,174514,2731,109135,1848,65823,328.0,28876,66.0,32433,119.0,2420,1585,59937,113.0,2433,31.0,1033,29,1881
103,3/27/2021,3338,177852,1910,111045,1423,67246,325.0,29201,21.0,32454,49.0,2469,1308,61245,46.0,2479,20.0,1053,5,1886
104,3/28/2021,1169,179021,809,111854,361,67607,92.0,29293,15.0,32469,12.0,2481,331,61576,16.0,2495,2.0,1055,4,1890
105,3/29/2021,3987,183008,2691,114545,1297,68904,229.0,29522,52.0,32521,39.0,2520,1218,62794,27.0,2522,13.0,1068,8,1898
106,3/30/2021,4371,187379,2756,117301,1647,70551,237.0,29759,74.0,32595,55.0,2575,1507,64301,67.0,2589,18.0,1086,47,1945
107,3/31/2021,3570,190949,2556,119857,1048,71599,167.0,29926,47.0,32642,41.0,2616,937,65238,50.0,2639,20.0,1106,29,1974
108,4/1/2021,5107,196056,3331,123188,1787,73386,148.0,30074,76.0,32718,73.0,2689,1636,66874,60.0,2699,18.0,1124,31,2005
109,4/2/2021,4706,200762,2523,125711,2185,75571,245.0,30319,49.0,32767,82.0,2771,1988,68862,90.0,2789,25.0,1149,27,2032
110,4/3/2021,4260,205022,3529,129240,765,76336,94.0,30413,40.0,32807,37.0,2808,680,69542,28.0,2817,20.0,1169,68,2100
111,4/4/2021,370,205392,256,129496,132,76468,6.0,30419,7.0,32814,3.0,2811,116,69658,11.0,2828,2.0,1171,33,2133
112,4/5/2021,4687,210079,3756,133252,955,77423,75.0,30494,46.0,32860,70.0,2881,817,70475,48.0,2876,20.0,1191,90,2223
113,4/6/2021,5160,215239,3030,136282,2320,79743,85.0,30579,58.0,32918,80.0,2961,2057,72532,125.0,3001,58.0,1249,269,2492
114,4/7/2021,4965,220204,3685,139967,2190,81933,59.0,30638,109.0,33027,118.0,3079,1862,74394,135.0,3136,75.0,1324,1146,3638
115,4/8/2021,6683,226887,4509,144476,2879,84812,137.0,30775,123.0,33150,135.0,3214,2527,76921,141.0,3277,76.0,1400,918,4556
116,4/9/2021,5721,232608,3263,147739,3239,88051,77.0,30852,71.0,33221,162.0,3376,2806,79727,182.0,3459,89.0,1489,802,5358
117,4/10/2021,4425,237033,3162,150901,1747,89798,51.0,30903,71.0,33292,99.0,3475,1476,81203,119.0,3578,53.0,1542,510,5868
118,4/11/2021,1039,238072,796,151697,289,90087,5.0,30908,11.0,33303,12.0,3487,242,81445,24.0,3602,11.0,1553,57,5925
119,4/12/2021,5036,243108,3637,155334,2027,92114,76.0,30984,96.0,33399,77.0,3564,1755,83200,134.0,3736,61.0,1614,498,6423
120,4/13/2021,5033,248141,3562,158896,1486,93600,55.0,31039,77.0,33476,70.0,3634,1296,84496,96.0,3832,24.0,1638,21,6444
121,4/14/2021,2954,251095,1439,160335,1509,95109,86.0,31125,26.0,33502,93.0,3727,1313,85809,70.0,3902,33.0,1671,2,6446
122,4/15/2021,4950,256045,2327,162662,2608,97717,102.0,31227,58.0,33560,218.0,3945,2168,87977,161.0,4063,61.0,1732,2,6448
123,4/16/2021,3906,259951,2077,164739,1818,99535,44.0,31271,34.0,33594,66.0,4011,1591,89568,126.0,4189,35.0,1767,4,6452
124,4/17/2021,4583,264534,2405,167144,2164,101699,39.0,31310,57.0,33651,97.0,4108,1883,91451,132.0,4321,52.0,1819,3,6455
125,4/18/2021,1039,265573,407,167551,625,102324,13.0,31323,11.0,33662,42.0,4150,520,91971,33.0,4354,30.0,1849,4,6459
126,4/19/2021,3865,269438,1411,168962,2431,104755,44.0,31367,40.0,33702,166.0,4316,2043,94014,162.0,4516,60.0,1909,5,6464
127,4/20/2021,4700,274138,1869,170831,2818,107573,47.0,31414,69.0,33771,160.0,4476,2400,96414,193.0,4709,65.0,1974,5,6469
128,4/21/2021,3166,277304,710,171541,2447,110020,34.0,31448,32.0,33803,146.0,4622,2059,98473,163.0,4872,79.0,2053,4,6473
129,4/22/2021,4656,281960,1772,173313,2871,112891,46.0,31494,62.0,33865,143.0,4765,2461,100934,193.0,5065,74.0,2127,3,6476
130,4/23/2021,3592,285552,1180,174493,2397,115288,41.0,31535,30.0,33895,73.0,4838,2113,103047,128.0,5193,83.0,2210,5,6481
131,4/24/2021,3361,288913,1119,175612,2236,117524,14.0,31549,21.0,33916,103.0,4941,1897,104944,194.0,5387,42.0,2252,6,6487
132,4/25/2021,794,289707,343,175955,450,117974,6.0,31555,6.0,33922,103.0,5044,268,105212,38.0,5425,41.0,2293,1,6488
133,4/26/2021,4357,294064,1112,177067,3238,121212,35.0,31590,30.0,33952,146.0,5190,2785,107997,214.0,5639,93.0,2386,4,6492
134,4/27/2021,3342,297406,1190,178257,2145,123357,37.0,31627,37.0,33989,80.0,5270,1888,109885,134.0,5773,43.0,2429,10,6502
135,4/28/2021,2990,300396,715,178972,2276,125633,45.0,31672,20.0,34009,166.0,5436,1845,111730,196.0,5969,69.0,2498,12,6514
136,4/29/2021,3969,304365,823,179795,3140,128773,67.0,31739,32.0,34041,227.0,5663,2580,114310,225.0,6194,108.0,2606,7,6521
137,4/30/2021,2867,307232,639,180434,2228,131001,44.0,31783,24.0,34065,73.0,5736,1894,116204,198.0,6392,63.0,2669,10,6531
138,5/1/2021,3645,310877,817,181251,2810,133811,35.0,31818,18.0,34083,283.0,6019,2188,118392,200.0,6592,139.0,2808,16,6547
139,5/2/2021,531,311408,235,181486,307,134118,7.0,31825,2.0,34085,11.0,6030,248,118640,38.0,6630,10.0,2818,10,6557
140,5/3/2021,3420,314828,634,182120,2785,136903,46.0,31871,34.0,34119,107.0,6137,2389,121029,212.0,6842,77.0,2895,12,6569
141,5/4/2021,4343,319171,696,182816,3667,140570,67.0,31938,27.0,34146,148.0,6285,3149,124178,258.0,7100,112.0,3007,27,6596
142,5/5/2021,2229,321400,477,183293,1788,142358,63.0,32001,24.0,34170,86.0,6371,1480,125658,141.0,7241,81.0,3088,13,6609
143,5/6/2021,3686,325086,820,184113,2984,145342,100.0,32101,40.0,34210,178.0,6549,2472,128130,198.0,7439,136.0,3224,45,6654
144,5/7/2021,2938,328024,544,184657,2487,147829,44.0,32145,11.0,34221,134.0,6683,2044,130174,211.0,7650,98.0,3322,37,6691
145,5/8/2021,2985,331009,553,185210,2538,150367,45.0,32190,16.0,34237,167.0,6850,2046,132220,194.0,7844,131.0,3453,45,6736
146,5/9/2021,365,331374,140,185350,238,150605,4.0,32194,2.0,34239,10.0,6860,198,132418,20.0,7864,10.0,3463,3,6739
147,5/10/2021,2426,333800,378,185728,2083,152688,60.0,32254,16.0,34255,87.0,6947,1693,134111,206.0,8070,97.0,3560,24,6763
148,5/11/2021,2719,336519,543,186271,2219,154907,92.0,32346,24.0,34279,190.0,7137,1726,135837,204.0,8274,99.0,3659,17,6780
149,5/12/2021,1225,337744,458,186729,819,155726,23.0,32369,14.0,34293,48.0,7185,649,136486,87.0,8361,35.0,3694,23,6803
150,5/13/2021,3250,340994,1030,187759,2236,157962,82.0,32451,25.0,34318,151.0,7336,1821,138307,159.0,8520,105.0,3799,16,6819
151,5/14/2021,2473,343467,1279,189038,1294,159256,51.0,32502,30.0,34348,64.0,7400,1073,139380,102.0,8622,55.0,3854,32,6851
152,5/15/2021,3015,346482,1506,190544,1596,160852,39.0,32541,15.0,34363,114.0,7514,1266,140646,142.0,8764,74.0,3928,23,6874
153,5/16/2021,944,347426,573,191117,404,161256,8.0,32549,8.0,34371,83.0,7597,251,140897,29.0,8793,41.0,3969,10,6884
154,5/17/2021,2447,349873,1210,192327,1309,162565,37.0,32586,27.0,34398,48.0,7645,1099,141996,101.0,8894,61.0,4030,20,6904
155,5/18/2021,2583,352456,1174,193501,1443,164008,44.0,32630,22.0,34420,73.0,7718,1208,143204,84.0,8978,78.0,4108,19,6923
156,5/19/2021,1874,354330,1154,194655,785,164793,24.0,32654,19.0,34439,42.0,7760,635,143839,69.0,9047,39.0,4147,15,6938
157,5/20/2021,1978,356308,922,195577,1100,165893,46.0,32700,27.0,34466,95.0,7855,874,144713,81.0,9128,50.0,4197,17,6955
158,5/21/2021,1630,357938,925,196502,786,166679,18.0,32718,16.0,34482,44.0,7899,627,145340,58.0,9186,57.0,4254,26,6981
159,5/22/2021,1683,359621,791,197293,921,167600,9.0,32727,13.0,34495,122.0,8021,639,145979,74.0,9260,86.0,4340,15,6996
160,5/23/2021,683,360304,343,197636,370,167970,2.0,32729,5.0,34500,70.0,8091,227,146206,18.0,9278,55.0,4395,3,6999
161,5/24/2021,1333,361637,537,198173,848,168818,36.0,32765,20.0,34520,43.0,8134,684,146890,80.0,9358,41.0,4436,19,7018
162,5/25/2021,1231,362868,508,198681,755,169573,22.0,32787,20.0,34540,57.0,8191,569,147459,64.0,9422,65.0,4501,18,7036
163,5/26/2021,967,363835,555,199236,530,170103,17.0,32804,25.0,34565,37.0,8228,418,147877,44.0,9466,31.0,4532,21,7057
164,5/27/2021,1269,365104,657,199893,677,170780,32.0,32836,19.0,34584,54.0,8282,546,148423,50.0,9516,27.0,4559,19,7076
165,5/28/2021,1031,366135,598,200491,477,171257,18.0,32854,22.0,34606,30.0,8312,373,148796,46.0,9562,28.0,4587,17,7093
166,5/29/2021,1020,367155,493,200984,564,171821,18.0,32872,8.0,34614,32.0,8344,444,149240,43.0,9605,45.0,4632,12,7105
167,5/30/2021,331,367486,220,201204,144,171965,5.0,32877,3.0,34617,13.0,8357,104,149344,17.0,9622,10.0,4642,8,7113
168,5/31/2021,340,367826,191,201395,175,172140,8.0,32885,6.0,34623,8.0,8365,140,149484,13.0,9635,14.0,4656,11,7124
169,6/1/2021,965,368791,394,201789,603,172743,27.0,32912,17.0,34640,49.0,8414,461,149945,46.0,9681,47.0,4703,23,7147
170,6/2/2021,719,369510,368,202157,407,173150,16.0,32928,8.0,34648,34.0,8448,322,150267,23.0,9704,28.0,4731,7,7154
171,6/3/2021,1306,370816,523,202680,834,173984,22.0,32950,12.0,34660,46.0,8494,689,150956,57.0,9761,42.0,4773,14,7168
172,6/4/2021,1502,372318,405,203085,1139,175123,16.0,32966,9.0,34669,70.0,8564,951,151907,70.0,9831,48.0,4821,4,7172
173,6/5/2021,1413,373731,357,203442,1084,176207,12.0,32978,6.0,34675,64.0,8628,888,152795,92.0,9923,40.0,4861,9,7181
174,6/6/2021,531,374262,142,203584,400,176607,5.0,32983,3.0,34678,43.0,8671,320,153115,25.0,9948,12.0,4873,8,7189
175,6/7/2021,1191,375453,333,203917,903,177510,14.0,32997,12.0,34690,67.0,8738,721,153836,83.0,10031,32.0,4905,17,7206
176,6/8/2021,1082,376535,253,204170,853,178363,18.0,33015,5.0,34695,57.0,8795,694,154530,67.0,10098,35.0,4940,4,7210
177,6/9/2021,1080,377615,283,204453,843,179206,15.0,33030,12.0,34707,78.0,8873,646,155176,72.0,10170,47.0,4987,12,7222
178,6/10/2021,1310,378925,334,204787,1013,180219,20.0,33050,4.0,34711,92.0,8965,799,155975,67.0,10237,55.0,5042,10,7232
179,6/11/2021,1113,380038,326,205113,830,181049,19.0,33069,13.0,34724,57.0,9022,651,156626,78.0,10315,44.0,5086,9,7241
180,6/12/2021,1040,381078,288,205401,793,181842,15.0,33084,9.0,34733,73.0,9095,614,157240,62.0,10377,44.0,5130,9,7250
181,6/13/2021,370,381448,96,205497,285,182127,4.0,33088,1.0,34734,37.0,9132,204,157444,25.0,10402,19.0,5149,5,7255
182,6/14/2021,830,382278,282,205779,592,182719,15.0,33103,4.0,34738,44.0,9176,449,157893,42.0,10444,57.0,5206,6,7261
183,6/15/2021,695,382973,238,206017,479,183198,20.0,33123,10.0,34748,40.0,9216,389,158282,34.0,10478,16.0,5222,2,7263
184,6/16/2021,622,383595,202,206219,446,183644,12.0,33135,4.0,34752,38.0,9254,339,158621,33.0,10511,36.0,5258,9,7272
185,6/17/2021,693,384288,250,206469,469,184113,13.0,33148,10.0,34762,41.0,9295,350,158971,49.0,10560,29.0,5287,3,7275
186,6/18/2021,1036,385324,380,206849,686,184799,23.0,33171,11.0,34773,52.0,9347,554,159525,51.0,10611,29.0,5316,7,7282
187,6/19/2021,634,385958,154,207003,495,185294,10.0,33181,6.0,34779,49.0,9396,366,159891,53.0,10664,27.0,5343,9,7291
188,6/20/2021,302,386260,114,207117,194,185488,3.0,33184,2.0,34781,37.0,9433,120,160011,15.0,10679,22.0,5365,5,7296
189,6/21/2021,516,386776,214,207331,328,185816,5.0,33189,8.0,34789,29.0,9462,241,160252,36.0,10715,22.0,5387,8,7304
190,6/22/2021,606,387382,249,207580,387,186203,12.0,33201,7.0,34796,31.0,9493,302,160554,25.0,10740,29.0,5416,5,7309
191,6/23/2021,513,387895,187,207767,353,186556,7.0,33208,10.0,34806,38.0,9531,256,160810,37.0,10777,22.0,5438,11,7320
192,6/24/2021,517,388412,210,207977,331,186887,12.0,33220,9.0,34815,30.0,9561,257,161067,23.0,10800,21.0,5459,1,7321
193,6/25/2021,687,389099,273,208250,436,187323,12.0,33232,8.0,34823,42.0,9603,322,161389,42.0,10842,30.0,5489,5,7326
194,6/26/2021,596,389695,165,208415,440,187763,9.0,33241,9.0,34832,77.0,9680,288,161677,43.0,10885,32.0,5521,4,7330
195,6/27/2021,183,389878,71,208486,113,187876,2.0,33243,3.0,34835,9.0,9689,82,161759,12.0,10897,10.0,5531,2,7332
196,6/28/2021,486,390364,209,208695,284,188160,7.0,33250,6.0,34841,39.0,9728,205,161964,24.0,10921,16.0,5547,2,7334
197,6/29/2021,555,390919,252,208947,325,188485,16.0,33266,11.0,34852,42.0,9770,235,162199,22.0,10943,26.0,5573,10,7344
198,6/30/2021,411,391330,206,209153,219,188704,8.0,33274,11.0,34863,19.0,9789,164,162363,16.0,10959,20.0,5593,12,7356
199,7/1/2021,485,391815,208,209361,295,188999,8.0,33282,7.0,34870,21.0,9810,221,162584,33.0,10992,20.0,5613,4,7360
200,7/2/2021,569,392384,273,209634,307,189306,5.0,33287,7.0,34877,26.0,9836,242,162826,23.0,11015,16.0,5629,3,7363
201,7/3/2021,308,392692,120,209754,195,189501,4.0,33291,3.0,34880,29.0,9865,126,162952,21.0,11036,19.0,5648,5,7368
202,7/4/2021,53,392745,18,209772,35,189536,1.0,33292,0.0,34880,4.0,9869,22,162974,1.0,11037,8.0,5656,0,7368
203,7/5/2021,317,393062,141,209913,174,189710,3.0,33295,1.0,34881,18.0,9887,120,163094,26.0,11063,10.0,5666,4,7372
204,7/6/2021,449,393511,188,210101,270,189980,4.0,33299,5.0,34886,45.0,9932,192,163286,18.0,11081,15.0,5681,1,7373
205,7/7/2021,369,393880,208,210309,175,190155,7.0,33306,6.0,34892,19.0,9951,130,163416,11.0,11092,15.0,5696,4,7377
206,7/8/2021,426,394306,201,210510,246,190401,10.0,33316,8.0,34900,23.0,9974,177,163593,23.0,11115,23.0,5719,3,7380
207,7/9/2021,482,394788,194,210704,294,190695,9.0,33325,2.0,34902,36.0,10010,216,163809,24.0,11139,18.0,5737,6,7386
208,7/10/2021,258,395046,145,210849,128,190823,5.0,33330,2.0,34904,5.0,10015,106,163915,10.0,11149,7.0,5744,2,7388
209,7/11/2021,224,395270,121,210970,121,190944,6.0,33336,6.0,34910,11.0,10026,87,164002,10.0,11159,13.0,5757,7,7395
210,7/12/2021,385,395655,202,211172,196,191140,7.0,33343,4.0,34914,25.0,10051,130,164132,24.0,11183,17.0,5774,4,7399
211,7/13/2021,438,396093,226,211398,226,191366,16.0,33359,10.0,34924,27.0,10078,176,164308,12.0,11195,11.0,5785,5,7404
212,7/14/2021,282,396375,149,211547,156,191522,8.0,33367,5.0,34929,19.0,10097,112,164420,10.0,11205,15.0,5800,7,7411
213,7/15/2021,360,396735,189,211736,182,191704,1.0,33368,4.0,34933,15.0,10112,137,164557,13.0,11218,17.0,5817,3,7414
214,7/16/2021,510,397245,244,211980,276,191980,8.0,33376,9.0,34942,24.0,10136,210,164767,22.0,11240,20.0,5837,5,7419
215,7/17/2021,277,397522,158,212138,129,192109,11.0,33387,5.0,34947,11.0,10147,97,164864,10.0,11250,11.0,5848,6,7425
216,7/18/2021,194,397716,118,212256,88,192197,4.0,33391,3.0,34950,13.0,10160,62,164926,6.0,11256,7.0,5855,4,7429
217,7/19/2021,405,398121,205,212461,206,192403,8.0,33399,8.0,34958,26.0,10186,150,165076,17.0,11273,13.0,5868,4,7433
218,7/20/2021,414,398535,208,212669,214,192617,6.0,33405,8.0,34966,12.0,10198,165,165241,23.0,11296,14.0,5882,5,7438
219,7/21/2021,335,398870,183,212852,173,192790,13.0,33418,14.0,34980,12.0,10210,130,165371,14.0,11310,17.0,5899,4,7442
220,7/22/2021,394,399264,234,213086,170,192960,8.0,33426,19.0,34999,18.0,10228,126,165497,18.0,11328,8.0,5907,6,7448
221,7/23/2021,549,399813,318,213404,235,193195,6.0,33432,10.0,35009,36.0,10264,161,165658,18.0,11346,20.0,5927,3,7451
222,7/24/2021,352,400165,215,213619,155,193350,8.0,33440,10.0,35019,19.0,10283,113,165771,9.0,11355,14.0,5941,6,7457
223,7/25/2021,199,400364,144,213763,63,193413,0.0,33440,4.0,35023,7.0,10290,45,165816,5.0,11360,6.0,5947,4,7461
224,7/26/2021,346,400710,200,213963,144,193557,1.0,33441,7.0,35030,11.0,10301,98,165914,18.0,11378,17.0,5964,4,7465
225,7/27/2021,422,401132,236,214199,173,193730,5.0,33446,16.0,35046,21.0,10322,122,166036,17.0,11395,13.0,5977,16,7481
226,7/28/2021,466,401598,285,214484,219,193949,3.0,33449,10.0,35056,28.0,10350,141,166177,16.0,11411,34.0,6011,5,7486
227,7/29/2021,511,402109,305,214789,237,194186,8.0,33457,6.0,35062,24.0,10374,181,166358,13.0,11424,19.0,6030,8,7494
228,7/30/2021,682,402791,473,215262,247,194433,10.0,33467,14.0,35076,25.0,10399,187,166545,16.0,11440,19.0,6049,5,7499
229,7/31/2021,334,403125,202,215464,135,194568,4.0,33471,1.0,35077,14.0,10413,107,166652,9.0,11449,5.0,6054,6,7505
230,8/1/2021,269,403394,170,215634,107,194675,0.0,33471,2.0,35079,15.0,10428,68,166720,8.0,11457,16.0,6070,8,7513
231,8/2/2021,445,403839,296,215930,173,194848,4.0,33475,13.0,35092,20.0,10448,120,166840,20.0,11477,13.0,6083,5,7518
232,8/3/2021,561,404400,347,216277,240,195088,6.0,33481,13.0,35105,37.0,10485,162,167002,15.0,11492,26.0,6109,4,7522
233,8/4/2021,390,404790,273,216550,138,195226,3.0,33484,14.0,35119,10.0,10495,105,167107,5.0,11497,18.0,6127,10,7532
234,8/5/2021,445,405235,286,216836,170,195396,5.0,33489,11.0,35130,20.0,10515,122,167229,17.0,11514,11.0,6138,4,7536
235,8/6/2021,679,405914,462,217298,264,195660,12.0,33501,16.0,35146,22.0,10537,200,167429,22.0,11536,20.0,6158,3,7539
236,8/7/2021,439,406353,305,217603,157,195817,4.0,33505,10.0,35156,12.0,10549,124,167553,5.0,11541,16.0,6174,5,7544
237,8/8/2021,217,406570,126,217729,98,195915,3.0,33508,5.0,35161,8.0,10557,71,167624,6.0,11547,13.0,6187,6,7550
238,8/9/2021,464,407034,281,218010,214,196129,4.0,33512,6.0,35167,22.0,10579,158,167782,11.0,11558,23.0,6210,7,7557
239,8/10/2021,502,407536,300,218310,227,196356,6.0,33518,14.0,35181,25.0,10604,179,167961,10.0,11568,13.0,6223,8,7565
240,8/11/2021,417,407953,265,218575,175,196531,11.0,33529,5.0,35186,16.0,10620,133,168094,14.0,11582,12.0,6235,3,7568
241,8/12/2021,542,408495,320,218895,258,196789,7.0,33536,13.0,35199,31.0,10651,181,168275,23.0,11605,23.0,6258,7,7575
242,8/13/2021,659,409154,379,219274,298,197087,11.0,33547,9.0,35208,31.0,10682,217,168492,19.0,11624,31.0,6289,6,7581
243,8/14/2021,502,409656,256,219530,249,197336,7.0,33554,9.0,35217,10.0,10692,213,168705,9.0,11633,17.0,6306,50,7631
244,8/15/2021,264,409920,129,219659,124,197460,2.0,33556,3.0,35220,11.0,10703,90,168795,6.0,11639,17.0,6323,19,7650
245,8/16/2021,538,410458,309,219968,168,197628,4.0,33560,11.0,35231,15.0,10718,128,168923,13.0,11652,12.0,6335,79,7729
246,8/17/2021,481,410939,227,220195,193,197821,20.0,33580,10.0,35241,17.0,10735,146,169069,10.0,11662,20.0,6355,82,7811
247,8/18/2021,592,411531,324,220519,256,198077,6.0,33586,16.0,35257,31.0,10766,172,169241,13.0,11675,40.0,6395,75,7886
248,8/19/2021,566,412097,278,220797,256,198333,7.0,33593,9.0,35266,21.0,10787,205,169446,17.0,11692,13.0,6408,77,7963
249,8/20/2021,840,412937,339,221136,452,198785,16.0,33609,11.0,35277,44.0,10831,358,169804,29.0,11721,21.0,6429,92,8055
250,8/21/2021,645,413582,209,221345,209,198994,4.0,33613,7.0,35284,14.0,10845,171,169975,13.0,11734,11.0,6440,206,8261
251,8/22/2021,317,413899,150,221495,144,199138,1.0,33614,2.0,35286,19.0,10864,102,170077,9.0,11743,14.0,6454,31,8292
252,8/23/2021,527,414426,262,221757,222,199360,10.0,33624,9.0,35295,19.0,10883,168,170245,12.0,11755,23.0,6477,62,8354
253,8/24/2021,570,414996,272,222029,277,199637,10.0,33634,8.0,35303,27.0,10910,217,170462,15.0,11770,18.0,6495,57,8411
254,8/25/2021,593,415589,321,222350,259,199896,12.0,33646,13.0,35316,19.0,10929,197,170659,10.0,11780,33.0,6528,48,8459
255,8/26/2021,534,416123,262,222612,252,200148,9.0,33655,14.0,35330,18.0,10947,193,170852,23.0,11803,18.0,6546,44,8503
256,8/27/2021,888,417011,351,222963,405,200553,15.0,33670,11.0,35341,37.0,10984,301,171153,22.0,11825,45.0,6591,158,8661
257,8/28/2021,1465,418476,202,223165,249,200802,7.0,33677,5.0,35346,23.0,11007,184,171337,14.0,11839,28.0,6619,995,9656
258,8/29/2021,1081,419557,161,223326,136,200938,4.0,33681,4.0,35350,8.0,11015,111,171448,12.0,11851,5.0,6624,773,10429
259,8/30/2021,618,420175,272,223598,282,201220,9.0,33690,13.0,35363,24.0,11039,217,171665,9.0,11860,32.0,6656,95,10524
260,8/31/2021,809,420984,234,223832,236,201456,7.0,33697,12.0,35375,18.0,11057,187,171852,18.0,11878,13.0,6669,344,10868
261,9/1/2021,951,421935,248,224080,221,201677,12.0,33709,15.0,35390,21.0,11078,168,172020,13.0,11891,19.0,6688,494,11362
262,9/2/2021,829,422764,185,224265,205,201882,13.0,33722,14.0,35404,19.0,11097,152,172172,16.0,11907,18.0,6706,464,11826
263,9/3/2021,856,423620,339,224604,374,202256,13.0,33735,12.0,35416,46.0,11143,272,172444,20.0,11927,36.0,6742,163,11989
264,9/4/2021,376,423996,164,224768,164,202420,6.0,33741,8.0,35424,13.0,11156,127,172571,11.0,11938,13.0,6755,58,12047
265,9/5/2021,251,424247,131,224899,108,202528,2.0,33743,4.0,35428,12.0,11168,77,172648,9.0,11947,10.0,6765,21,12068
266,9/6/2021,112,424359,47,224946,58,202586,1.0,33744,0.0,35428,4.0,11172,43,172691,8.0,11955,3.0,6768,12,12080
267,9/7/2021,952,425311,199,225145,275,202861,19.0,33763,12.0,35440,23.0,11195,208,172899,19.0,11974,25.0,6793,483,12563
268,9/8/2021,789,426100,219,225364,224,203085,11.0,33774,12.0,35452,24.0,11219,166,173065,10.0,11984,24.0,6817,372,12935
269,9/9/2021,403,426503,176,225540,195,203280,9.0,33783,8.0,35460,21.0,11240,143,173208,14.0,11998,17.0,6834,55,12990
270,9/10/2021,751,427254,339,225879,306,203586,9.0,33792,23.0,35483,28.0,11268,230,173438,20.0,12018,28.0,6862,147,13137
271,9/11/2021,1635,428889,163,226042,210,203796,10.0,33802,19.0,35502,18.0,11286,160,173598,15.0,12033,17.0,6879,1274,14411
272,9/12/2021,232,429121,101,226143,113,203909,1.0,33803,2.0,35504,11.0,11297,72,173670,10.0,12043,20.0,6899,16,14427
273,9/13/2021,492,429613,220,226363,245,204154,9.0,33812,8.0,35512,24.0,11321,184,173854,12.0,12055,25.0,6924,45,14472
274,9/14/2021,843,430456,204,226567,273,204427,14.0,33826,16.0,35528,17.0,11338,219,174073,14.0,12069,23.0,6947,403,14875
275,9/15/2021,829,431285,189,226756,266,204693,15.0,33841,15.0,35543,21.0,11359,196,174269,17.0,12086,32.0,6979,398,15273
276,9/16/2021,356,431641,134,226890,195,204888,9.0,33850,8.0,35551,33.0,11392,139,174408,11.0,12097,12.0,6991,42,15315
277,9/17/2021,746,432387,284,227174,387,205275,13.0,33863,13.0,35564,29.0,11421,289,174697,38.0,12135,31.0,7022,123,15438
278,9/18/2021,1839,434226,128,227302,171,205446,5.0,33868,20.0,35584,10.0,11431,126,174823,15.0,12150,20.0,7042,1545,16983
279,9/19/2021,181,434407,74,227376,106,205552,3.0,33871,2.0,35586,6.0,11437,82,174905,5.0,12155,13.0,7055,11,16994
280,9/20/2021,385,434792,143,227519,217,205769,8.0,33879,9.0,35595,27.0,11464,161,175066,10.0,12165,19.0,7074,55,17049
281,9/21/2021,771,435563,166,227685,199,205968,9.0,33888,14.0,35609,21.0,11485,153,175219,8.0,12173,17.0,7091,422,17471
282,9/22/2021,719,436282,164,227849,230,206198,6.0,33894,12.0,35621,15.0,11500,181,175400,16.0,12189,18.0,7109,363,17834
283,9/23/2021,348,436630,144,227993,179,206377,8.0,33902,3.0,35624,9.0,11509,132,175532,13.0,12202,25.0,7134,47,17881
284,9/24/2021,695,437325,208,228201,274,206651,16.0,33918,16.0,35640,20.0,11529,217,175749,11.0,12213,26.0,7160,232,18113
285,9/25/2021,1734,439059,137,228338,176,206827,11.0,33929,21.0,35661,15.0,11544,137,175886,12.0,12225,12.0,7172,1427,19540
286,9/26/2021,264,439323,65,228403,88,206915,3.0,33932,3.0,35664,11.0,11555,66,175952,4.0,12229,7.0,7179,110,19650
287,9/27/2021,565,439888,155,228558,124,207039,7.0,33939,11.0,35675,7.0,11562,96,176048,8.0,12237,13.0,7192,302,19952
288,9/28/2021,1128,441016,158,228716,203,207242,19.0,33958,23.0,35698,15.0,11577,154,176202,9.0,12246,25.0,7217,790,20742
289,9/29/2021,1140,442156,174,228890,171,207413,12.0,33970,19.0,35717,15.0,11592,127,176329,7.0,12253,22.0,7239,810,21552
290,9/30/2021,705,442861,161,229051,167,207580,15.0,33985,7.0,35724,11.0,11603,128,176457,10.0,12263,18.0,7257,407,21959
291,10/1/2021,1059,443920,174,229225,301,207881,20.0,34005,15.0,35739,20.0,11623,238,176695,21.0,12284,22.0,7279,600,22559
292,10/2/2021,1816,445736,118,229343,116,207997,12.0,34017,14.0,35753,9.0,11632,97,176792,5.0,12289,5.0,7284,1588,24147
293,10/3/2021,391,446127,64,229407,112,208109,1.0,34018,2.0,35755,18.0,11650,76,176868,7.0,12296,11.0,7295,227,24374
294,10/4/2021,794,446921,113,229520,155,208264,7.0,34025,12.0,35767,26.0,11676,102,176970,14.0,12310,13.0,7308,533,24907
295,10/5/2021,1116,448037,139,229659,135,208399,12.0,34037,17.0,35784,13.0,11689,103,177073,5.0,12315,14.0,7322,853,25760
296,10/6/2021,996,449033,105,229764,155,208554,8.0,34045,14.0,35798,11.0,11700,122,177195,5.0,12320,17.0,7339,752,26512
297,10/7/2021,784,449817,132,229896,107,208661,8.0,34053,14.0,35812,8.0,11708,83,177278,5.0,12325,11.0,7350,566,27078
298,10/8/2021,1036,450853,158,230054,239,208900,19.0,34072,13.0,35825,20.0,11728,186,177464,11.0,12336,22.0,7372,650,27728
299,10/9/2021,1676,452529,108,230162,131,209031,11.0,34083,8.0,35833,22.0,11750,98,177562,3.0,12339,8.0,7380,1439,29167
300,10/10/2021,244,452773,50,230212,63,209094,2.0,34085,2.0,35835,4.0,11754,49,177611,5.0,12344,5.0,7385,132,29299
301,10/11/2021,820,453593,123,230335,134,209228,16.0,34101,18.0,35853,3.0,11757,110,177721,10.0,12354,11.0,7396,574,29873
302,10/12/2021,1023,454616,118,230453,132,209360,8.0,34109,20.0,35873,16.0,11773,104,177825,4.0,12358,8.0,7404,783,30656
303,10/13/2021,970,455586,116,230569,150,209510,16.0,34125,8.0,35881,16.0,11789,114,177939,12.0,12370,8.0,7412,722,31378
304,10/14/2021,712,456298,102,230671,127,209637,14.0,34139,9.0,35890,20.0,11809,94,178033,8.0,12378,5.0,7417,490,31868
305,10/15/2021,1028,457326,177,230848,215,209852,11.0,34150,7.0,35897,15.0,11824,169,178202,13.0,12391,18.0,7435,671,32539
306,10/16/2021,803,458129,66,230914,80,209932,4.0,34154,3.0,35900,6.0,11830,69,178271,2.0,12393,3.0,7438,657,33196
307,10/17/2021,196,458325,48,230962,63,209995,1.0,34155,2.0,35902,4.0,11834,47,178318,3.0,12396,9.0,7447,83,33279
308,10/18/2021,652,458977,119,231081,135,210130,10.0,34165,4.0,35906,13.0,11847,106,178424,6.0,12402,10.0,7457,413,33692
309,10/19/2021,1050,460027,121,231202,133,210263,4.0,34169,11.0,35917,8.0,11855,107,178531,8.0,12410,10.0,7467,806,34498
310,10/20/2021,893,460920,122,231324,121,210384,6.0,34175,11.0,35928,9.0,11864,91,178622,7.0,12417,14.0,7481,664,35162
311,10/21/2021,534,461454,107,231431,128,210512,9.0,34184,8.0,35936,14.0,11878,86,178708,11.0,12428,17.0,7498,320,35482
312,10/22/2021,1479,462933,195,231626,230,210742,9.0,34193,13.0,35949,20.0,11898,171,178879,14.0,12442,25.0,7523,1075,36557
313,10/23/2021,1880,464813,88,231714,195,210937,14.0,34207,15.0,35964,4.0,11902,170,179049,11.0,12453,10.0,7533,1600,38157
314,10/24/2021,567,465380,81,231795,152,211089,8.0,34215,11.0,35975,12.0,11914,128,179177,7.0,12460,5.0,7538,347,38504
315,10/25/2021,1383,466763,137,231932,298,211387,27.0,34242,17.0,35992,12.0,11926,253,179430,21.0,12481,12.0,7550,962,39466
316,10/26/2021,2141,468904,176,232108,299,211686,14.0,34256,17.0,36009,19.0,11945,248,179678,18.0,12499,14.0,7564,1676,41142
317,10/27/2021,1971,470875,153,232261,274,211960,19.0,34275,19.0,36028,9.0,11954,242,179920,14.0,12513,9.0,7573,1552,42694
318,10/28/2021,1710,472585,139,232400,260,212220,11.0,34286,20.0,36048,11.0,11965,219,180139,17.0,12530,13.0,7586,1322,44016
319,10/29/2021,1657,474242,179,232579,279,212499,12.0,34298,15.0,36063,10.0,11975,244,180383,12.0,12542,13.0,7599,1211,45227
320,10/30/2021,1587,475829,81,232660,151,212650,13.0,34311,8.0,36071,6.0,11981,130,180513,9.0,12551,6.0,7605,1364,46591
321,10/31/2021,463,476292,48,232708,74,212724,2.0,34313,6.0,36077,6.0,11987,62,180575,4.0,12555,2.0,7607,340,46931
322,11/1/2021,1236,477528,136,232844,216,212940,10.0,34323,10.0,36087,10.0,11997,176,180751,12.0,12567,18.0,7625,892,47823
323,11/2/2021,1817,479345,130,232974,200,213140,8.0,34331,17.0,36104,14.0,12011,162,180913,13.0,12580,11.0,7636,1502,49325
324,11/3/2021,1743,481088,159,233133,229,213369,12.0,34343,17.0,36121,15.0,12026,181,181094,16.0,12596,17.0,7653,1371,50696
325,11/4/2021,1406,482494,143,233276,183,213552,4.0,34347,13.0,36134,1.0,12027,159,181253,12.0,12608,11.0,7664,1104,51800
326,11/5/2021,2017,484511,227,233503,298,213850,14.0,34361,12.0,36146,17.0,12044,249,181502,14.0,12622,18.0,7682,1524,53324
327,11/6/2021,1578,486089,215,233718,142,213992,4.0,34365,7.0,36153,6.0,12050,115,181617,15.0,12637,6.0,7688,1229,54553
328,11/7/2021,523,486612,120,233838,77,214069,1.0,34366,8.0,36161,5.0,12055,63,181680,3.0,12640,6.0,7694,327,54880
329,11/8/2021,1524,488136,386,234224,199,214268,7.0,34373,9.0,36170,11.0,12066,165,181845,9.0,12649,14.0,7708,960,55840
330,11/9/2021,2625,490761,940,235164,221,214489,10.0,34383,21.0,36191,15.0,12081,163,182008,16.0,12665,27.0,7735,1484,57324
331,11/10/2021,2481,493242,817,235981,223,214712,12.0,34395,18.0,36209,11.0,12092,177,182185,22.0,12687,13.0,7748,1464,58788
332,11/11/2021,2341,495583,961,236942,187,214899,17.0,34412,8.0,36217,13.0,12105,153,182338,13.0,12700,8.0,7756,1213,60001
333,11/12/2021,2546,498129,747,237689,240,215139,12.0,34424,19.0,36236,23.0,12128,191,182529,13.0,12713,13.0,7769,1570,61571
334,11/13/2021,1927,500056,406,238095,139,215278,3.0,34427,13.0,36249,7.0,12135,103,182632,15.0,12728,14.0,7783,1392,62963
335,11/14/2021,1481,501537,911,239006,107,215385,1.0,34428,2.0,36251,11.0,12146,72,182704,14.0,12742,10.0,7793,473,63436
336,11/15/2021,1954,503491,453,239459,199,215584,7.0,34435,11.0,36262,12.0,12158,159,182863,12.0,12754,16.0,7809,1323,64759
337,11/16/2021,2401,505892,456,239915,213,215797,5.0,34440,21.0,36283,26.0,12184,156,183019,17.0,12771,14.0,7823,1744,66503
338,11/17/2021,2719,508611,633,240548,269,216066,12.0,34452,16.0,36299,16.0,12200,222,183241,17.0,12788,14.0,7837,1848,68351
339,11/18/2021,1885,510496,378,240926,178,216244,7.0,34459,11.0,36310,15.0,12215,143,183384,15.0,12803,5.0,7842,1344,69695
340,11/19/2021,2558,513054,714,241640,280,216524,13.0,34472,14.0,36324,9.0,12224,233,183617,20.0,12823,18.0,7860,1584,71279
341,11/20/2021,1872,514926,530,242170,112,216636,6.0,34478,5.0,36329,8.0,12232,95,183712,4.0,12827,5.0,7865,1233,72512
342,11/21/2021,639,515565,124,242294,83,216719,0.0,34478,1.0,36330,3.0,12235,67,183779,8.0,12835,5.0,7870,433,72945
343,11/22/2021,1968,517533,425,242719,208,216927,11.0,34489,21.0,36351,10.0,12245,169,183948,11.0,12846,18.0,7888,1355,74300
344,11/23/2021,1833,519366,287,243006,184,217111,8.0,34497,15.0,36366,15.0,12260,148,184096,14.0,12860,7.0,7895,1371,75671
345,11/24/2021,1507,520873,215,243221,162,217273,6.0,34503,11.0,36377,14.0,12274,131,184227,11.0,12871,6.0,7901,1144,76815
346,11/25/2021,46,520919,9,243230,2,217275,0.0,34503,0.0,36377,0.0,12274,1,184228,1.0,12872,,7901,35,76850
347,11/26/2021,1256,522175,191,243421,202,217477,3.0,34506,4.0,36381,17.0,12291,163,184391,12.0,12884,10.0,7911,882,77732
348,11/27/2021,946,523121,138,243559,152,217629,2.0,34508,2.0,36383,7.0,12298,130,184521,8.0,12892,7.0,7918,658,78390
349,11/28/2021,539,523660,96,243655,104,217733,2.0,34510,2.0,36385,9.0,12307,83,184604,5.0,12897,7.0,7925,345,78735
350,11/29/2021,1838,525498,278,243933,407,218140,8.0,34518,14.0,36399,29.0,12336,338,184942,25.0,12922,15.0,7940,1174,79909
351,11/30/2021,2654,528152,345,244278,782,218922,8.0,34526,12.0,36411,50.0,12386,660,185602,61.0,12983,11.0,7951,1547,81456
352,12/1/2021,2425,530577,262,244540,742,219664,12.0,34538,9.0,36420,30.0,12416,652,186254,56.0,13039,4.0,7955,1431,82887
353,12/2/2021,2796,533373,350,244890,907,220571,9.0,34547,11.0,36431,68.0,12484,737,186991,73.0,13112,29.0,7984,1566,84453
354,12/3/2021,2579,535952,292,245182,750,221321,11.0,34558,4.0,36435,61.0,12545,591,187582,69.0,13181,29.0,8013,1557,86010
355,12/4/2021,2178,538130,161,245343,419,221740,4.0,34562,1.0,36436,24.0,12569,328,187910,36.0,13217,31.0,8044,1605,87615
356,12/5/2021,1377,539507,105,245448,840,222580,1.0,34563,0.0,36436,67.0,12636,667,188577,69.0,13286,37.0,8081,441,88056
357,12/6/2021,1913,541420,235,245683,465,223045,7.0,34570,5.0,36441,54.0,12690,361,188938,34.0,13320,16.0,8097,1225,89281
358,12/7/2021,2441,543861,304,245987,468,223513,10.0,34580,9.0,36450,49.0,12739,372,189310,31.0,13351,16.0,8113,1688,90969
359,12/8/2021,2223,546084,272,246259,510,224023,9.0,34589,12.0,36462,29.0,12768,427,189737,40.0,13391,14.0,8127,1463,92432
360,12/9/2021,2143,548227,303,246562,459,224482,6.0,34595,8.0,36470,27.0,12795,355,190092,43.0,13434,34.0,8161,1395,93827
361,12/10/2021,2084,550311,241,246803,402,224884,10.0,34605,9.0,36479,38.0,12833,312,190404,32.0,13466,20.0,8181,1449,95276
362,12/11/2021,1777,552088,136,246939,490,225374,6.0,34611,1.0,36480,59.0,12892,365,190769,40.0,13506,26.0,8207,1153,96429
363,12/12/2021,414,552502,55,246994,89,225463,1.0,34612,3.0,36483,4.0,12896,72,190841,7.0,13513,6.0,8213,273,96702
364,12/13/2021,1745,554247,298,247292,392,225855,9.0,34621,9.0,36492,26.0,12922,318,191159,35.0,13548,13.0,8226,1073,97775
365,12/14/2021,2174,556421,277,247569,364,226219,7.0,34628,5.0,36497,33.0,12955,298,191457,16.0,13564,17.0,8243,1558,99333
366,12/15/2021,1736,558157,204,247773,227,226446,6.0,34634,4.0,36501,9.0,12964,185,191642,18.0,13582,15.0,8258,1318,100651
367,12/16/2021,1757,559914,315,248088,243,226689,7.0,34641,7.0,36508,15.0,12979,204,191846,15.0,13597,9.0,8267,1217,101868
368,12/17/2021,2106,562020,308,248396,440,227129,6.0,34647,10.0,36518,28.0,13007,363,192209,38.0,13635,11.0,8278,1369,103237
369,12/18/2021,1800,563820,181,248577,240,227369,4.0,34651,4.0,36522,17.0,13024,205,192414,10.0,13645,8.0,8286,1380,104617
370,12/19/2021,434,564254,43,248620,80,227449,1.0,34652,3.0,36525,5.0,13029,66,192480,3.0,13648,6.0,8292,311,104928
371,12/20/2021,1548,565802,198,248818,241,227690,10.0,34662,9.0,36534,27.0,13056,191,192671,16.0,13664,7.0,8299,1114,106042
372,12/21/2021,2182,567984,308,249126,294,227984,10.0,34672,8.0,36542,28.0,13084,227,192898,25.0,13689,14.0,8313,1588,107630
373,12/22/2021,1869,569853,218,249344,285,228269,4.0,34676,9.0,36551,27.0,13111,228,193126,22.0,13711,8.0,8321,1369,108999
374,12/23/2021,1230,571083,216,249560,206,228475,5.0,34681,5.0,36556,23.0,13134,156,193282,16.0,13727,11.0,8332,821,109820
375,12/24/2021,320,571403,46,249606,63,228538,3.0,34684,2.0,36558,4.0,13138,54,193336,4.0,13731,1.0,8333,213,110033
376,12/25/2021,13,571416,4,249610,2,228540,0.0,34684,0.0,36558,,13138,1,193337,1.0,13732,,8333,7,110040
377,12/26/2021,353,571769,62,249672,68,228608,1.0,34685,0.0,36558,7.0,13145,53,193390,5.0,13737,3.0,8336,225,110265
378,12/27/2021,1247,573016,173,249845,222,228830,4.0,34689,5.0,36563,18.0,13163,176,193566,20.0,13757,8.0,8344,859,111124
379,12/28/2021,1887,574903,271,250116,293,229123,12.0,34701,12.0,36575,35.0,13198,228,193794,16.0,13773,14.0,8358,1327,112451
380,12/29/2021,1688,576591,210,250326,249,229372,5.0,34706,6.0,36581,27.0,13225,189,193983,22.0,13795,11.0,8369,1240,113691
381,12/30/2021,1360,577951,221,250547,237,229609,7.0,34713,9.0,36590,26.0,13251,184,194167,15.0,13810,12.0,8381,912,114603
382,12/31/2021,500,578451,97,250644,92,229701,0.0,34713,2.0,36592,7.0,13258,75,194242,5.0,13815,5.0,8386,314,114917
383,1/1/2022,93,578544,12,250656,16,229717,1.0,34714,1.0,36593,0.0,13258,13,194255,2.0,13817,1.0,8387,65,114982
384,1/2/2022,315,578859,45,250701,60,229777,1.0,34715,1.0,36594,7.0,13265,41,194296,9.0,13826,3.0,8390,211,115193
385,1/3/2022,1592,580451,331,251032,345,230122,4.0,34719,5.0,36599,34.0,13299,281,194577,20.0,13846,10.0,8400,926,116119
386,1/4/2022,1660,582111,265,251297,273,230395,10.0,34729,7.0,36606,29.0,13328,217,194794,17.0,13863,10.0,8410,1135,117254
387,1/5/2022,1329,583440,206,251503,200,230595,7.0,34736,8.0,36614,13.0,13341,163,194957,9.0,13872,15.0,8425,937,118191
388,1/6/2022,1222,584662,253,251756,228,230823,4.0,34740,4.0,36618,23.0,13364,170,195127,13.0,13885,22.0,8447,750,118941
389,1/7/2022,2052,586714,254,252010,340,231163,6.0,34746,9.0,36627,35.0,13399,262,195389,30.0,13915,13.0,8460,1470,120411
390,1/8/2022,1572,588286,125,252135,130,231293,0.0,34746,3.0,36630,7.0,13406,109,195498,7.0,13922,7.0,8467,1321,121732
391,1/9/2022,496,588782,92,252227,72,231365,0.0,34746,2.0,36632,14.0,13420,49,195547,3.0,13925,6.0,8473,333,122065
392,1/10/2022,1550,590332,287,252514,251,231616,3.0,34749,6.0,36638,19.0,13439,194,195741,27.0,13952,11.0,8484,1023,123088
393,1/11/2022,1557,591889,218,252732,274,231890,3.0,34752,4.0,36642,31.0,13470,209,195950,15.0,13967,19.0,8503,1077,124165
394,1/12/2022,1400,593289,179,252911,185,232075,6.0,34758,5.0,36647,29.0,13499,126,196076,20.0,13987,10.0,8513,1048,125213
395,1/13/2022,1096,594385,191,253102,178,232253,3.0,34761,2.0,36649,14.0,13513,132,196208,18.0,14005,14.0,8527,736,125949
396,1/14/2022,1615,596000,279,253381,214,232467,2.0,34763,8.0,36657,25.0,13538,156,196364,20.0,14025,13.0,8540,1137,127086
397,1/15/2022,1216,597216,138,253519,101,232568,1.0,34764,3.0,36660,11.0,13549,79,196443,9.0,14034,2.0,8542,978,128064
398,1/16/2022,289,597505,46,253565,35,232603,1.0,34765,0.0,36660,1.0,13550,31,196474,3.0,14037,0.0,8542,208,128272
399,1/17/2022,770,598275,157,253722,127,232730,4.0,34769,5.0,36665,12.0,13562,105,196579,8.0,14045,2.0,8544,488,128760
400,1/18/2022,886,599161,165,253887,164,232894,2.0,34771,6.0,36671,25.0,13587,125,196704,6.0,14051,8.0,8552,564,129324
401,1/19/2022,719,599880,122,254009,117,233011,4.0,34775,7.0,36678,9.0,13596,86,196790,10.0,14061,12.0,8564,492,129816
402,1/20/2022,779,600659,145,254154,147,233158,0.0,34775,10.0,36688,17.0,13613,111,196901,10.0,14071,9.0,8573,494,130310
403,1/21/2022,1170,601829,166,254320,172,233330,7.0,34782,2.0,36690,15.0,13628,133,197034,11.0,14082,13.0,8586,842,131152
404,1/22/2022,779,602608,89,254409,100,233430,0.0,34782,1.0,36691,14.0,13642,71,197105,6.0,14088,9.0,8595,593,131745
405,1/23/2022,209,602817,24,254433,53,233483,1.0,34783,0.0,36691,5.0,13647,41,197146,7.0,14095,0.0,8595,133,131878
406,1/24/2022,489,603306,77,254510,106,233589,1.0,34784,1.0,36692,14.0,13661,77,197223,8.0,14103,7.0,8602,309,132187
407,1/25/2022,661,603967,118,254628,142,233731,3.0,34787,2.0,36694,15.0,13676,99,197322,20.0,14123,8.0,8610,403,132590
408,1/26/2022,637,604604,99,254727,138,233869,7.0,34794,2.0,36696,12.0,13688,105,197427,13.0,14136,8.0,8618,409,132999
409,1/27/2022,611,605215,112,254839,170,234039,5.0,34799,1.0,36697,29.0,13717,125,197552,10.0,14146,6.0,8624,335,133334
410,1/28/2022,965,606180,164,255003,168,234207,6.0,34805,6.0,36703,20.0,13737,118,197670,14.0,14160,16.0,8640,638,133972
411,1/29/2022,556,606736,68,255071,83,234290,1.0,34806,4.0,36707,10.0,13747,60,197730,8.0,14168,5.0,8645,405,134377
412,1/30/2022,191,606927,33,255104,43,234333,1.0,34807,1.0,36708,13.0,13760,26,197756,1.0,14169,3.0,8648,117,134494
413,1/31/2022,553,607480,136,255240,120,234453,2.0,34809,2.0,36710,17.0,13777,79,197835,13.0,14182,11.0,8659,301,134795
414,2/1/2022,543,608023,95,255335,133,234586,0.0,34809,3.0,36713,17.0,13794,100,197935,11.0,14193,5.0,8664,317,135112
415,2/2/2022,124,608147,16,255351,45,234631,0.0,34809,0.0,36713,2.0,13796,41,197976,1.0,14194,1.0,8665,66,135178
416,2/3/2022,359,608506,75,255426,113,234744,0.0,34809,3.0,36716,24.0,13820,77,198053,6.0,14200,6.0,8671,176,135354
417,2/4/2022,583,609089,99,255525,122,234866,6.0,34815,3.0,36719,15.0,13835,96,198149,6.0,14206,5.0,8676,364,135718
418,2/5/2022,454,609543,57,255582,112,234978,2.0,34817,0.0,36719,7.0,13842,90,198239,6.0,14212,9.0,8685,287,136005
419,2/6/2022,71,609614,17,255599,15,234993,0.0,34817,1.0,36720,0.0,13842,9,198248,3.0,14215,3.0,8688,40,136045
