,Date,daily number of doses received by Larimer County residents,total number of doses recevied by residents,daily number of residents receiving first dose,total number of residents receiving first dose,daily number of residents vaccinated,total number of residents vaccinated,daily number of 70+ vaccinated,total number of 70+ vaccinated,daily number of 70+ at least one dose,total number of 70+ at least one dose,daily number of Latinx residents vaccinated,total of Latinx residents vaccinated,daily number of White non-Latinx residents vaccinated,total of White non-Latinx residents vaccinated,daily number of non-White non-Latinx residents vaccinated,total of non-White non-Latinx residents vaccinated,dailyUnknown,totalUnknown,daily_additional_doses,total_additional_doses
0,12/14/2020,32,32,32,32,1,1,0.0,0,1.0,1,0.0,0,1,1,0.0,0,,0,0,0
1,12/15/2020,13,45,13,45,0,1,,0,,1,,0,0,1,0.0,0,,0,0,0
2,12/16/2020,303,348,303,348,0,1,0.0,0,2.0,3,0.0,0,0,1,0.0,0,0.0,0,0,0
3,12/17/2020,989,1337,989,1337,0,1,0.0,0,11.0,14,0.0,0,0,1,0.0,0,0.0,0,0,0
4,12/18/2020,1056,2393,1056,2393,2,3,0.0,0,15.0,29,0.0,0,2,3,0.0,0,0.0,0,0,0
5,12/19/2020,721,3114,721,3114,0,3,0.0,0,14.0,43,0.0,0,0,3,0.0,0,0.0,0,0,0
6,12/20/2020,266,3380,266,3380,0,3,0.0,0,4.0,47,0.0,0,0,3,0.0,0,0.0,0,0,0
7,12/21/2020,357,3737,357,3737,3,6,0.0,0,3.0,50,0.0,0,3,6,0.0,0,0.0,0,0,0
8,12/22/2020,363,4100,363,4100,0,6,0.0,0,7.0,57,0.0,0,0,6,0.0,0,0.0,0,0,0
9,12/23/2020,438,4538,438,4538,0,6,0.0,0,6.0,63,0.0,0,0,6,0.0,0,0.0,0,0,0
10,12/24/2020,106,4644,106,4644,0,6,0.0,0,3.0,66,0.0,0,0,6,0.0,0,0.0,0,0,0
11,12/25/2020,1,4645,1,4645,0,6,,0,,66,,0,0,6,,0,,0,0,0
12,12/26/2020,227,4872,227,4872,1,7,0.0,0,3.0,69,0.0,0,1,7,0.0,0,0.0,0,0,0
13,12/27/2020,278,5150,278,5150,0,7,0.0,0,197.0,266,0.0,0,0,7,0.0,0,,0,0,0
14,12/28/2020,710,5860,710,5860,0,7,0.0,0,386.0,652,0.0,0,0,7,0.0,0,0.0,0,0,0
15,12/29/2020,909,6769,908,6768,1,8,0.0,0,460.0,1112,0.0,0,1,8,0.0,0,0.0,0,0,0
16,12/30/2020,883,7652,883,7651,0,8,0.0,0,273.0,1385,0.0,0,0,8,0.0,0,0.0,0,0,0
17,12/31/2020,895,8547,895,8546,0,8,0.0,0,342.0,1727,0.0,0,0,8,0.0,0,0.0,0,0,0
18,1/1/2021,4,8551,3,8549,1,9,,0,,1727,,0,1,9,,0,,0,0,0
19,1/2/2021,391,8942,391,8940,1,10,0.0,0,141.0,1868,0.0,0,1,10,0.0,0,0.0,0,0,0
20,1/3/2021,124,9066,124,9064,0,10,0.0,0,52.0,1920,0.0,0,0,10,0.0,0,0.0,0,0,0
21,1/4/2021,588,9654,575,9639,12,22,0.0,0,320.0,2240,0.0,0,10,20,2.0,2,0.0,0,0,0
22,1/5/2021,645,10299,636,10275,10,32,0.0,0,409.0,2649,0.0,0,9,29,1.0,3,0.0,0,0,0
23,1/6/2021,1230,11529,912,11187,310,342,4.0,4,515.0,3164,18.0,18,272,301,16.0,19,4.0,4,0,0
24,1/7/2021,1657,13186,702,11889,930,1272,11.0,15,406.0,3570,33.0,51,840,1141,42.0,61,15.0,19,0,0
25,1/8/2021,1991,15177,982,12871,988,2260,11.0,26,479.0,4049,48.0,99,878,2019,43.0,104,19.0,38,1,1
26,1/9/2021,1230,16407,530,13401,682,2942,12.0,38,303.0,4352,16.0,115,618,2637,37.0,141,11.0,49,0,1
27,1/10/2021,703,17110,428,13829,271,3213,4.0,42,261.0,4613,10.0,125,244,2881,14.0,155,3.0,52,0,1
28,1/11/2021,1148,18258,798,14627,347,3560,1.0,43,536.0,5149,10.0,135,315,3196,19.0,174,3.0,55,0,1
29,1/12/2021,1179,19437,881,15508,297,3857,8.0,51,518.0,5667,14.0,149,257,3453,18.0,192,8.0,63,1,2
30,1/13/2021,1079,20516,835,16343,241,4098,1.0,52,377.0,6044,23.0,172,195,3648,15.0,207,8.0,71,0,2
31,1/14/2021,872,21388,837,17180,35,4133,1.0,53,494.0,6538,2.0,174,31,3679,1.0,208,1.0,72,0,2
32,1/15/2021,1220,22608,1207,18387,13,4146,0.0,53,760.0,7298,0.0,174,13,3692,0.0,208,0.0,72,0,2
33,1/16/2021,984,23592,970,19357,14,4160,1.0,54,585.0,7883,0.0,174,13,3705,1.0,209,0.0,72,0,2
34,1/17/2021,54,23646,50,19407,4,4164,0.0,54,19.0,7902,0.0,174,2,3707,2.0,211,0.0,72,0,2
35,1/18/2021,1014,24660,812,20219,200,4364,48.0,102,598.0,8500,8.0,182,174,3881,13.0,224,5.0,77,2,4
36,1/19/2021,1257,25917,1117,21336,138,4502,7.0,109,738.0,9238,7.0,189,117,3998,6.0,230,8.0,85,0,4
37,1/20/2021,1423,27340,1204,22540,217,4719,17.0,126,572.0,9810,15.0,204,176,4174,9.0,239,17.0,102,1,5
38,1/21/2021,2253,29593,2044,24584,209,4928,7.0,133,1587.0,11397,13.0,217,174,4348,15.0,254,7.0,109,0,5
39,1/22/2021,1736,31329,1461,26045,274,5202,89.0,222,1090.0,12487,34.0,251,221,4569,13.0,267,6.0,115,0,5
40,1/23/2021,895,32224,562,26607,328,5530,54.0,276,417.0,12904,8.0,259,300,4869,13.0,280,7.0,122,0,5
41,1/24/2021,393,32617,104,26711,285,5815,205.0,481,61.0,12965,8.0,267,269,5138,8.0,288,,122,0,5
42,1/25/2021,1408,34025,786,27497,610,6425,360.0,841,554.0,13519,14.0,281,569,5707,15.0,303,12.0,134,0,5
43,1/26/2021,1623,35648,694,28191,914,7339,452.0,1293,442.0,13961,30.0,311,839,6546,32.0,335,13.0,147,0,5
44,1/27/2021,1836,37484,770,28961,1058,8397,532.0,1825,334.0,14295,40.0,351,965,7511,44.0,379,9.0,156,0,5
45,1/28/2021,1347,38831,539,29500,804,9201,355.0,2180,295.0,14590,25.0,376,736,8247,28.0,407,15.0,171,2,7
46,1/29/2021,1633,40464,1154,30654,474,9675,156.0,2336,824.0,15414,21.0,397,410,8657,33.0,440,10.0,181,0,7
47,1/30/2021,1227,41691,733,31387,490,10165,213.0,2549,598.0,16012,24.0,421,439,9096,21.0,461,6.0,187,0,7
48,1/31/2021,625,42316,399,31786,225,10390,76.0,2625,354.0,16366,5.0,426,199,9295,15.0,476,6.0,193,1,8
49,2/1/2021,1607,43923,903,32689,699,11089,466.0,3091,654.0,17020,17.0,443,646,9941,26.0,502,10.0,203,1,9
50,2/2/2021,1865,45788,731,33420,1125,12214,731.0,3822,583.0,17603,43.0,486,1037,10978,34.0,536,11.0,214,0,9
51,2/3/2021,1269,47057,584,34004,682,12896,323.0,4145,225.0,17828,48.0,534,584,11562,41.0,577,9.0,223,0,9
52,2/4/2021,2534,49591,1793,35797,730,13626,488.0,4633,1550.0,19378,29.0,563,654,12216,37.0,614,10.0,233,1,10
53,2/5/2021,2580,52171,1533,37330,1033,14659,680.0,5313,1305.0,20683,38.0,601,948,13164,30.0,644,17.0,250,2,12
54,2/6/2021,2216,54387,1594,38924,613,15272,441.0,5754,1239.0,21922,6.0,607,583,13747,22.0,666,2.0,252,0,12
55,2/7/2021,233,54620,89,39013,142,15414,95.0,5849,26.0,21948,7.0,614,126,13873,4.0,670,5.0,257,1,13
56,2/8/2021,2483,57103,1595,40608,879,16293,593.0,6442,1138.0,23086,26.0,640,808,14681,28.0,698,17.0,274,0,13
57,2/9/2021,2391,59494,1545,42153,840,17133,511.0,6953,998.0,24084,26.0,666,755,15436,32.0,730,27.0,301,0,13
58,2/10/2021,1586,61080,965,43118,616,17749,321.0,7274,288.0,24372,25.0,691,549,15985,26.0,756,16.0,317,4,17
59,2/11/2021,3533,64613,2000,45118,1521,19270,1051.0,8325,808.0,25180,55.0,746,1390,17375,49.0,805,27.0,344,2,19
60,2/12/2021,3264,67877,1811,46929,1437,20707,949.0,9274,800.0,25980,61.0,807,1321,18696,42.0,847,13.0,357,0,19
61,2/13/2021,2997,70874,2364,49293,625,21332,307.0,9581,672.0,26652,13.0,820,578,19274,22.0,869,12.0,369,1,20
62,2/14/2021,421,71295,350,49643,71,21403,49.0,9630,46.0,26698,2.0,822,64,19338,3.0,872,2.0,371,0,20
63,2/15/2021,2626,73921,2131,51774,491,21894,324.0,9954,256.0,26954,17.0,839,460,19798,12.0,884,2.0,373,0,20
64,2/16/2021,2755,76676,1921,53695,826,22720,496.0,10450,231.0,27185,35.0,874,751,20549,24.0,908,16.0,389,0,20
65,2/17/2021,1632,78308,654,54349,971,23691,479.0,10929,155.0,27340,29.0,903,886,21435,36.0,944,20.0,409,0,20
66,2/18/2021,2640,80948,1675,56024,950,24641,729.0,11658,275.0,27615,37.0,940,876,22311,30.0,974,7.0,416,1,21
67,2/19/2021,2421,83369,1031,57055,1371,26012,1013.0,12671,156.0,27771,44.0,984,1268,23579,44.0,1018,15.0,431,3,24
68,2/20/2021,1654,85023,689,57744,956,26968,780.0,13451,134.0,27905,22.0,1006,895,24474,29.0,1047,10.0,441,1,25
69,2/21/2021,109,85132,40,57784,68,27036,38.0,13489,8.0,27913,1.0,1007,65,24539,2.0,1049,0.0,441,0,25
70,2/22/2021,2024,87156,763,58547,1243,28279,918.0,14407,147.0,28060,37.0,1044,1159,25698,37.0,1086,10.0,451,1,26
71,2/23/2021,1225,88381,519,59066,704,28983,470.0,14877,161.0,28221,20.0,1064,635,26333,36.0,1122,13.0,464,0,26
72,2/24/2021,1412,89793,755,59821,650,29633,276.0,15153,136.0,28357,31.0,1095,595,26928,19.0,1141,5.0,469,1,27
73,2/25/2021,3866,93659,2072,61893,1784,31417,1503.0,16656,351.0,28708,47.0,1142,1684,28612,36.0,1177,17.0,486,0,27
74,2/26/2021,3274,96933,1157,63050,2109,33526,1744.0,18400,202.0,28910,33.0,1175,1988,30600,59.0,1236,29.0,515,2,29
75,2/27/2021,3490,100423,1662,64712,1816,35342,1555.0,19955,544.0,29454,36.0,1211,1701,32301,52.0,1288,27.0,542,1,30
76,2/28/2021,429,100852,359,65071,69,35411,43.0,19998,115.0,29569,2.0,1213,63,32364,2.0,1290,2.0,544,0,30
77,3/1/2021,2821,103673,1346,66417,1467,36878,1076.0,21074,299.0,29868,53.0,1266,1356,33720,46.0,1336,12.0,556,5,35
78,3/2/2021,3256,106929,1727,68144,1521,38399,1052.0,22126,383.0,30251,38.0,1304,1412,35132,44.0,1380,27.0,583,1,36
79,3/3/2021,1658,108587,1093,69237,562,38961,174.0,22300,203.0,30454,32.0,1336,502,35634,24.0,1404,4.0,587,0,36
80,3/4/2021,3003,111590,1582,70819,1419,40380,814.0,23114,170.0,30624,42.0,1378,1303,36937,54.0,1458,20.0,607,25,61
81,3/5/2021,3487,115077,2059,72878,1432,41812,811.0,23925,426.0,31050,39.0,1417,1327,38264,43.0,1501,23.0,630,26,87
82,3/6/2021,4117,119194,2334,75212,1982,43794,752.0,24677,268.0,31318,94.0,1511,1778,40042,76.0,1577,34.0,664,587,674
83,3/7/2021,417,119611,301,75513,124,43918,37.0,24714,20.0,31338,1.0,1512,118,40160,3.0,1580,2.0,666,21,695
84,3/8/2021,2823,122434,1055,76568,1773,45691,259.0,24973,75.0,31413,49.0,1561,1639,41799,62.0,1642,23.0,689,124,819
85,3/9/2021,3186,125620,1652,78220,1548,47239,264.0,25237,96.0,31509,51.0,1612,1407,43206,65.0,1707,25.0,714,74,893
86,3/10/2021,2381,128001,1366,79586,1019,48258,299.0,25536,84.0,31593,54.0,1666,917,44123,32.0,1739,16.0,730,63,956
87,3/11/2021,4177,132178,2380,81966,1802,50060,400.0,25936,135.0,31728,63.0,1729,1653,45776,67.0,1806,19.0,749,75,1031
88,3/12/2021,3943,136121,2573,84539,1386,51446,197.0,26133,67.0,31795,64.0,1793,1236,47012,53.0,1859,33.0,782,73,1104
89,3/13/2021,212,136333,129,84668,99,51545,20.0,26153,6.0,31801,1.0,1794,92,47104,4.0,1863,2.0,784,30,1134
90,3/14/2021,101,136434,61,84729,39,51584,9.0,26162,0.0,31801,1.0,1795,36,47140,1.0,1864,1.0,785,2,1136
91,3/15/2021,900,137334,363,85092,537,52121,85.0,26247,15.0,31816,19.0,1814,494,47634,17.0,1881,7.0,792,19,1155
92,3/16/2021,3285,140619,2114,87206,1171,53292,226.0,26473,46.0,31862,65.0,1879,1042,48676,42.0,1923,22.0,814,30,1185
93,3/17/2021,2911,143530,1785,88991,1129,54421,239.0,26712,88.0,31950,40.0,1919,1034,49710,35.0,1958,20.0,834,32,1217
94,3/18/2021,4004,147534,2090,91081,1920,56341,337.0,27049,91.0,32041,97.0,2016,1738,51448,64.0,2022,21.0,855,21,1238
95,3/19/2021,3001,150535,1752,92833,1249,57590,221.0,27270,42.0,32083,60.0,2076,1123,52571,46.0,2068,20.0,875,16,1254
96,3/20/2021,3083,153618,1966,94799,1119,58709,313.0,27583,54.0,32137,37.0,2113,1006,53577,55.0,2123,21.0,896,36,1290
97,3/21/2021,661,154279,397,95196,266,58975,26.0,27609,5.0,32142,11.0,2124,236,53813,16.0,2139,3.0,899,18,1308
98,3/22/2021,3111,157390,2243,97439,866,59841,188.0,27797,56.0,32198,19.0,2143,797,54610,37.0,2176,13.0,912,25,1333
99,3/23/2021,4451,161841,3573,101012,1173,61014,194.0,27991,75.0,32273,38.0,2181,1045,55655,51.0,2227,39.0,951,495,1828
100,3/24/2021,3166,165007,2432,103444,744,61758,118.0,28109,37.0,32310,41.0,2222,663,56318,26.0,2253,14.0,965,37,1865
101,3/25/2021,5069,170076,3054,106498,2013,63771,312.0,28421,71.0,32381,67.0,2289,1846,58164,69.0,2322,31.0,996,15,1880
102,3/26/2021,4582,174658,2725,109223,1854,65625,329.0,28750,65.0,32446,115.0,2404,1594,59758,114.0,2436,31.0,1027,30,1910
103,3/27/2021,3343,178001,1915,111138,1423,67048,325.0,29075,21.0,32467,49.0,2453,1308,61066,46.0,2482,20.0,1047,4,1914
104,3/28/2021,1173,179174,811,111949,362,67410,93.0,29168,16.0,32483,12.0,2465,332,61398,16.0,2498,2.0,1049,4,1918
105,3/29/2021,3988,183162,2691,114640,1292,68702,229.0,29397,53.0,32536,38.0,2503,1213,62611,28.0,2526,13.0,1062,8,1926
106,3/30/2021,4364,187526,2750,117390,1639,70341,237.0,29634,74.0,32610,55.0,2558,1499,64110,67.0,2593,18.0,1080,44,1970
107,3/31/2021,3580,191106,2564,119954,1046,71387,165.0,29799,47.0,32657,42.0,2600,934,65044,50.0,2643,20.0,1100,33,2003
108,4/1/2021,5106,196212,3329,123283,1785,73172,147.0,29946,76.0,32733,72.0,2672,1634,66678,60.0,2703,19.0,1119,33,2036
109,4/2/2021,4710,200922,2524,125807,2181,75353,245.0,30191,49.0,32782,82.0,2754,1981,68659,91.0,2794,27.0,1146,29,2065
110,4/3/2021,4259,205181,3529,129336,761,76114,94.0,30285,41.0,32823,36.0,2790,676,69335,29.0,2823,20.0,1166,70,2135
111,4/4/2021,371,205552,257,129593,132,76246,6.0,30291,7.0,32830,3.0,2793,116,69451,11.0,2834,2.0,1168,33,2168
112,4/5/2021,4689,210241,3761,133354,948,77194,75.0,30366,47.0,32877,69.0,2862,811,70262,49.0,2883,19.0,1187,91,2259
113,4/6/2021,5169,215410,3034,136388,2316,79510,85.0,30451,58.0,32935,80.0,2942,2055,72317,126.0,3009,55.0,1242,274,2533
114,4/7/2021,4964,220374,3683,140071,2161,81671,60.0,30511,109.0,33044,119.0,3061,1835,74152,134.0,3143,73.0,1315,1170,3703
115,4/8/2021,6690,227064,4512,144583,2858,84529,137.0,30648,123.0,33167,136.0,3197,2509,76661,140.0,3283,73.0,1388,935,4638
116,4/9/2021,5721,232785,3268,147851,3215,87744,77.0,30725,71.0,33238,163.0,3360,2781,79442,181.0,3464,90.0,1478,818,5456
117,4/10/2021,4435,237220,3168,151019,1739,89483,50.0,30775,71.0,33309,98.0,3458,1470,80912,117.0,3581,54.0,1532,517,5973
118,4/11/2021,1037,238257,794,151813,288,89771,6.0,30781,11.0,33320,12.0,3470,241,81153,24.0,3605,11.0,1543,57,6030
119,4/12/2021,5042,243299,3642,155455,2006,91777,75.0,30856,96.0,33416,77.0,3547,1736,82889,133.0,3738,60.0,1603,515,6545
120,4/13/2021,5040,248339,3565,159020,1487,93264,55.0,30911,77.0,33493,70.0,3617,1297,84186,96.0,3834,24.0,1627,22,6567
121,4/14/2021,2958,251297,1440,160460,1511,94775,86.0,30997,26.0,33519,93.0,3710,1315,85501,70.0,3904,33.0,1660,2,6569
122,4/15/2021,4945,256242,2320,162780,2608,97383,102.0,31099,58.0,33577,217.0,3927,2169,87670,161.0,4065,61.0,1721,3,6572
123,4/16/2021,3909,260151,2076,164856,1819,99202,44.0,31143,34.0,33611,66.0,3993,1591,89261,127.0,4192,35.0,1756,4,6576
124,4/17/2021,4590,264741,2403,167259,2170,101372,39.0,31182,57.0,33668,99.0,4092,1887,91148,133.0,4325,51.0,1807,4,6580
125,4/18/2021,1040,265781,409,167668,624,101996,13.0,31195,11.0,33679,42.0,4134,519,91667,33.0,4358,30.0,1837,3,6583
126,4/19/2021,3859,269640,1408,169076,2426,104422,44.0,31239,40.0,33719,166.0,4300,2040,93707,162.0,4520,58.0,1895,5,6588
127,4/20/2021,4700,274340,1869,170945,2814,107236,47.0,31286,69.0,33788,159.0,4459,2398,96105,193.0,4713,64.0,1959,5,6593
128,4/21/2021,3177,277517,712,171657,2452,109688,35.0,31321,31.0,33819,145.0,4604,2063,98168,165.0,4878,79.0,2038,6,6599
129,4/22/2021,4655,282172,1769,173426,2873,112561,46.0,31367,62.0,33881,143.0,4747,2464,100632,193.0,5071,73.0,2111,2,6601
130,4/23/2021,3584,285756,1175,174601,2393,114954,41.0,31408,30.0,33911,73.0,4820,2109,102741,128.0,5199,83.0,2194,5,6606
131,4/24/2021,3357,289113,1118,175719,2235,117189,14.0,31422,20.0,33931,104.0,4924,1895,104636,196.0,5395,40.0,2234,4,6610
132,4/25/2021,796,289909,344,176063,451,117640,6.0,31428,6.0,33937,105.0,5029,267,104903,39.0,5434,40.0,2274,1,6611
133,4/26/2021,4360,294269,1112,177175,3237,120877,36.0,31464,31.0,33968,147.0,5176,2783,107686,215.0,5649,92.0,2366,4,6615
134,4/27/2021,3346,297615,1194,178369,2145,123022,36.0,31500,37.0,34005,79.0,5255,1890,109576,134.0,5783,42.0,2408,10,6625
135,4/28/2021,2990,300605,716,179085,2272,125294,45.0,31545,20.0,34025,167.0,5422,1843,111419,197.0,5980,65.0,2473,13,6638
136,4/29/2021,3965,304570,820,179905,3138,128432,67.0,31612,33.0,34058,226.0,5648,2578,113997,226.0,6206,108.0,2581,8,6646
137,4/30/2021,2871,307441,640,180545,2230,130662,44.0,31656,24.0,34082,74.0,5722,1893,115890,200.0,6406,63.0,2644,11,6657
138,5/1/2021,3651,311092,817,181362,2816,133478,35.0,31691,18.0,34100,283.0,6005,2191,118081,202.0,6608,140.0,2784,16,6673
139,5/2/2021,526,311618,232,181594,305,133783,7.0,31698,2.0,34102,12.0,6017,245,118326,38.0,6646,10.0,2794,10,6683
140,5/3/2021,3429,315047,638,182232,2790,136573,47.0,31745,34.0,34136,107.0,6124,2394,120720,213.0,6859,76.0,2870,13,6696
141,5/4/2021,4349,319396,699,182931,3668,140241,67.0,31812,27.0,34163,148.0,6272,3150,123870,259.0,7118,111.0,2981,30,6726
142,5/5/2021,2232,321628,478,183409,1788,142029,63.0,31875,24.0,34187,85.0,6357,1482,125352,141.0,7259,80.0,3061,14,6740
143,5/6/2021,3689,325317,822,184231,2986,145015,100.0,31975,40.0,34227,179.0,6536,2475,127827,196.0,7455,136.0,3197,44,6784
144,5/7/2021,2939,328256,542,184773,2485,147500,44.0,32019,11.0,34238,135.0,6671,2042,129869,211.0,7666,97.0,3294,40,6824
145,5/8/2021,2991,331247,553,185326,2541,150041,45.0,32064,16.0,34254,166.0,6837,2049,131918,195.0,7861,131.0,3425,47,6871
146,5/9/2021,367,331614,140,185466,240,150281,4.0,32068,2.0,34256,10.0,6847,200,132118,20.0,7881,10.0,3435,3,6874
147,5/10/2021,2428,334042,380,185846,2081,152362,59.0,32127,16.0,34272,87.0,6934,1693,133811,205.0,8086,96.0,3531,25,6899
148,5/11/2021,2720,336762,543,186389,2217,154579,91.0,32218,24.0,34296,189.0,7123,1727,135538,204.0,8290,97.0,3628,18,6917
149,5/12/2021,1229,337991,459,186848,822,155401,23.0,32241,14.0,34310,49.0,7172,652,136190,86.0,8376,35.0,3663,23,6940
150,5/13/2021,3247,341238,1031,187879,2231,157632,82.0,32323,25.0,34335,150.0,7322,1820,138010,156.0,8532,105.0,3768,16,6956
151,5/14/2021,2467,343705,1280,189159,1284,158916,51.0,32374,31.0,34366,64.0,7386,1069,139079,98.0,8630,53.0,3821,34,6990
152,5/15/2021,3022,346727,1512,190671,1591,160507,40.0,32414,15.0,34381,115.0,7501,1263,140342,139.0,8769,74.0,3895,28,7018
153,5/16/2021,944,347671,572,191243,405,160912,8.0,32422,8.0,34389,83.0,7584,252,140594,30.0,8799,40.0,3935,10,7028
154,5/17/2021,2442,350113,1210,192453,1305,162217,38.0,32460,27.0,34416,48.0,7632,1096,141690,102.0,8901,59.0,3994,20,7048
155,5/18/2021,2587,352700,1175,193628,1445,163662,44.0,32504,22.0,34438,72.0,7704,1215,142905,84.0,8985,74.0,4068,19,7067
156,5/19/2021,1875,354575,1152,194780,786,164448,24.0,32528,19.0,34457,42.0,7746,636,143541,69.0,9054,39.0,4107,17,7084
157,5/20/2021,1979,356554,922,195702,1097,165545,45.0,32573,27.0,34484,94.0,7840,873,144414,81.0,9135,49.0,4156,18,7102
158,5/21/2021,1626,358180,922,196624,781,166326,18.0,32591,16.0,34500,43.0,7883,621,145035,60.0,9195,57.0,4213,29,7131
159,5/22/2021,1689,359869,795,197419,923,167249,9.0,32600,13.0,34513,123.0,8006,641,145676,74.0,9269,85.0,4298,17,7148
160,5/23/2021,679,360548,340,197759,368,167617,2.0,32602,5.0,34518,68.0,8074,227,145903,18.0,9287,55.0,4353,3,7151
161,5/24/2021,1337,361885,539,198298,849,168466,36.0,32638,20.0,34538,43.0,8117,682,146585,83.0,9370,41.0,4394,20,7171
162,5/25/2021,1234,363119,509,198807,756,169222,22.0,32660,20.0,34558,57.0,8174,568,147153,66.0,9436,65.0,4459,19,7190
163,5/26/2021,965,364084,552,199359,523,169745,17.0,32677,25.0,34583,38.0,8212,414,147567,44.0,9480,27.0,4486,27,7217
164,5/27/2021,1275,365359,660,200019,678,170423,32.0,32709,19.0,34602,54.0,8266,548,148115,49.0,9529,27.0,4513,21,7238
165,5/28/2021,1033,366392,598,200617,480,170903,18.0,32727,22.0,34624,30.0,8296,372,148487,51.0,9580,27.0,4540,16,7254
166,5/29/2021,1017,367409,492,201109,562,171465,18.0,32745,8.0,34632,32.0,8328,443,148930,42.0,9622,45.0,4585,12,7266
167,5/30/2021,332,367741,220,201329,143,171608,5.0,32750,3.0,34635,12.0,8340,104,149034,17.0,9639,10.0,4595,10,7276
168,5/31/2021,339,368080,192,201521,172,171780,8.0,32758,6.0,34641,8.0,8348,138,149172,13.0,9652,13.0,4608,11,7287
169,6/1/2021,974,369054,401,201922,604,172384,26.0,32784,17.0,34658,49.0,8397,462,149634,46.0,9698,47.0,4655,24,7311
170,6/2/2021,719,369773,369,202291,406,172790,16.0,32800,8.0,34666,34.0,8431,321,149955,23.0,9721,28.0,4683,8,7319
171,6/3/2021,1307,371080,520,202811,835,173625,22.0,32822,12.0,34678,48.0,8479,688,150643,58.0,9779,41.0,4724,15,7334
172,6/4/2021,1498,372578,400,203211,1138,174763,16.0,32838,9.0,34687,71.0,8550,953,151596,69.0,9848,45.0,4769,4,7338
173,6/5/2021,1414,373992,357,203568,1084,175847,12.0,32850,6.0,34693,64.0,8614,888,152484,92.0,9940,40.0,4809,9,7347
174,6/6/2021,530,374522,142,203710,397,176244,5.0,32855,3.0,34696,43.0,8657,317,152801,25.0,9965,12.0,4821,11,7358
175,6/7/2021,1193,375715,335,204045,901,177145,14.0,32869,12.0,34708,68.0,8725,718,153519,83.0,10048,32.0,4853,19,7377
176,6/8/2021,1087,376802,253,204298,858,178003,18.0,32887,5.0,34713,59.0,8784,696,154215,70.0,10118,33.0,4886,4,7381
177,6/9/2021,1079,377881,283,204581,842,178845,15.0,32902,12.0,34725,78.0,8862,645,154860,72.0,10190,47.0,4933,12,7393
178,6/10/2021,1309,379190,336,204917,1010,179855,20.0,32922,4.0,34729,92.0,8954,797,155657,67.0,10257,54.0,4987,10,7403
179,6/11/2021,1113,380303,324,205241,831,180686,20.0,32942,13.0,34742,57.0,9011,652,156309,78.0,10335,44.0,5031,9,7412
180,6/12/2021,1047,381350,290,205531,799,181485,15.0,32957,9.0,34751,73.0,9084,619,156928,64.0,10399,43.0,5074,9,7421
181,6/13/2021,370,381720,98,205629,283,181768,4.0,32961,1.0,34752,37.0,9121,202,157130,25.0,10424,19.0,5093,6,7427
182,6/14/2021,829,382549,282,205911,591,182359,15.0,32976,4.0,34756,44.0,9165,449,157579,42.0,10466,56.0,5149,6,7433
183,6/15/2021,695,383244,237,206148,479,182838,20.0,32996,10.0,34766,41.0,9206,388,157967,34.0,10500,16.0,5165,2,7435
184,6/16/2021,627,383871,203,206351,450,183288,12.0,33008,4.0,34770,38.0,9244,343,158310,34.0,10534,35.0,5200,9,7444
185,6/17/2021,695,384566,251,206602,467,183755,13.0,33021,10.0,34780,42.0,9286,347,158657,49.0,10583,29.0,5229,5,7449
186,6/18/2021,1038,385604,380,206982,687,184442,23.0,33044,11.0,34791,52.0,9338,555,159212,51.0,10634,29.0,5258,8,7457
187,6/19/2021,634,386238,153,207135,496,184938,10.0,33054,6.0,34797,51.0,9389,365,159577,54.0,10688,26.0,5284,9,7466
188,6/20/2021,300,386538,114,207249,192,185130,3.0,33057,2.0,34799,36.0,9425,119,159696,15.0,10703,22.0,5306,5,7471
189,6/21/2021,516,387054,215,207464,327,185457,5.0,33062,8.0,34807,28.0,9453,243,159939,35.0,10738,21.0,5327,8,7479
190,6/22/2021,612,387666,250,207714,392,185849,12.0,33074,7.0,34814,31.0,9484,308,160247,26.0,10764,27.0,5354,5,7484
191,6/23/2021,511,388177,186,207900,353,186202,7.0,33081,10.0,34824,38.0,9522,256,160503,37.0,10801,22.0,5376,11,7495
192,6/24/2021,521,388698,211,208111,333,186535,12.0,33093,9.0,34833,30.0,9552,258,160761,23.0,10824,22.0,5398,1,7496
193,6/25/2021,690,389388,276,208387,436,186971,12.0,33105,8.0,34841,42.0,9594,324,161085,42.0,10866,28.0,5426,5,7501
194,6/26/2021,596,389984,166,208553,439,187410,9.0,33114,9.0,34850,77.0,9671,288,161373,43.0,10909,31.0,5457,4,7505
195,6/27/2021,183,390167,71,208624,113,187523,2.0,33116,3.0,34853,9.0,9680,82,161455,12.0,10921,10.0,5467,2,7507
196,6/28/2021,487,390654,209,208833,285,187808,7.0,33123,6.0,34859,39.0,9719,205,161660,25.0,10946,16.0,5483,2,7509
197,6/29/2021,559,391213,251,209084,329,188137,16.0,33139,11.0,34870,42.0,9761,238,161898,23.0,10969,26.0,5509,11,7520
198,6/30/2021,412,391625,206,209290,221,188358,8.0,33147,11.0,34881,19.0,9780,166,162064,16.0,10985,20.0,5529,11,7531
199,7/1/2021,488,392113,210,209500,295,188653,8.0,33155,7.0,34888,21.0,9801,221,162285,33.0,11018,20.0,5549,5,7536
200,7/2/2021,570,392683,273,209773,308,188961,5.0,33160,7.0,34895,27.0,9828,241,162526,24.0,11042,16.0,5565,3,7539
201,7/3/2021,307,392990,120,209893,194,189155,4.0,33164,3.0,34898,29.0,9857,126,162652,20.0,11062,19.0,5584,5,7544
202,7/4/2021,54,393044,19,209912,35,189190,1.0,33165,0.0,34898,4.0,9861,22,162674,1.0,11063,8.0,5592,0,7544
203,7/5/2021,315,393359,138,210050,177,189367,3.0,33168,1.0,34899,18.0,9879,121,162795,28.0,11091,10.0,5602,4,7548
204,7/6/2021,453,393812,190,210240,272,189639,4.0,33172,5.0,34904,45.0,9924,193,162988,19.0,11110,15.0,5617,1,7549
205,7/7/2021,372,394184,210,210450,176,189815,7.0,33179,6.0,34910,19.0,9943,130,163118,12.0,11122,15.0,5632,4,7553
206,7/8/2021,424,394608,198,210648,247,190062,10.0,33189,8.0,34918,23.0,9966,177,163295,23.0,11145,24.0,5656,3,7556
207,7/9/2021,482,395090,195,210843,293,190355,9.0,33198,2.0,34920,36.0,10002,215,163510,24.0,11169,18.0,5674,6,7562
208,7/10/2021,260,395350,148,210991,128,190483,5.0,33203,2.0,34922,5.0,10007,106,163616,10.0,11179,7.0,5681,2,7564
209,7/11/2021,223,395573,119,211110,122,190605,6.0,33209,6.0,34928,11.0,10018,88,163704,10.0,11189,13.0,5694,7,7571
210,7/12/2021,385,395958,202,211312,196,190801,7.0,33216,4.0,34932,25.0,10043,130,163834,24.0,11213,17.0,5711,4,7575
211,7/13/2021,435,396393,224,211536,224,191025,16.0,33232,10.0,34942,26.0,10069,175,164009,12.0,11225,11.0,5722,4,7579
212,7/14/2021,284,396677,151,211687,154,191179,8.0,33240,5.0,34947,20.0,10089,110,164119,9.0,11234,15.0,5737,8,7587
213,7/15/2021,363,397040,190,211877,184,191363,1.0,33241,4.0,34951,15.0,10104,139,164258,13.0,11247,17.0,5754,3,7590
214,7/16/2021,509,397549,243,212120,277,191640,8.0,33249,9.0,34960,25.0,10129,210,164468,22.0,11269,20.0,5774,4,7594
215,7/17/2021,274,397823,157,212277,127,191767,11.0,33260,5.0,34965,11.0,10140,96,164564,9.0,11278,11.0,5785,6,7600
216,7/18/2021,195,398018,118,212395,89,191856,4.0,33264,3.0,34968,13.0,10153,63,164627,6.0,11284,7.0,5792,4,7604
217,7/19/2021,406,398424,206,212601,206,192062,8.0,33272,8.0,34976,26.0,10179,150,164777,17.0,11301,13.0,5805,4,7608
218,7/20/2021,417,398841,210,212811,215,192277,6.0,33278,8.0,34984,12.0,10191,166,164943,23.0,11324,14.0,5819,5,7613
219,7/21/2021,336,399177,184,212995,172,192449,13.0,33291,14.0,34998,12.0,10203,129,165072,14.0,11338,17.0,5836,3,7616
220,7/22/2021,394,399571,232,213227,169,192618,6.0,33297,18.0,35016,19.0,10222,124,165196,18.0,11356,8.0,5844,6,7622
221,7/23/2021,552,400123,318,213545,237,192855,6.0,33303,10.0,35026,37.0,10259,161,165357,20.0,11376,19.0,5863,3,7625
222,7/24/2021,352,400475,214,213759,157,193012,8.0,33311,10.0,35036,19.0,10278,115,165472,9.0,11385,14.0,5877,5,7630
223,7/25/2021,197,400672,145,213904,62,193074,0.0,33311,4.0,35040,7.0,10285,44,165516,5.0,11390,6.0,5883,4,7634
224,7/26/2021,347,401019,201,214105,143,193217,1.0,33312,7.0,35047,11.0,10296,97,165613,18.0,11408,17.0,5900,4,7638
225,7/27/2021,424,401443,238,214343,174,193391,5.0,33317,16.0,35063,21.0,10317,122,165735,18.0,11426,13.0,5913,15,7653
226,7/28/2021,467,401910,283,214626,222,193613,3.0,33320,10.0,35073,28.0,10345,144,165879,17.0,11443,33.0,5946,5,7658
227,7/29/2021,511,402421,307,214933,232,193845,8.0,33328,6.0,35079,24.0,10369,176,166055,14.0,11457,18.0,5964,10,7668
228,7/30/2021,685,403106,476,215409,247,194092,10.0,33338,14.0,35093,25.0,10394,187,166242,16.0,11473,19.0,5983,5,7673
229,7/31/2021,333,403439,201,215610,136,194228,4.0,33342,1.0,35094,15.0,10409,107,166349,9.0,11482,5.0,5988,5,7678
230,8/1/2021,268,403707,171,215781,105,194333,0.0,33342,2.0,35096,15.0,10424,66,166415,8.0,11490,16.0,6004,8,7686
231,8/2/2021,446,404153,297,216078,173,194506,4.0,33346,13.0,35109,21.0,10445,119,166534,20.0,11510,13.0,6017,6,7692
232,8/3/2021,559,404712,346,216424,238,194744,6.0,33352,13.0,35122,37.0,10482,160,166694,15.0,11525,26.0,6043,4,7696
233,8/4/2021,392,405104,274,216698,139,194883,3.0,33355,14.0,35136,10.0,10492,106,166800,5.0,11530,18.0,6061,10,7706
234,8/5/2021,444,405548,287,216985,168,195051,5.0,33360,11.0,35147,19.0,10511,122,166922,16.0,11546,11.0,6072,4,7710
235,8/6/2021,681,406229,462,217447,265,195316,12.0,33372,16.0,35163,22.0,10533,201,167123,22.0,11568,20.0,6092,4,7714
236,8/7/2021,438,406667,306,217753,155,195471,4.0,33376,10.0,35173,12.0,10545,122,167245,5.0,11573,16.0,6108,5,7719
237,8/8/2021,218,406885,126,217879,99,195570,3.0,33379,5.0,35178,8.0,10553,72,167317,7.0,11580,12.0,6120,5,7724
238,8/9/2021,462,407347,279,218158,213,195783,4.0,33383,6.0,35184,22.0,10575,158,167475,11.0,11591,22.0,6142,6,7730
239,8/10/2021,506,407853,302,218460,229,196012,6.0,33389,14.0,35198,25.0,10600,180,167655,11.0,11602,13.0,6155,8,7738
240,8/11/2021,418,408271,264,218724,176,196188,11.0,33400,5.0,35203,17.0,10617,133,167788,14.0,11616,12.0,6167,2,7740
241,8/12/2021,541,408812,319,219043,260,196448,7.0,33407,13.0,35216,31.0,10648,183,167971,23.0,11639,23.0,6190,6,7746
242,8/13/2021,657,409469,378,219421,298,196746,11.0,33418,9.0,35225,31.0,10679,217,168188,19.0,11658,31.0,6221,5,7751
243,8/14/2021,503,409972,257,219678,248,196994,7.0,33425,9.0,35234,11.0,10690,211,168399,9.0,11667,17.0,6238,45,7796
244,8/15/2021,264,410236,129,219807,124,197118,2.0,33427,3.0,35237,11.0,10701,90,168489,6.0,11673,17.0,6255,16,7812
245,8/16/2021,539,410775,312,220119,169,197287,5.0,33432,11.0,35248,15.0,10716,129,168618,13.0,11686,12.0,6267,70,7882
246,8/17/2021,483,411258,228,220347,194,197481,19.0,33451,10.0,35258,17.0,10733,146,168764,10.0,11696,21.0,6288,69,7951
247,8/18/2021,591,411849,323,220670,257,197738,5.0,33456,15.0,35273,30.0,10763,175,168939,13.0,11709,39.0,6327,66,8017
248,8/19/2021,565,412414,278,220948,255,197993,7.0,33463,9.0,35282,21.0,10784,205,169144,17.0,11726,12.0,6339,69,8086
249,8/20/2021,843,413257,340,221288,451,198444,14.0,33477,10.0,35292,44.0,10828,358,169502,29.0,11755,20.0,6359,80,8166
250,8/21/2021,644,413901,209,221497,208,198652,4.0,33481,7.0,35299,14.0,10842,170,169672,13.0,11768,11.0,6370,183,8349
251,8/22/2021,315,414216,151,221648,141,198793,1.0,33482,2.0,35301,19.0,10861,99,169771,9.0,11777,14.0,6384,29,8378
252,8/23/2021,527,414743,262,221910,221,199014,10.0,33492,9.0,35310,19.0,10880,167,169938,12.0,11789,23.0,6407,59,8437
253,8/24/2021,571,415314,275,222185,274,199288,10.0,33502,8.0,35318,27.0,10907,215,170153,14.0,11803,18.0,6425,50,8487
254,8/25/2021,596,415910,322,222507,257,199545,12.0,33514,13.0,35331,19.0,10926,196,170349,9.0,11812,33.0,6458,48,8535
255,8/26/2021,534,416444,260,222767,253,199798,9.0,33523,14.0,35345,18.0,10944,195,170544,23.0,11835,17.0,6475,41,8576
256,8/27/2021,889,417333,352,223119,404,200202,15.0,33538,11.0,35356,38.0,10982,298,170842,23.0,11858,45.0,6520,144,8720
257,8/28/2021,1466,418799,202,223321,250,200452,7.0,33545,5.0,35361,23.0,11005,187,171029,13.0,11871,27.0,6547,974,9694
258,8/29/2021,1080,419879,160,223481,136,200588,4.0,33549,4.0,35365,8.0,11013,111,171140,12.0,11883,5.0,6552,766,10460
259,8/30/2021,616,420495,272,223753,280,200868,9.0,33558,13.0,35378,24.0,11037,215,171355,9.0,11892,32.0,6584,89,10549
260,8/31/2021,811,421306,235,223988,237,201105,7.0,33565,12.0,35390,18.0,11055,188,171543,18.0,11910,13.0,6597,337,10886
261,9/1/2021,951,422257,247,224235,222,201327,12.0,33577,15.0,35405,21.0,11076,169,171712,13.0,11923,19.0,6616,480,11366
262,9/2/2021,827,423084,184,224419,203,201530,13.0,33590,14.0,35419,18.0,11094,151,171863,17.0,11940,17.0,6633,454,11820
263,9/3/2021,853,423937,340,224759,370,201900,13.0,33603,12.0,35431,43.0,11137,271,172134,21.0,11961,35.0,6668,161,11981
264,9/4/2021,376,424313,163,224922,165,202065,6.0,33609,8.0,35439,13.0,11150,128,172262,11.0,11972,13.0,6681,57,12038
265,9/5/2021,251,424564,131,225053,108,202173,2.0,33611,4.0,35443,12.0,11162,77,172339,9.0,11981,10.0,6691,21,12059
266,9/6/2021,112,424676,46,225099,59,202232,1.0,33612,0.0,35443,4.0,11166,43,172382,8.0,11989,4.0,6695,11,12070
267,9/7/2021,952,425628,199,225298,272,202504,19.0,33631,12.0,35455,22.0,11188,208,172590,17.0,12006,25.0,6720,480,12550
268,9/8/2021,789,426417,219,225517,225,202729,11.0,33642,12.0,35467,24.0,11212,169,172759,10.0,12016,22.0,6742,364,12914
269,9/9/2021,402,426819,176,225693,193,202922,9.0,33651,8.0,35475,21.0,11233,141,172900,14.0,12030,17.0,6759,54,12968
270,9/10/2021,752,427571,339,226032,306,203228,9.0,33660,23.0,35498,28.0,11261,230,173130,20.0,12050,28.0,6787,144,13112
271,9/11/2021,1634,429205,162,226194,210,203438,10.0,33670,19.0,35517,17.0,11278,161,173291,15.0,12065,17.0,6804,1259,14371
272,9/12/2021,233,429438,101,226295,114,203552,1.0,33671,2.0,35519,11.0,11289,74,173365,10.0,12075,19.0,6823,16,14387
273,9/13/2021,493,429931,220,226515,245,203797,9.0,33680,8.0,35527,24.0,11313,184,173549,12.0,12087,25.0,6848,44,14431
274,9/14/2021,845,430776,202,226717,274,204071,13.0,33693,15.0,35542,17.0,11330,220,173769,14.0,12101,23.0,6871,396,14827
275,9/15/2021,832,431608,191,226908,268,204339,15.0,33708,15.0,35557,21.0,11351,198,173967,17.0,12118,32.0,6903,394,15221
276,9/16/2021,355,431963,134,227042,193,204532,9.0,33717,8.0,35565,32.0,11383,138,174105,12.0,12130,11.0,6914,41,15262
277,9/17/2021,749,432712,285,227327,389,204921,13.0,33730,13.0,35578,29.0,11412,291,174396,38.0,12168,31.0,6945,120,15382
278,9/18/2021,1840,434552,127,227454,174,205095,6.0,33736,20.0,35598,10.0,11422,128,174524,16.0,12184,20.0,6965,1531,16913
279,9/19/2021,181,434733,74,227528,105,205200,3.0,33739,2.0,35600,7.0,11429,80,174604,5.0,12189,13.0,6978,10,16923
280,9/20/2021,384,435117,143,227671,216,205416,8.0,33747,9.0,35609,27.0,11456,160,174764,10.0,12199,19.0,6997,55,16978
281,9/21/2021,772,435889,166,227837,200,205616,9.0,33756,14.0,35623,21.0,11477,154,174918,8.0,12207,17.0,7014,417,17395
282,9/22/2021,718,436607,164,228001,229,205845,6.0,33762,12.0,35635,15.0,11492,181,175099,16.0,12223,17.0,7031,358,17753
283,9/23/2021,347,436954,143,228144,179,206024,8.0,33770,3.0,35638,9.0,11501,132,175231,13.0,12236,25.0,7056,46,17799
284,9/24/2021,694,437648,208,228352,274,206298,16.0,33786,16.0,35654,20.0,11521,217,175448,11.0,12247,26.0,7082,229,18028
285,9/25/2021,1731,439379,133,228485,176,206474,11.0,33797,21.0,35675,15.0,11536,137,175585,12.0,12259,12.0,7094,1424,19452
286,9/26/2021,264,439643,66,228551,87,206561,3.0,33800,3.0,35678,11.0,11547,65,175650,4.0,12263,7.0,7101,109,19561
287,9/27/2021,566,440209,156,228707,123,206684,7.0,33807,11.0,35689,7.0,11554,95,175745,8.0,12271,13.0,7114,303,19864
288,9/28/2021,1133,441342,158,228865,203,206887,19.0,33826,23.0,35712,15.0,11569,154,175899,9.0,12280,25.0,7139,791,20655
289,9/29/2021,1137,442479,174,229039,170,207057,12.0,33838,19.0,35731,15.0,11584,127,176026,7.0,12287,21.0,7160,803,21458
290,9/30/2021,710,443189,161,229200,168,207225,15.0,33853,7.0,35738,11.0,11595,128,176154,11.0,12298,18.0,7178,410,21868
291,10/1/2021,1069,444258,177,229377,303,207528,21.0,33874,16.0,35754,20.0,11615,240,176394,21.0,12319,22.0,7200,602,22470
292,10/2/2021,1816,446074,118,229495,115,207643,12.0,33886,14.0,35768,9.0,11624,96,176490,5.0,12324,5.0,7205,1588,24058
293,10/3/2021,392,446466,64,229559,113,207756,1.0,33887,2.0,35770,18.0,11642,77,176567,7.0,12331,11.0,7216,226,24284
294,10/4/2021,796,447262,113,229672,157,207913,7.0,33894,12.0,35782,27.0,11669,103,176670,14.0,12345,13.0,7229,532,24816
295,10/5/2021,1122,448384,139,229811,134,208047,12.0,33906,17.0,35799,13.0,11682,102,176772,5.0,12350,14.0,7243,860,25676
296,10/6/2021,999,449383,107,229918,155,208202,8.0,33914,14.0,35813,11.0,11693,122,176894,5.0,12355,17.0,7260,753,26429
297,10/7/2021,787,450170,135,230053,107,208309,8.0,33922,14.0,35827,8.0,11701,83,176977,5.0,12360,11.0,7271,565,26994
298,10/8/2021,1040,451210,159,230212,241,208550,19.0,33941,11.0,35838,21.0,11722,186,177163,11.0,12371,23.0,7294,652,27646
299,10/9/2021,1676,452886,108,230320,132,208682,11.0,33952,8.0,35846,22.0,11744,98,177261,4.0,12375,8.0,7302,1435,29081
300,10/10/2021,243,453129,50,230370,63,208745,2.0,33954,2.0,35848,4.0,11748,49,177310,5.0,12380,5.0,7307,131,29212
301,10/11/2021,820,453949,122,230492,135,208880,17.0,33971,18.0,35866,3.0,11751,111,177421,10.0,12390,11.0,7318,574,29786
302,10/12/2021,1024,454973,117,230609,132,209012,8.0,33979,19.0,35885,16.0,11767,104,177525,4.0,12394,8.0,7326,785,30571
303,10/13/2021,973,455946,118,230727,151,209163,17.0,33996,9.0,35894,16.0,11783,114,177639,12.0,12406,9.0,7335,723,31294
304,10/14/2021,711,456657,100,230827,127,209290,14.0,34010,9.0,35903,20.0,11803,94,177733,8.0,12414,5.0,7340,491,31785
305,10/15/2021,1028,457685,177,231004,215,209505,11.0,34021,7.0,35910,15.0,11818,169,177902,13.0,12427,18.0,7358,671,32456
306,10/16/2021,802,458487,66,231070,79,209584,4.0,34025,3.0,35913,6.0,11824,68,177970,2.0,12429,3.0,7361,657,33113
307,10/17/2021,196,458683,48,231118,63,209647,1.0,34026,2.0,35915,4.0,11828,47,178017,3.0,12432,9.0,7370,83,33196
308,10/18/2021,651,459334,118,231236,134,209781,10.0,34036,4.0,35919,13.0,11841,105,178122,6.0,12438,10.0,7380,414,33610
309,10/19/2021,1051,460385,120,231356,134,209915,4.0,34040,11.0,35930,8.0,11849,108,178230,8.0,12446,10.0,7390,806,34416
310,10/20/2021,891,461276,121,231477,118,210033,6.0,34046,12.0,35942,8.0,11857,89,178319,7.0,12453,14.0,7404,664,35080
311,10/21/2021,533,461809,107,231584,127,210160,9.0,34055,8.0,35950,14.0,11871,85,178404,11.0,12464,17.0,7421,320,35400
312,10/22/2021,1474,463283,195,231779,227,210387,9.0,34064,13.0,35963,19.0,11890,169,178573,14.0,12478,25.0,7446,1072,36472
313,10/23/2021,1879,465162,87,231866,195,210582,14.0,34078,15.0,35978,4.0,11894,170,178743,11.0,12489,10.0,7456,1600,38072
314,10/24/2021,572,465734,81,231947,151,210733,8.0,34086,11.0,35989,12.0,11906,127,178870,7.0,12496,5.0,7461,352,38424
315,10/25/2021,1387,467121,136,232083,297,211030,27.0,34113,17.0,36006,12.0,11918,252,179122,21.0,12517,12.0,7473,966,39390
316,10/26/2021,2143,469264,178,232261,299,211329,15.0,34128,18.0,36024,19.0,11937,248,179370,18.0,12535,14.0,7487,1676,41066
317,10/27/2021,1970,471234,150,232411,273,211602,18.0,34146,18.0,36042,9.0,11946,241,179611,14.0,12549,9.0,7496,1553,42619
318,10/28/2021,1716,472950,138,232549,262,211864,11.0,34157,20.0,36062,11.0,11957,220,179831,17.0,12566,14.0,7510,1327,43946
319,10/29/2021,1662,474612,177,232726,279,212143,12.0,34169,15.0,36077,10.0,11967,244,180075,12.0,12578,13.0,7523,1217,45163
320,10/30/2021,1588,476200,78,232804,150,212293,13.0,34182,8.0,36085,6.0,11973,129,180204,9.0,12587,6.0,7529,1369,46532
321,10/31/2021,461,476661,48,232852,74,212367,2.0,34184,6.0,36091,6.0,11979,62,180266,4.0,12591,2.0,7531,337,46869
322,11/1/2021,1245,477906,138,232990,215,212582,10.0,34194,10.0,36101,8.0,11987,177,180443,12.0,12603,18.0,7549,898,47767
323,11/2/2021,1821,479727,129,233119,201,212783,8.0,34202,17.0,36118,14.0,12001,162,180605,14.0,12617,11.0,7560,1506,49273
324,11/3/2021,1742,481469,159,233278,230,213013,12.0,34214,17.0,36135,15.0,12016,182,180787,16.0,12633,17.0,7577,1368,50641
325,11/4/2021,1411,482880,144,233422,183,213196,4.0,34218,13.0,36148,1.0,12017,159,180946,12.0,12645,11.0,7588,1108,51749
326,11/5/2021,2016,484896,225,233647,299,213495,14.0,34232,12.0,36160,18.0,12035,251,181197,14.0,12659,16.0,7604,1524,53273
327,11/6/2021,1579,486475,215,233862,142,213637,4.0,34236,7.0,36167,6.0,12041,115,181312,15.0,12674,6.0,7610,1229,54502
328,11/7/2021,531,487006,123,233985,78,213715,1.0,34237,8.0,36175,5.0,12046,64,181376,3.0,12677,6.0,7616,330,54832
329,11/8/2021,1524,488530,384,234369,199,213914,7.0,34244,9.0,36184,11.0,12057,165,181541,9.0,12686,14.0,7630,961,55793
330,11/9/2021,2630,491160,942,235311,221,214135,10.0,34254,21.0,36205,15.0,12072,163,181704,16.0,12702,27.0,7657,1487,57280
331,11/10/2021,2488,493648,823,236134,223,214358,11.0,34265,17.0,36222,12.0,12084,176,181880,22.0,12724,13.0,7670,1465,58745
332,11/11/2021,2350,495998,965,237099,187,214545,17.0,34282,8.0,36230,13.0,12097,153,182033,13.0,12737,8.0,7678,1217,59962
333,11/12/2021,2554,498552,757,237856,240,214785,12.0,34294,19.0,36249,23.0,12120,191,182224,13.0,12750,13.0,7691,1568,61530
334,11/13/2021,1928,500480,404,238260,140,214925,4.0,34298,12.0,36261,7.0,12127,104,182328,15.0,12765,14.0,7705,1393,62923
335,11/14/2021,1482,501962,910,239170,107,215032,1.0,34299,2.0,36263,11.0,12138,72,182400,14.0,12779,10.0,7715,474,63397
336,11/15/2021,1955,503917,450,239620,200,215232,7.0,34306,11.0,36274,12.0,12150,160,182560,12.0,12791,16.0,7731,1326,64723
337,11/16/2021,2399,506316,455,240075,211,215443,5.0,34311,21.0,36295,26.0,12176,154,182714,17.0,12808,14.0,7745,1745,66468
338,11/17/2021,2725,509041,633,240708,268,215711,12.0,34323,16.0,36311,16.0,12192,220,182934,18.0,12826,14.0,7759,1855,68323
339,11/18/2021,1888,510929,377,241085,177,215888,7.0,34330,10.0,36321,15.0,12207,142,183076,15.0,12841,5.0,7764,1349,69672
340,11/19/2021,2565,513494,716,241801,281,216169,13.0,34343,15.0,36336,9.0,12216,235,183311,20.0,12861,17.0,7781,1588,71260
341,11/20/2021,1880,515374,533,242334,113,216282,6.0,34349,5.0,36341,8.0,12224,96,183407,4.0,12865,5.0,7786,1237,72497
342,11/21/2021,639,516013,123,242457,86,216368,0.0,34349,1.0,36342,3.0,12227,70,183477,8.0,12873,5.0,7791,433,72930
343,11/22/2021,1972,517985,425,242882,208,216576,11.0,34360,21.0,36363,10.0,12237,168,183645,12.0,12885,18.0,7809,1359,74289
344,11/23/2021,1839,519824,286,243168,187,216763,8.0,34368,15.0,36378,15.0,12252,151,183796,14.0,12899,7.0,7816,1375,75664
345,11/24/2021,1513,521337,214,243382,164,216927,6.0,34374,11.0,36389,14.0,12266,132,183928,12.0,12911,6.0,7822,1150,76814
346,11/25/2021,46,521383,9,243391,2,216929,0.0,34374,0.0,36389,0.0,12266,1,183929,1.0,12912,,7822,35,76849
347,11/26/2021,1257,522640,191,243582,202,217131,3.0,34377,4.0,36393,17.0,12283,163,184092,12.0,12924,10.0,7832,883,77732
348,11/27/2021,951,523591,136,243718,153,217284,2.0,34379,2.0,36395,8.0,12291,130,184222,8.0,12932,7.0,7839,664,78396
349,11/28/2021,538,524129,95,243813,105,217389,2.0,34381,2.0,36397,9.0,12300,84,184306,5.0,12937,7.0,7846,344,78740
350,11/29/2021,1844,525973,272,244085,410,217799,8.0,34389,13.0,36410,29.0,12329,341,184647,25.0,12962,15.0,7861,1183,79923
351,11/30/2021,2663,528636,337,244422,790,218589,8.0,34397,11.0,36421,51.0,12380,666,185313,61.0,13023,12.0,7873,1556,81479
352,12/1/2021,2435,531071,264,244686,745,219334,13.0,34410,11.0,36432,30.0,12410,655,185968,56.0,13079,4.0,7877,1437,82916
353,12/2/2021,2811,533882,350,245036,912,220246,9.0,34419,15.0,36447,69.0,12479,741,186709,73.0,13152,29.0,7906,1576,84492
354,12/3/2021,2586,536468,280,245316,757,221003,11.0,34430,4.0,36451,61.0,12540,597,187306,71.0,13223,28.0,7934,1569,86061
355,12/4/2021,2186,538654,161,245477,421,221424,4.0,34434,1.0,36452,24.0,12564,329,187635,37.0,13260,31.0,7965,1611,87672
356,12/5/2021,1375,540029,102,245579,840,222264,1.0,34435,0.0,36452,67.0,12631,666,188301,71.0,13331,36.0,8001,442,88114
357,12/6/2021,1924,541953,233,245812,469,222733,7.0,34442,5.0,36457,54.0,12685,366,188667,33.0,13364,16.0,8017,1234,89348
358,12/7/2021,2449,544402,307,246119,467,223200,10.0,34452,9.0,36466,48.0,12733,372,189039,31.0,13395,16.0,8033,1694,91042
359,12/8/2021,2230,546632,269,246388,513,223713,9.0,34461,12.0,36478,31.0,12764,429,189468,40.0,13435,13.0,8046,1469,92511
360,12/9/2021,2149,548781,301,246689,461,224174,6.0,34467,8.0,36486,27.0,12791,357,189825,43.0,13478,34.0,8080,1401,93912
361,12/10/2021,2086,550867,239,246928,402,224576,10.0,34477,9.0,36495,38.0,12829,312,190137,32.0,13510,20.0,8100,1455,95367
362,12/11/2021,1783,552650,137,247065,492,225068,6.0,34483,1.0,36496,59.0,12888,366,190503,41.0,13551,26.0,8126,1156,96523
363,12/12/2021,416,553066,56,247121,87,225155,1.0,34484,3.0,36499,4.0,12892,70,190573,7.0,13558,6.0,8132,275,96798
364,12/13/2021,1751,554817,298,247419,393,225548,9.0,34493,8.0,36507,26.0,12918,319,190892,35.0,13593,13.0,8145,1078,97876
365,12/14/2021,2181,556998,276,247695,364,225912,7.0,34500,5.0,36512,33.0,12951,298,191190,16.0,13609,17.0,8162,1566,99442
366,12/15/2021,1740,558738,200,247895,229,226141,6.0,34506,4.0,36516,9.0,12960,185,191375,20.0,13629,15.0,8177,1325,100767
367,12/16/2021,1768,560506,313,248208,246,226387,7.0,34513,8.0,36524,16.0,12976,207,191582,14.0,13643,9.0,8186,1227,101994
368,12/17/2021,2117,562623,307,248515,443,226830,6.0,34519,9.0,36533,28.0,13004,365,191947,39.0,13682,11.0,8197,1378,103372
369,12/18/2021,1806,564429,177,248692,243,227073,4.0,34523,4.0,36537,17.0,13021,208,192155,10.0,13692,8.0,8205,1386,104758
370,12/19/2021,438,564867,44,248736,80,227153,1.0,34524,3.0,36540,5.0,13026,67,192222,4.0,13696,4.0,8209,314,105072
371,12/20/2021,1550,566417,197,248933,243,227396,10.0,34534,9.0,36549,27.0,13053,194,192416,16.0,13712,6.0,8215,1114,106186
372,12/21/2021,2190,568607,311,249244,295,227691,10.0,34544,8.0,36557,28.0,13081,229,192645,24.0,13736,14.0,8229,1592,107778
373,12/22/2021,1883,570490,220,249464,287,227978,5.0,34549,9.0,36566,29.0,13110,227,192872,23.0,13759,8.0,8237,1379,109157
374,12/23/2021,1241,571731,216,249680,207,228185,5.0,34554,4.0,36570,23.0,13133,157,193029,16.0,13775,11.0,8248,831,109988
375,12/24/2021,320,572051,45,249725,62,228247,2.0,34556,2.0,36572,4.0,13137,53,193082,4.0,13779,1.0,8249,215,110203
376,12/25/2021,13,572064,3,249728,2,228249,0.0,34556,0.0,36572,,13137,1,193083,1.0,13780,,8249,8,110211
377,12/26/2021,356,572420,60,249788,68,228317,1.0,34557,0.0,36572,7.0,13144,53,193136,5.0,13785,3.0,8252,230,110441
378,12/27/2021,1253,573673,173,249961,222,228539,3.0,34560,5.0,36577,17.0,13161,177,193313,20.0,13805,8.0,8260,863,111304
379,12/28/2021,1893,575566,267,250228,295,228834,12.0,34572,11.0,36588,35.0,13196,229,193542,16.0,13821,15.0,8275,1334,112638
380,12/29/2021,1700,577266,208,250436,253,229087,5.0,34577,6.0,36594,28.0,13224,192,193734,22.0,13843,11.0,8286,1250,113888
381,12/30/2021,1371,578637,221,250657,242,229329,7.0,34584,9.0,36603,27.0,13251,188,193922,15.0,13858,12.0,8298,918,114806
382,12/31/2021,506,579143,96,250753,92,229421,0.0,34584,2.0,36605,7.0,13258,75,193997,5.0,13863,5.0,8303,321,115127
383,1/1/2022,93,579236,12,250765,16,229437,1.0,34585,1.0,36606,0.0,13258,13,194010,2.0,13865,1.0,8304,65,115192
384,1/2/2022,315,579551,45,250810,59,229496,1.0,34586,1.0,36607,7.0,13265,41,194051,8.0,13873,3.0,8307,212,115404
385,1/3/2022,1599,581150,328,251138,346,229842,4.0,34590,5.0,36612,34.0,13299,282,194333,20.0,13893,10.0,8317,935,116339
386,1/4/2022,1677,582827,262,251400,276,230118,10.0,34600,7.0,36619,30.0,13329,218,194551,17.0,13910,11.0,8328,1152,117491
387,1/5/2022,1330,584157,203,251603,199,230317,7.0,34607,8.0,36627,13.0,13342,162,194713,9.0,13919,15.0,8343,941,118432
388,1/6/2022,1228,585385,255,251858,232,230549,4.0,34611,4.0,36631,24.0,13366,173,194886,13.0,13932,22.0,8365,750,119182
389,1/7/2022,2057,587442,253,252111,341,230890,6.0,34617,9.0,36640,35.0,13401,263,195149,30.0,13962,13.0,8378,1475,120657
390,1/8/2022,1577,589019,124,252235,130,231020,0.0,34617,3.0,36643,7.0,13408,109,195258,7.0,13969,7.0,8385,1327,121984
391,1/9/2022,497,589516,90,252325,73,231093,0.0,34617,2.0,36645,14.0,13422,50,195308,3.0,13972,6.0,8391,335,122319
392,1/10/2022,1559,591075,289,252614,250,231343,3.0,34620,6.0,36651,19.0,13441,195,195503,27.0,13999,9.0,8400,1031,123350
393,1/11/2022,1562,592637,221,252835,275,231618,3.0,34623,4.0,36655,32.0,13473,209,195712,15.0,14014,19.0,8419,1078,124428
394,1/12/2022,1402,594039,177,253012,185,231803,6.0,34629,5.0,36660,29.0,13502,127,195839,20.0,14034,9.0,8428,1052,125480
395,1/13/2022,1098,595137,192,253204,178,231981,3.0,34632,2.0,36662,14.0,13516,132,195971,18.0,14052,14.0,8442,737,126217
396,1/14/2022,1617,596754,277,253481,215,232196,2.0,34634,8.0,36670,25.0,13541,157,196128,20.0,14072,13.0,8455,1141,127358
397,1/15/2022,1215,597969,135,253616,102,232298,1.0,34635,3.0,36673,11.0,13552,80,196208,9.0,14081,2.0,8457,979,128337
398,1/16/2022,290,598259,47,253663,35,232333,1.0,34636,0.0,36673,1.0,13553,31,196239,3.0,14084,0.0,8457,208,128545
399,1/17/2022,778,599037,161,253824,128,232461,4.0,34640,5.0,36678,12.0,13565,106,196345,8.0,14092,2.0,8459,491,129036
400,1/18/2022,885,599922,163,253987,165,232626,2.0,34642,6.0,36684,25.0,13590,126,196471,6.0,14098,8.0,8467,564,129600
401,1/19/2022,721,600643,121,254108,118,232744,4.0,34646,7.0,36691,9.0,13599,87,196558,10.0,14108,12.0,8479,494,130094
402,1/20/2022,783,601426,146,254254,146,232890,0.0,34646,10.0,36701,17.0,13616,110,196668,10.0,14118,9.0,8488,498,130592
403,1/21/2022,1176,602602,168,254422,171,233061,7.0,34653,2.0,36703,15.0,13631,133,196801,12.0,14130,11.0,8499,846,131438
404,1/22/2022,784,603386,86,254508,104,233165,0.0,34653,1.0,36704,14.0,13645,74,196875,7.0,14137,9.0,8508,595,132033
405,1/23/2022,210,603596,24,254532,53,233218,1.0,34654,0.0,36704,5.0,13650,41,196916,7.0,14144,0.0,8508,134,132167
406,1/24/2022,490,604086,75,254607,107,233325,1.0,34655,1.0,36705,14.0,13664,78,196994,8.0,14152,7.0,8515,311,132478
407,1/25/2022,663,604749,116,254723,143,233468,3.0,34658,2.0,36707,15.0,13679,100,197094,21.0,14173,7.0,8522,405,132883
408,1/26/2022,644,605393,100,254823,140,233608,8.0,34666,2.0,36709,13.0,13692,106,197200,13.0,14186,8.0,8530,413,133296
409,1/27/2022,620,606013,114,254937,173,233781,5.0,34671,1.0,36710,29.0,13721,128,197328,10.0,14196,6.0,8536,339,133635
410,1/28/2022,970,606983,163,255100,170,233951,6.0,34677,6.0,36716,20.0,13741,119,197447,15.0,14211,16.0,8552,640,134275
411,1/29/2022,558,607541,65,255165,87,234038,1.0,34678,4.0,36720,10.0,13751,64,197511,8.0,14219,5.0,8557,406,134681
412,1/30/2022,193,607734,33,255198,45,234083,1.0,34679,1.0,36721,14.0,13765,27,197538,1.0,14220,3.0,8560,117,134798
413,1/31/2022,558,608292,137,255335,121,234204,2.0,34681,2.0,36723,17.0,13782,80,197618,13.0,14233,11.0,8571,303,135101
414,2/1/2022,550,608842,100,255435,137,234341,0.0,34681,5.0,36728,19.0,13801,102,197720,11.0,14244,5.0,8576,315,135416
415,2/2/2022,127,608969,18,255453,45,234386,0.0,34681,1.0,36729,2.0,13803,41,197761,1.0,14245,1.0,8577,67,135483
416,2/3/2022,371,609340,77,255530,117,234503,1.0,34682,3.0,36732,24.0,13827,82,197843,6.0,14251,5.0,8582,182,135665
417,2/4/2022,646,609986,110,255640,147,234650,7.0,34689,5.0,36737,17.0,13844,115,197958,9.0,14260,6.0,8588,390,136055
418,2/5/2022,455,610441,57,255697,112,234762,2.0,34691,0.0,36737,7.0,13851,90,198048,6.0,14266,9.0,8597,288,136343
419,2/6/2022,124,610565,21,255718,34,234796,0.0,34691,1.0,36738,1.0,13852,23,198071,6.0,14272,4.0,8601,70,136413
420,2/7/2022,362,610927,61,255779,109,234905,0.0,34691,0.0,36738,12.0,13864,84,198155,5.0,14277,8.0,8609,194,136607
421,2/8/2022,441,611368,85,255864,115,235020,0.0,34691,3.0,36741,19.0,13883,84,198239,5.0,14282,7.0,8616,251,136858
422,2/9/2022,354,611722,63,255927,98,235118,3.0,34694,1.0,36742,18.0,13901,65,198304,3.0,14285,12.0,8628,196,137054
423,2/10/2022,378,612100,85,256012,89,235207,1.0,34695,3.0,36745,15.0,13916,60,198364,8.0,14293,6.0,8634,205,137259
424,2/11/2022,552,612652,96,256108,158,235365,4.0,34699,1.0,36746,28.0,13944,109,198473,9.0,14302,12.0,8646,303,137562
425,2/12/2022,250,612902,41,256149,51,235416,0.0,34699,0.0,36746,5.0,13949,39,198512,5.0,14307,2.0,8648,161,137723
426,2/13/2022,75,612977,18,256167,16,235432,0.0,34699,1.0,36747,0.0,13949,10,198522,4.0,14311,2.0,8650,43,137766
427,2/14/2022,238,613215,41,256208,51,235483,4.0,34703,2.0,36749,8.0,13957,37,198559,2.0,14313,4.0,8654,148,137914
428,2/15/2022,303,613518,44,256252,95,235578,0.0,34703,0.0,36749,16.0,13973,65,198624,7.0,14320,7.0,8661,168,138082
429,2/16/2022,225,613743,43,256295,64,235642,2.0,34705,0.0,36749,12.0,13985,44,198668,5.0,14325,3.0,8664,121,138203
430,2/17/2022,164,613907,30,256325,43,235685,1.0,34706,1.0,36750,8.0,13993,31,198699,3.0,14328,1.0,8665,93,138296
431,2/18/2022,490,614397,106,256431,111,235796,3.0,34709,2.0,36752,15.0,14008,65,198764,20.0,14348,11.0,8676,273,138569
432,2/19/2022,213,614610,27,256458,61,235857,0.0,34709,0.0,36752,12.0,14020,41,198805,2.0,14350,6.0,8682,127,138696
433,2/20/2022,69,614679,16,256474,13,235870,0.0,34709,0.0,36752,0.0,14020,11,198816,0.0,14350,2.0,8684,41,138737
434,2/21/2022,250,614929,57,256531,75,235945,2.0,34711,1.0,36753,17.0,14037,49,198865,5.0,14355,4.0,8688,123,138860
435,2/22/2022,264,615193,46,256577,85,236030,5.0,34716,0.0,36753,7.0,14044,65,198930,4.0,14359,9.0,8697,138,138998
436,2/23/2022,207,615400,43,256620,44,236074,1.0,34717,0.0,36753,4.0,14048,32,198962,5.0,14364,3.0,8700,120,139118
437,2/24/2022,198,615598,31,256651,50,236124,0.0,34717,1.0,36754,8.0,14056,33,198995,2.0,14366,7.0,8707,119,139237
438,2/25/2022,305,615903,54,256705,101,236225,2.0,34719,0.0,36754,13.0,14069,67,199062,13.0,14379,8.0,8715,152,139389
439,2/26/2022,175,616078,24,256729,43,236268,2.0,34721,1.0,36755,1.0,14070,34,199096,6.0,14385,2.0,8717,110,139499
440,2/27/2022,32,616110,8,256737,9,236277,0.0,34721,1.0,36756,0.0,14070,7,199103,1.0,14386,1.0,8718,15,139514
