,Date,daily number of doses received by Larimer County residents,total number of doses recevied by residents,daily number of residents receiving first dose,total number of residents receiving first dose,daily number of residents vaccinated,total number of residents vaccinated,daily number of 70+ vaccinated,total number of 70+ vaccinated,daily number of 70+ at least one dose,total number of 70+ at least one dose,daily number of Latinx residents vaccinated,total of Latinx residents vaccinated,daily number of White non-Latinx residents vaccinated,total of White non-Latinx residents vaccinated,daily number of non-White non-Latinx residents vaccinated,total of non-White non-Latinx residents vaccinated,dailyUnknown,totalUnknown,daily_additional_doses,total_additional_doses,daily_second_booster ,total_second_boosters
0,12/14/2020,31,31,31,31,0,0,0.0,0,1.0,1,0.0,0,0,0,0.0,0,,0,0,0,0,0
1,12/15/2020,14,45,14,45,0,0,,0,,1,,0,0,0,0.0,0,,0,0,0,0,0
2,12/16/2020,310,355,310,355,0,0,0.0,0,1.0,2,0.0,0,0,0,0.0,0,0.0,0,0,0,0,0
3,12/17/2020,995,1350,995,1350,0,0,0.0,0,11.0,13,0.0,0,0,0,0.0,0,0.0,0,0,0,0,0
4,12/18/2020,1051,2401,1051,2401,0,0,0.0,0,15.0,28,0.0,0,0,0,0.0,0,0.0,0,0,0,0,0
5,12/19/2020,722,3123,722,3123,0,0,0.0,0,13.0,41,0.0,0,0,0,0.0,0,0.0,0,0,0,0,0
6,12/20/2020,270,3393,270,3393,0,0,0.0,0,4.0,45,0.0,0,0,0,0.0,0,0.0,0,0,0,0,0
7,12/21/2020,360,3753,360,3753,0,0,0.0,0,3.0,48,0.0,0,0,0,0.0,0,0.0,0,0,0,0,0
8,12/22/2020,356,4109,356,4109,0,0,0.0,0,7.0,55,0.0,0,0,0,0.0,0,0.0,0,0,0,0,0
9,12/23/2020,449,4558,449,4558,0,0,0.0,0,7.0,62,0.0,0,0,0,0.0,0,0.0,0,0,0,0,0
10,12/24/2020,109,4667,109,4667,0,0,0.0,0,3.0,65,0.0,0,0,0,0.0,0,0.0,0,0,0,0,0
11,12/25/2020,1,4668,1,4668,0,0,,0,,65,,0,0,0,,0,,0,0,0,0,0
12,12/26/2020,231,4899,231,4899,0,0,0.0,0,3.0,68,0.0,0,0,0,0.0,0,0.0,0,0,0,0,0
13,12/27/2020,276,5175,276,5175,0,0,0.0,0,196.0,264,0.0,0,0,0,0.0,0,,0,0,0,0,0
14,12/28/2020,721,5896,721,5896,0,0,0.0,0,387.0,651,0.0,0,0,0,0.0,0,0.0,0,0,0,0,0
15,12/29/2020,905,6801,904,6800,1,1,0.0,0,451.0,1102,0.0,0,1,1,0.0,0,0.0,0,0,0,0,0
16,12/30/2020,873,7674,872,7672,1,2,0.0,0,256.0,1358,0.0,0,1,2,0.0,0,0.0,0,0,0,0,0
17,12/31/2020,908,8582,907,8579,2,4,1.0,1,340.0,1698,0.0,0,2,4,0.0,0,0.0,0,0,0,0,0
18,1/1/2021,8,8590,7,8586,2,6,,1,,1698,,0,2,6,,0,0.0,0,0,0,0,0
19,1/2/2021,383,8973,383,8969,0,6,0.0,1,136.0,1834,0.0,0,0,6,0.0,0,0.0,0,0,0,0,0
20,1/3/2021,130,9103,129,9098,2,8,0.0,1,58.0,1892,0.0,0,2,8,0.0,0,0.0,0,0,0,0,0
21,1/4/2021,601,9704,585,9683,16,24,0.0,1,315.0,2207,0.0,0,13,21,2.0,2,1.0,1,0,0,0,0
22,1/5/2021,654,10358,643,10326,11,35,0.0,1,407.0,2614,0.0,0,11,32,0.0,2,0.0,1,0,0,0,0
23,1/6/2021,1263,11621,941,11267,321,356,3.0,4,534.0,3148,18.0,18,279,311,18.0,20,6.0,7,1,1,0,0
24,1/7/2021,1678,13299,714,11981,963,1319,12.0,16,407.0,3555,34.0,52,870,1181,45.0,65,14.0,21,1,2,0,0
25,1/8/2021,1991,15290,990,12971,1000,2319,12.0,28,485.0,4040,45.0,97,891,2072,42.0,107,22.0,43,1,3,0,0
26,1/9/2021,1225,16515,531,13502,694,3013,16.0,44,307.0,4347,17.0,114,629,2701,36.0,143,12.0,55,0,3,0,0
27,1/10/2021,712,17227,434,13936,278,3291,4.0,48,270.0,4617,10.0,124,252,2953,13.0,156,3.0,58,0,3,0,0
28,1/11/2021,1150,18377,798,14734,352,3643,1.0,49,531.0,5148,10.0,134,319,3272,18.0,174,5.0,63,0,3,0,0
29,1/12/2021,1184,19561,885,15619,299,3942,8.0,57,513.0,5661,15.0,149,255,3527,19.0,193,10.0,73,0,3,0,0
30,1/13/2021,1076,20637,830,16449,246,4188,1.0,58,366.0,6027,23.0,172,197,3724,16.0,209,10.0,83,0,3,0,0
31,1/14/2021,881,21518,846,17295,35,4223,1.0,59,494.0,6521,2.0,174,30,3754,1.0,210,2.0,85,0,3,0,0
32,1/15/2021,1224,22742,1208,18503,16,4239,0.0,59,759.0,7280,0.0,174,16,3770,0.0,210,0.0,85,0,3,0,0
33,1/16/2021,988,23730,974,19477,14,4253,1.0,60,583.0,7863,0.0,174,13,3783,1.0,211,0.0,85,0,3,0,0
34,1/17/2021,67,23797,61,19538,6,4259,0.0,60,23.0,7886,0.0,174,4,3787,2.0,213,0.0,85,0,3,0,0
35,1/18/2021,1023,24820,816,20354,204,4463,49.0,109,599.0,8485,6.0,180,178,3965,13.0,226,7.0,92,3,6,0,0
36,1/19/2021,1257,26077,1115,21469,139,4602,7.0,116,731.0,9216,7.0,187,119,4084,7.0,233,6.0,98,2,8,1,1
37,1/20/2021,1440,27517,1218,22687,220,4822,13.0,129,574.0,9790,14.0,201,180,4264,8.0,241,18.0,116,1,9,1,2
38,1/21/2021,2266,29783,2042,24729,224,5046,11.0,140,1582.0,11372,14.0,215,186,4450,16.0,257,8.0,124,1,10,0,2
39,1/22/2021,1751,31534,1467,26196,284,5330,94.0,234,1095.0,12467,34.0,249,230,4680,13.0,270,7.0,131,0,10,0,2
40,1/23/2021,913,32447,581,26777,332,5662,55.0,289,428.0,12895,8.0,257,306,4986,13.0,283,5.0,136,0,10,0,2
41,1/24/2021,390,32837,104,26881,286,5948,208.0,497,61.0,12956,8.0,265,270,5256,8.0,291,,136,0,10,0,2
42,1/25/2021,1419,34256,795,27676,620,6568,369.0,866,553.0,13509,13.0,278,582,5838,16.0,307,9.0,145,4,14,0,2
43,1/26/2021,1626,35882,701,28377,923,7491,455.0,1321,440.0,13949,30.0,308,839,6677,39.0,346,15.0,160,1,15,1,3
44,1/27/2021,1841,37723,775,29152,1065,8556,530.0,1851,334.0,14283,41.0,349,969,7646,47.0,393,8.0,168,1,16,0,3
45,1/28/2021,1365,39088,554,29706,810,9366,351.0,2202,303.0,14586,25.0,374,743,8389,29.0,422,13.0,181,1,17,0,3
46,1/29/2021,1647,40735,1164,30870,482,9848,165.0,2367,826.0,15412,23.0,397,417,8806,32.0,454,10.0,191,1,18,0,3
47,1/30/2021,1223,41958,737,31607,484,10332,207.0,2574,598.0,16010,24.0,421,435,9241,19.0,473,6.0,197,2,20,0,3
48,1/31/2021,654,42612,425,32032,225,10557,76.0,2650,365.0,16375,5.0,426,199,9440,15.0,488,6.0,203,3,23,1,4
49,2/1/2021,1676,44288,956,32988,714,11271,464.0,3114,668.0,17043,20.0,446,657,10097,28.0,516,9.0,212,7,30,0,4
50,2/2/2021,1879,46167,741,33729,1138,12409,734.0,3848,583.0,17626,45.0,491,1048,11145,34.0,550,11.0,223,0,30,0,4
51,2/3/2021,1277,47444,594,34323,684,13093,322.0,4170,230.0,17856,48.0,539,579,11724,46.0,596,11.0,234,0,30,0,4
52,2/4/2021,2530,49974,1780,36103,750,13843,497.0,4667,1534.0,19390,31.0,570,671,12395,38.0,634,10.0,244,0,30,0,4
53,2/5/2021,2583,52557,1531,37634,1048,14891,690.0,5357,1304.0,20694,38.0,608,959,13354,33.0,667,18.0,262,5,35,0,4
54,2/6/2021,2230,54787,1605,39239,625,15516,454.0,5811,1239.0,21933,11.0,619,587,13941,20.0,687,7.0,269,0,35,0,4
55,2/7/2021,239,55026,93,39332,144,15660,97.0,5908,29.0,21962,7.0,626,129,14070,4.0,691,4.0,273,2,37,0,4
56,2/8/2021,2461,57487,1582,40914,880,16540,595.0,6503,1126.0,23088,28.0,654,807,14877,28.0,719,17.0,290,0,37,0,4
57,2/9/2021,2389,59876,1528,42442,860,17400,526.0,7029,981.0,24069,26.0,680,772,15649,40.0,759,22.0,312,2,39,0,4
58,2/10/2021,1593,61469,974,43416,612,18012,314.0,7343,288.0,24357,24.0,704,544,16193,29.0,788,15.0,327,7,46,0,4
59,2/11/2021,3537,65006,2002,45418,1534,19546,1049.0,8392,809.0,25166,54.0,758,1397,17590,56.0,844,27.0,354,3,49,0,4
60,2/12/2021,3274,68280,1817,47235,1453,20999,959.0,9351,796.0,25962,59.0,817,1335,18925,47.0,891,12.0,366,4,53,0,4
61,2/13/2021,3000,71280,2362,49597,636,21635,311.0,9662,676.0,26638,14.0,831,584,19509,26.0,917,12.0,378,2,55,0,4
62,2/14/2021,438,71718,354,49951,83,21718,57.0,9719,44.0,26682,2.0,833,76,19585,3.0,920,2.0,380,1,56,0,4
63,2/15/2021,2624,74342,2127,52078,497,22215,322.0,10041,259.0,26941,18.0,851,465,20050,12.0,932,2.0,382,0,56,0,4
64,2/16/2021,2752,77094,1911,53989,841,23056,497.0,10538,229.0,27170,36.0,887,766,20816,22.0,954,17.0,399,0,56,0,4
65,2/17/2021,1649,78743,657,54646,989,24045,483.0,11021,155.0,27325,32.0,919,899,21715,40.0,994,18.0,417,4,60,0,4
66,2/18/2021,2646,81389,1681,56327,961,25006,732.0,11753,279.0,27604,37.0,956,884,22599,32.0,1026,8.0,425,4,64,0,4
67,2/19/2021,2436,83825,1037,57364,1396,26402,1031.0,12784,160.0,27764,45.0,1001,1289,23888,47.0,1073,15.0,440,3,67,0,4
68,2/20/2021,1659,85484,680,58044,977,27379,793.0,13577,129.0,27893,24.0,1025,911,24799,32.0,1105,10.0,450,2,69,0,4
69,2/21/2021,116,85600,44,58088,70,27449,40.0,13617,8.0,27901,0.0,1025,67,24866,2.0,1107,1.0,451,2,71,0,4
70,2/22/2021,2033,87633,764,58852,1265,28714,929.0,14546,149.0,28050,38.0,1063,1176,26042,41.0,1148,10.0,461,4,75,0,4
71,2/23/2021,1233,88866,523,59375,709,29423,470.0,15016,161.0,28211,21.0,1084,639,26681,37.0,1185,12.0,473,1,76,0,4
72,2/24/2021,1425,90291,760,60135,663,30086,280.0,15296,138.0,28349,28.0,1112,612,27293,19.0,1204,4.0,477,2,78,0,4
73,2/25/2021,3873,94164,2068,62203,1802,31888,1506.0,16802,353.0,28702,49.0,1161,1698,28991,40.0,1244,15.0,492,2,80,1,5
74,2/26/2021,3279,97443,1163,63366,2113,34001,1740.0,18542,204.0,28906,32.0,1193,1991,30982,61.0,1305,29.0,521,3,83,0,5
75,2/27/2021,3502,100945,1672,65038,1826,35827,1560.0,20102,550.0,29456,35.0,1228,1707,32689,57.0,1362,27.0,548,4,87,0,5
76,2/28/2021,439,101384,365,65403,71,35898,43.0,20145,117.0,29573,2.0,1230,66,32755,1.0,1363,2.0,550,3,90,0,5
77,3/1/2021,2971,104355,1477,66880,1499,37397,1075.0,21220,304.0,29877,55.0,1285,1387,34142,46.0,1409,11.0,561,14,104,0,5
78,3/2/2021,3263,107618,1739,68619,1521,38918,1042.0,22262,385.0,30262,37.0,1322,1412,35554,44.0,1453,28.0,589,3,107,0,5
79,3/3/2021,1672,109290,1096,69715,581,39499,179.0,22441,209.0,30471,31.0,1353,516,36070,28.0,1481,6.0,595,0,107,0,5
80,3/4/2021,3028,112318,1603,71318,1458,40957,821.0,23262,171.0,30642,43.0,1396,1338,37408,58.0,1539,19.0,614,2,109,0,5
81,3/5/2021,3496,115814,2065,73383,1477,42434,821.0,24083,425.0,31067,42.0,1438,1368,38776,43.0,1582,24.0,638,3,112,0,5
82,3/6/2021,4133,119947,2338,75721,2719,45153,866.0,24949,271.0,31338,172.0,1610,2386,41162,126.0,1708,35.0,673,3,115,1,6
83,3/7/2021,429,120376,311,76032,152,45305,35.0,24984,23.0,31361,4.0,1614,143,41305,2.0,1710,3.0,676,0,115,0,6
84,3/8/2021,2831,123207,1065,77097,1924,47229,276.0,25260,77.0,31438,54.0,1668,1780,43085,67.0,1777,23.0,699,4,119,0,6
85,3/9/2021,3200,126407,1661,78758,1642,48871,263.0,25523,96.0,31534,54.0,1722,1495,44580,69.0,1846,24.0,723,10,129,0,6
86,3/10/2021,2416,128823,1395,80153,1102,49973,309.0,25832,89.0,31623,54.0,1776,992,45572,38.0,1884,18.0,741,3,132,0,6
87,3/11/2021,4191,133014,2390,82543,1907,51880,403.0,26235,135.0,31758,65.0,1841,1750,47322,71.0,1955,21.0,762,6,138,0,6
88,3/12/2021,3965,136979,2588,85131,1479,53359,205.0,26440,68.0,31826,94.0,1935,1298,48620,57.0,2012,30.0,792,8,146,0,6
89,3/13/2021,225,137204,141,85272,134,53493,21.0,26461,6.0,31832,1.0,1936,125,48745,6.0,2018,2.0,794,1,147,0,6
90,3/14/2021,105,137309,62,85334,43,53536,9.0,26470,0.0,31832,1.0,1937,40,48785,1.0,2019,1.0,795,1,148,0,6
91,3/15/2021,923,138232,381,85715,567,54103,90.0,26560,15.0,31847,20.0,1957,521,49306,17.0,2036,9.0,804,2,150,0,6
92,3/16/2021,3316,141548,2130,87845,1230,55333,234.0,26794,46.0,31893,67.0,2024,1099,50405,46.0,2082,18.0,822,1,151,0,6
93,3/17/2021,2937,144485,1793,89638,1197,56530,239.0,27033,87.0,31980,41.0,2065,1098,51503,41.0,2123,17.0,839,7,158,0,6
94,3/18/2021,4029,148514,2095,91733,1962,58492,344.0,27377,91.0,32071,99.0,2164,1780,53283,64.0,2187,19.0,858,12,170,0,6
95,3/19/2021,3028,151542,1758,93491,1286,59778,224.0,27601,44.0,32115,63.0,2227,1158,54441,46.0,2233,19.0,877,11,181,1,7
96,3/20/2021,3086,154628,1961,95452,1169,60947,319.0,27920,52.0,32167,37.0,2264,1045,55486,63.0,2296,24.0,901,7,188,0,7
97,3/21/2021,690,155318,413,95865,295,61242,28.0,27948,5.0,32172,13.0,2277,262,55748,19.0,2315,1.0,902,5,193,0,7
98,3/22/2021,3128,158446,2250,98115,903,62145,196.0,28144,57.0,32229,19.0,2296,832,56580,39.0,2354,13.0,915,7,200,0,7
99,3/23/2021,4474,162920,3579,101694,1749,63894,202.0,28346,74.0,32303,66.0,2362,1525,58105,106.0,2460,52.0,967,2,202,0,7
100,3/24/2021,3174,166094,2436,104130,796,64690,125.0,28471,36.0,32339,46.0,2408,706,58811,28.0,2488,16.0,983,5,207,0,7
101,3/25/2021,5071,171165,3044,107174,2043,66733,313.0,28784,70.0,32409,68.0,2476,1870,60681,73.0,2561,32.0,1015,12,219,2,9
102,3/26/2021,4606,175771,2732,109906,1911,68644,332.0,29116,67.0,32476,119.0,2595,1648,62329,114.0,2675,30.0,1045,10,229,0,9
103,3/27/2021,3350,179121,1907,111813,1449,70093,332.0,29448,21.0,32497,48.0,2643,1331,63660,49.0,2724,21.0,1066,3,232,0,9
104,3/28/2021,1191,180312,828,112641,365,70458,92.0,29540,17.0,32514,12.0,2655,334,63994,16.0,2740,3.0,1069,1,233,0,9
105,3/29/2021,4014,184326,2701,115342,1331,71789,234.0,29774,55.0,32569,43.0,2698,1243,65237,33.0,2773,12.0,1081,4,237,0,9
106,3/30/2021,4388,188714,2758,118100,1709,73498,248.0,30022,76.0,32645,57.0,2755,1552,66789,78.0,2851,22.0,1103,7,244,0,9
107,3/31/2021,3633,192347,2593,120693,1110,74608,172.0,30194,48.0,32693,46.0,2801,990,67779,51.0,2902,23.0,1126,7,251,0,9
108,4/1/2021,5225,197572,3391,124084,1879,76487,155.0,30349,81.0,32774,77.0,2878,1704,69483,74.0,2976,24.0,1150,22,273,1,10
109,4/2/2021,4738,202310,2536,126620,2246,78733,243.0,30592,52.0,32826,82.0,2960,2037,71520,98.0,3074,29.0,1179,6,279,1,11
110,4/3/2021,4288,206598,3527,130147,879,79612,100.0,30692,42.0,32868,39.0,2999,785,72305,36.0,3110,19.0,1198,6,285,0,11
111,4/4/2021,391,206989,270,130417,175,79787,6.0,30698,7.0,32875,3.0,3002,157,72462,13.0,3123,2.0,1200,2,287,0,11
112,4/5/2021,4724,211713,3787,134204,1079,80866,81.0,30779,47.0,32922,70.0,3072,929,73391,55.0,3178,25.0,1225,3,290,0,11
113,4/6/2021,5191,216904,3051,137255,2663,83529,92.0,30871,63.0,32985,91.0,3163,2336,75727,171.0,3349,65.0,1290,10,300,1,12
114,4/7/2021,5026,221930,3707,140962,3539,87068,84.0,30955,108.0,33093,157.0,3320,3037,78764,251.0,3600,94.0,1384,12,312,0,12
115,4/8/2021,6696,228626,4507,145469,4005,91073,165.0,31120,120.0,33213,169.0,3489,3527,82291,222.0,3822,87.0,1471,17,329,0,12
116,4/9/2021,5755,234381,3287,148756,4196,95269,96.0,31216,70.0,33283,196.0,3685,3653,85944,246.0,4068,101.0,1572,13,342,2,14
117,4/10/2021,4446,238827,3172,151928,2368,97637,71.0,31287,70.0,33353,130.0,3815,2007,87951,166.0,4234,65.0,1637,5,347,0,14
118,4/11/2021,1053,239880,797,152725,367,98004,7.0,31294,11.0,33364,16.0,3831,302,88253,38.0,4272,11.0,1648,0,347,0,14
119,4/12/2021,5077,244957,3655,156380,2683,100687,98.0,31392,97.0,33461,102.0,3933,2335,90588,177.0,4449,69.0,1717,12,359,0,14
120,4/13/2021,5054,250011,3563,159943,1524,102211,56.0,31448,77.0,33538,73.0,4006,1322,91910,103.0,4552,26.0,1743,10,369,0,14
121,4/14/2021,2977,252988,1442,161385,1525,103736,85.0,31533,25.0,33563,92.0,4098,1329,93239,75.0,4627,29.0,1772,10,379,0,14
122,4/15/2021,4973,257961,2326,163711,2632,106368,103.0,31636,61.0,33624,220.0,4318,2188,95427,167.0,4794,57.0,1829,16,395,1,15
123,4/16/2021,3940,261901,2079,165790,1843,108211,46.0,31682,35.0,33659,68.0,4386,1604,97031,135.0,4929,36.0,1865,17,412,1,16
124,4/17/2021,4589,266490,2394,168184,2185,110396,38.0,31720,57.0,33716,103.0,4489,1901,98932,135.0,5064,46.0,1911,10,422,1,17
125,4/18/2021,1068,267558,412,168596,649,111045,15.0,31735,10.0,33726,47.0,4536,539,99471,35.0,5099,28.0,1939,6,428,1,18
126,4/19/2021,3859,271417,1403,169999,2440,113485,44.0,31779,39.0,33765,169.0,4705,2053,101524,161.0,5260,57.0,1996,15,443,1,19
127,4/20/2021,4710,276127,1854,171853,2829,116314,47.0,31826,71.0,33836,161.0,4866,2408,103932,197.0,5457,63.0,2059,23,466,4,23
128,4/21/2021,3239,279366,722,172575,2499,118813,37.0,31863,31.0,33867,150.0,5016,2102,106034,169.0,5626,78.0,2137,20,486,0,23
129,4/22/2021,4659,284025,1772,174347,2869,121682,47.0,31910,62.0,33929,145.0,5161,2463,108497,193.0,5819,68.0,2205,18,504,0,23
130,4/23/2021,3609,287634,1174,175521,2422,124104,43.0,31953,31.0,33960,78.0,5239,2136,110633,129.0,5948,79.0,2284,15,519,0,23
131,4/24/2021,3370,291004,1124,176645,2236,126340,15.0,31968,20.0,33980,108.0,5347,1895,112528,193.0,6141,40.0,2324,10,529,0,23
132,4/25/2021,834,291838,366,177011,466,126806,6.0,31974,8.0,33988,107.0,5454,284,112812,39.0,6180,36.0,2360,3,532,0,23
133,4/26/2021,4401,296239,1111,178122,3283,130089,38.0,32012,30.0,34018,151.0,5605,2828,115640,213.0,6393,91.0,2451,9,541,0,23
134,4/27/2021,3385,299624,1203,179325,2187,132276,41.0,32053,38.0,34056,81.0,5686,1927,117567,138.0,6531,41.0,2492,14,555,1,24
135,4/28/2021,3015,302639,716,180041,2310,134586,45.0,32098,23.0,34079,169.0,5855,1874,119441,204.0,6735,63.0,2555,19,574,1,25
136,4/29/2021,4004,306643,822,180863,3191,137777,73.0,32171,32.0,34111,234.0,6089,2617,122058,235.0,6970,105.0,2660,10,584,0,25
137,4/30/2021,2911,309554,659,181522,2263,140040,50.0,32221,24.0,34135,74.0,6163,1927,123985,203.0,7173,59.0,2719,21,605,0,25
138,5/1/2021,3700,313254,824,182346,2853,142893,37.0,32258,19.0,34154,283.0,6446,2226,126211,205.0,7378,139.0,2858,38,643,1,26
139,5/2/2021,549,313803,242,182588,325,143218,7.0,32265,2.0,34156,12.0,6458,260,126471,43.0,7421,10.0,2868,4,647,0,26
140,5/3/2021,3436,317239,641,183229,2807,146025,47.0,32312,34.0,34190,111.0,6569,2410,128881,212.0,7633,74.0,2942,13,660,0,26
141,5/4/2021,4363,321602,690,183919,3718,149743,71.0,32383,26.0,34216,150.0,6719,3189,132070,261.0,7894,118.0,3060,9,669,2,28
142,5/5/2021,2247,323849,481,184400,1820,151563,62.0,32445,24.0,34240,88.0,6807,1508,133578,146.0,8040,78.0,3138,7,676,2,30
143,5/6/2021,3700,327549,826,185226,3049,154612,100.0,32545,38.0,34278,182.0,6989,2537,136115,202.0,8242,128.0,3266,9,685,5,35
144,5/7/2021,2951,330500,539,185765,2550,157162,46.0,32591,11.0,34289,136.0,7125,2104,138219,211.0,8453,99.0,3365,14,699,1,36
145,5/8/2021,3019,333519,568,186333,2618,159780,47.0,32638,16.0,34305,170.0,7295,2127,140346,194.0,8647,127.0,3492,10,709,0,36
146,5/9/2021,384,333903,147,186480,251,160031,4.0,32642,2.0,34307,11.0,7306,209,140555,22.0,8669,9.0,3501,3,712,0,36
147,5/10/2021,2454,336357,385,186865,2132,162163,65.0,32707,16.0,34323,91.0,7397,1739,142294,206.0,8875,96.0,3597,7,719,3,39
148,5/11/2021,2728,339085,537,187402,2247,164410,95.0,32802,23.0,34346,193.0,7590,1755,144049,205.0,9080,94.0,3691,15,734,1,40
149,5/12/2021,1254,340339,465,187867,870,165280,27.0,32829,14.0,34360,54.0,7644,693,144742,86.0,9166,37.0,3728,8,742,0,40
150,5/13/2021,3267,343606,1033,188900,2262,167542,86.0,32915,25.0,34385,147.0,7791,1844,146586,166.0,9332,105.0,3833,12,754,4,44
151,5/14/2021,2477,346083,1284,190184,1326,168868,58.0,32973,30.0,34415,66.0,7857,1107,147693,100.0,9432,53.0,3886,12,766,2,46
152,5/15/2021,3042,349125,1511,191695,1657,170525,44.0,33017,17.0,34432,117.0,7974,1321,149014,147.0,9579,72.0,3958,7,773,3,49
153,5/16/2021,949,350074,543,192238,449,170974,11.0,33028,5.0,34437,90.0,8064,284,149298,33.0,9612,42.0,4000,1,774,2,51
154,5/17/2021,2447,352521,1207,193445,1336,172310,36.0,33064,27.0,34464,50.0,8114,1116,150414,111.0,9723,59.0,4059,5,779,1,52
155,5/18/2021,2587,355108,1157,194602,1470,173780,46.0,33110,22.0,34486,77.0,8191,1242,151656,88.0,9811,63.0,4122,10,789,4,56
156,5/19/2021,1891,356999,1156,195758,815,174595,28.0,33138,20.0,34506,43.0,8234,666,152322,67.0,9878,39.0,4161,4,793,1,57
157,5/20/2021,1991,358990,938,196696,1110,175705,44.0,33182,28.0,34534,97.0,8331,887,153209,77.0,9955,49.0,4210,11,804,2,59
158,5/21/2021,1667,360657,931,197627,841,176546,21.0,33203,15.0,34549,44.0,8375,675,153884,66.0,10021,56.0,4266,14,818,2,61
159,5/22/2021,1699,362356,797,198424,942,177488,9.0,33212,13.0,34562,123.0,8498,661,154545,76.0,10097,82.0,4348,9,827,2,63
160,5/23/2021,688,363044,343,198767,377,177865,2.0,33214,5.0,34567,67.0,8565,234,154779,21.0,10118,55.0,4403,0,827,0,63
161,5/24/2021,1353,364397,543,199310,885,178750,37.0,33251,20.0,34587,41.0,8606,715,155494,85.0,10203,44.0,4447,12,839,2,65
162,5/25/2021,1239,365636,510,199820,772,179522,24.0,33275,19.0,34606,57.0,8663,583,156077,67.0,10270,65.0,4512,7,846,0,65
163,5/26/2021,974,366610,549,200369,566,180088,22.0,33297,25.0,34631,41.0,8704,450,156527,44.0,10314,31.0,4543,3,849,1,66
164,5/27/2021,1315,367925,668,201037,731,180819,32.0,33329,20.0,34651,59.0,8763,587,157114,56.0,10370,29.0,4572,6,855,1,67
165,5/28/2021,1052,368977,607,201644,506,181325,20.0,33349,23.0,34674,34.0,8797,394,157508,52.0,10422,26.0,4598,11,866,0,67
166,5/29/2021,1031,370008,496,202140,581,181906,19.0,33368,7.0,34681,34.0,8831,462,157970,45.0,10467,40.0,4638,6,872,0,67
167,5/30/2021,334,370342,218,202358,152,182058,5.0,33373,3.0,34684,14.0,8845,109,158079,18.0,10485,11.0,4649,3,875,2,69
168,5/31/2021,342,370684,191,202549,178,182236,8.0,33381,6.0,34690,8.0,8853,148,158227,11.0,10496,11.0,4660,11,886,1,70
169,6/1/2021,1020,371704,410,202959,629,182865,29.0,33410,18.0,34708,52.0,8905,484,158711,47.0,10543,46.0,4706,41,927,1,71
170,6/2/2021,724,372428,369,203328,421,183286,16.0,33426,8.0,34716,35.0,8940,337,159048,24.0,10567,25.0,4731,3,930,1,72
171,6/3/2021,1319,373747,522,203850,863,184149,22.0,33448,11.0,34727,52.0,8992,708,159756,63.0,10630,40.0,4771,4,934,0,72
172,6/4/2021,1500,375247,400,204250,1154,185303,16.0,33464,11.0,34738,71.0,9063,968,160724,70.0,10700,45.0,4816,3,937,1,73
173,6/5/2021,1426,376673,363,204613,1092,186395,13.0,33477,6.0,34744,62.0,9125,891,161615,96.0,10796,43.0,4859,10,947,2,75
174,6/6/2021,565,377238,149,204762,436,186831,5.0,33482,3.0,34747,51.0,9176,344,161959,28.0,10824,13.0,4872,1,948,0,75
175,6/7/2021,1204,378442,343,205105,920,187751,16.0,33498,12.0,34759,67.0,9243,737,162696,82.0,10906,34.0,4906,8,956,1,76
176,6/8/2021,1093,379535,248,205353,875,188626,18.0,33516,5.0,34764,59.0,9302,713,163409,71.0,10977,32.0,4938,7,963,0,76
177,6/9/2021,1087,380622,283,205636,859,189485,15.0,33531,11.0,34775,76.0,9378,664,164073,75.0,11052,44.0,4982,4,967,1,77
178,6/10/2021,1336,381958,345,205981,1037,190522,21.0,33552,4.0,34779,94.0,9472,817,164890,72.0,11124,54.0,5036,11,978,1,78
179,6/11/2021,1121,383079,324,206305,852,191374,20.0,33572,14.0,34793,62.0,9534,665,165555,81.0,11205,44.0,5080,2,980,0,78
180,6/12/2021,1050,384129,288,206593,813,192187,16.0,33588,9.0,34802,71.0,9605,634,166189,67.0,11272,41.0,5121,1,981,0,78
181,6/13/2021,374,384503,99,206692,293,192480,4.0,33592,1.0,34803,35.0,9640,213,166402,25.0,11297,20.0,5141,3,984,0,78
182,6/14/2021,852,385355,293,206985,615,193095,15.0,33607,4.0,34807,48.0,9688,469,166871,45.0,11342,53.0,5194,3,987,0,78
183,6/15/2021,713,386068,245,207230,494,193589,21.0,33628,10.0,34817,45.0,9733,398,167269,34.0,11376,17.0,5211,2,989,1,79
184,6/16/2021,646,386714,210,207440,470,194059,13.0,33641,5.0,34822,40.0,9773,350,167619,41.0,11417,39.0,5250,6,995,0,79
185,6/17/2021,706,387420,255,207695,479,194538,15.0,33656,9.0,34831,45.0,9818,353,167972,51.0,11468,30.0,5280,7,1002,1,80
186,6/18/2021,1049,388469,378,208073,707,195245,21.0,33677,11.0,34842,57.0,9875,562,168534,58.0,11526,30.0,5310,13,1015,0,80
187,6/19/2021,648,389117,155,208228,514,195759,9.0,33686,6.0,34848,51.0,9926,382,168916,54.0,11580,27.0,5337,4,1019,0,80
188,6/20/2021,297,389414,112,208340,193,195952,3.0,33689,2.0,34850,37.0,9963,118,169034,15.0,11595,23.0,5360,5,1024,0,80
189,6/21/2021,523,389937,217,208557,340,196292,5.0,33694,7.0,34857,30.0,9993,253,169287,34.0,11629,23.0,5383,4,1028,0,80
190,6/22/2021,619,390556,252,208809,405,196697,13.0,33707,8.0,34865,32.0,10025,318,169605,27.0,11656,28.0,5411,1,1029,0,80
191,6/23/2021,510,391066,186,208995,351,197048,8.0,33715,10.0,34875,42.0,10067,254,169859,34.0,11690,21.0,5432,9,1038,1,81
192,6/24/2021,532,391598,207,209202,351,197399,13.0,33728,9.0,34884,34.0,10101,271,170130,24.0,11714,22.0,5454,2,1040,0,81
193,6/25/2021,694,392292,275,209477,444,197843,13.0,33741,9.0,34893,44.0,10145,332,170462,42.0,11756,26.0,5480,3,1043,0,81
194,6/26/2021,606,392898,164,209641,456,198299,9.0,33750,9.0,34902,79.0,10224,300,170762,48.0,11804,29.0,5509,3,1046,1,82
195,6/27/2021,184,393082,66,209707,120,198419,2.0,33752,3.0,34905,10.0,10234,88,170850,12.0,11816,10.0,5519,2,1048,0,82
196,6/28/2021,495,393577,210,209917,292,198711,7.0,33759,6.0,34911,40.0,10274,208,171058,26.0,11842,18.0,5537,8,1056,0,82
197,6/29/2021,566,394143,259,210176,339,199050,17.0,33776,11.0,34922,43.0,10317,248,171306,23.0,11865,25.0,5562,9,1065,2,84
198,6/30/2021,423,394566,206,210382,230,199280,8.0,33784,11.0,34933,20.0,10337,173,171479,17.0,11882,20.0,5582,8,1073,2,86
199,7/1/2021,517,395083,220,210602,308,199588,9.0,33793,7.0,34940,24.0,10361,229,171708,34.0,11916,21.0,5603,16,1089,2,88
200,7/2/2021,575,395658,274,210876,314,199902,7.0,33800,7.0,34947,28.0,10389,244,171952,26.0,11942,16.0,5619,6,1095,0,88
201,7/3/2021,303,395961,118,210994,192,200094,4.0,33804,3.0,34950,29.0,10418,125,172077,20.0,11962,18.0,5637,5,1100,0,88
202,7/4/2021,55,396016,20,211014,35,200129,1.0,33805,0.0,34950,4.0,10422,22,172099,1.0,11963,8.0,5645,0,1100,0,88
203,7/5/2021,326,396342,143,211157,180,200309,4.0,33809,1.0,34951,19.0,10441,125,172224,26.0,11989,10.0,5655,9,1109,0,88
204,7/6/2021,474,396816,193,211350,291,200600,4.0,33813,5.0,34956,45.0,10486,211,172435,21.0,12010,14.0,5669,4,1113,0,88
205,7/7/2021,391,397207,218,211568,193,200793,8.0,33821,6.0,34962,23.0,10509,141,172576,13.0,12023,16.0,5685,5,1118,0,88
206,7/8/2021,433,397640,203,211771,254,201047,9.0,33830,8.0,34970,25.0,10534,180,172756,26.0,12049,23.0,5708,4,1122,1,89
207,7/9/2021,477,398117,192,211963,296,201343,10.0,33840,2.0,34972,39.0,10573,215,172971,24.0,12073,18.0,5726,2,1124,2,91
208,7/10/2021,268,398385,155,212118,133,201476,5.0,33845,2.0,34974,6.0,10579,109,173080,10.0,12083,8.0,5734,2,1126,0,91
209,7/11/2021,222,398607,120,212238,125,201601,6.0,33851,7.0,34981,11.0,10590,93,173173,9.0,12092,12.0,5746,7,1133,2,93
210,7/12/2021,394,399001,207,212445,200,201801,6.0,33857,4.0,34985,27.0,10617,134,173307,22.0,12114,17.0,5763,4,1137,0,93
211,7/13/2021,441,399442,228,212673,235,202036,17.0,33874,9.0,34994,29.0,10646,182,173489,12.0,12126,12.0,5775,4,1141,0,93
212,7/14/2021,289,399731,155,212828,161,202197,8.0,33882,5.0,34999,20.0,10666,117,173606,9.0,12135,15.0,5790,4,1145,1,94
213,7/15/2021,364,400095,186,213014,186,202383,1.0,33883,4.0,35003,16.0,10682,139,173745,14.0,12149,17.0,5807,6,1151,0,94
214,7/16/2021,512,400607,247,213261,281,202664,8.0,33891,9.0,35012,24.0,10706,214,173959,21.0,12170,22.0,5829,1,1152,0,94
215,7/17/2021,276,400883,158,213419,137,202801,12.0,33903,4.0,35016,13.0,10719,107,174066,8.0,12178,9.0,5838,3,1155,0,94
216,7/18/2021,194,401077,115,213534,95,202896,4.0,33907,3.0,35019,14.0,10733,67,174133,7.0,12185,7.0,5845,3,1158,0,94
217,7/19/2021,408,401485,203,213737,212,203108,9.0,33916,8.0,35027,26.0,10759,156,174289,18.0,12203,12.0,5857,4,1162,2,96
218,7/20/2021,430,401915,217,213954,221,203329,6.0,33922,8.0,35035,12.0,10771,171,174460,25.0,12228,13.0,5870,6,1168,2,98
219,7/21/2021,346,402261,188,214142,178,203507,14.0,33936,14.0,35049,15.0,10786,132,174592,14.0,12242,17.0,5887,4,1172,1,99
220,7/22/2021,401,402662,233,214375,178,203685,7.0,33943,17.0,35066,21.0,10807,133,174725,17.0,12259,7.0,5894,7,1179,1,100
221,7/23/2021,559,403221,327,214702,240,203925,7.0,33950,10.0,35076,38.0,10845,166,174891,19.0,12278,17.0,5911,6,1185,0,100
222,7/24/2021,351,403572,212,214914,162,204087,9.0,33959,9.0,35085,20.0,10865,119,175010,9.0,12287,14.0,5925,3,1188,1,101
223,7/25/2021,192,403764,139,215053,65,204152,0.0,33959,4.0,35089,7.0,10872,47,175057,5.0,12292,6.0,5931,4,1192,0,101
224,7/26/2021,357,404121,205,215258,154,204306,3.0,33962,6.0,35095,12.0,10884,106,175163,20.0,12312,16.0,5947,10,1202,0,101
225,7/27/2021,432,404553,235,215493,187,204493,7.0,33969,18.0,35113,23.0,10907,131,175294,20.0,12332,13.0,5960,26,1228,0,101
226,7/28/2021,475,405028,285,215778,226,204719,4.0,33973,10.0,35123,30.0,10937,148,175442,17.0,12349,31.0,5991,5,1233,2,103
227,7/29/2021,523,405551,315,216093,240,204959,8.0,33981,7.0,35130,27.0,10964,180,175622,14.0,12363,19.0,6010,13,1246,1,104
228,7/30/2021,698,406249,483,216576,253,205212,10.0,33991,14.0,35144,29.0,10993,189,175811,17.0,12380,18.0,6028,9,1255,1,105
229,7/31/2021,340,406589,200,216776,142,205354,4.0,33995,1.0,35145,16.0,11009,113,175924,8.0,12388,5.0,6033,10,1265,0,105
230,8/1/2021,303,406892,179,216955,106,205460,0.0,33995,2.0,35147,14.0,11023,66,175990,10.0,12398,16.0,6049,33,1298,3,108
231,8/2/2021,456,407348,299,217254,184,205644,5.0,34000,14.0,35161,22.0,11045,128,176118,19.0,12417,15.0,6064,8,1306,2,110
232,8/3/2021,570,407918,352,217606,250,205894,6.0,34006,14.0,35175,42.0,11087,167,176285,16.0,12433,25.0,6089,4,1310,1,111
233,8/4/2021,402,408320,280,217886,154,206048,6.0,34012,13.0,35188,11.0,11098,115,176400,8.0,12441,20.0,6109,2,1312,1,112
234,8/5/2021,445,408765,288,218174,171,206219,6.0,34018,9.0,35197,21.0,11119,124,176524,16.0,12457,10.0,6119,8,1320,0,112
235,8/6/2021,681,409446,458,218632,275,206494,13.0,34031,16.0,35213,23.0,11142,206,176730,24.0,12481,22.0,6141,8,1328,0,112
236,8/7/2021,453,409899,314,218946,163,206657,4.0,34035,11.0,35224,12.0,11154,132,176862,5.0,12486,14.0,6155,5,1333,1,113
237,8/8/2021,213,410112,124,219070,96,206753,3.0,34038,5.0,35229,8.0,11162,67,176929,9.0,12495,12.0,6167,5,1338,2,115
238,8/9/2021,467,410579,277,219347,221,206974,4.0,34042,6.0,35235,20.0,11182,167,177096,11.0,12506,23.0,6190,8,1346,2,117
239,8/10/2021,505,411084,297,219644,232,207206,6.0,34048,13.0,35248,26.0,11208,179,177275,13.0,12519,14.0,6204,6,1352,4,121
240,8/11/2021,417,411501,261,219905,182,207388,11.0,34059,5.0,35253,18.0,11226,138,177413,14.0,12533,12.0,6216,3,1355,0,121
241,8/12/2021,542,412043,319,220224,267,207655,7.0,34066,15.0,35268,31.0,11257,189,177602,23.0,12556,24.0,6240,7,1362,2,123
242,8/13/2021,663,412706,374,220598,309,207964,10.0,34076,9.0,35277,30.0,11287,229,177831,20.0,12576,30.0,6270,7,1369,1,124
243,8/14/2021,511,413217,261,220859,259,208223,7.0,34083,7.0,35284,12.0,11299,219,178050,10.0,12586,18.0,6288,52,1421,2,126
244,8/15/2021,269,413486,131,220990,126,208349,2.0,34085,2.0,35286,12.0,11311,90,178140,7.0,12593,17.0,6305,22,1443,0,126
245,8/16/2021,543,414029,311,221301,177,208526,4.0,34089,11.0,35297,16.0,11327,137,178277,12.0,12605,12.0,6317,85,1528,3,129
246,8/17/2021,491,414520,229,221530,200,208726,17.0,34106,10.0,35307,19.0,11346,150,178427,12.0,12617,19.0,6336,89,1617,0,129
247,8/18/2021,596,415116,327,221857,271,208997,6.0,34112,15.0,35322,31.0,11377,184,178611,15.0,12632,41.0,6377,73,1690,4,133
248,8/19/2021,571,415687,279,222136,268,209265,7.0,34119,9.0,35331,21.0,11398,210,178821,22.0,12654,15.0,6392,84,1774,1,134
249,8/20/2021,846,416533,332,222468,471,209736,16.0,34135,11.0,35342,46.0,11444,373,179194,30.0,12684,22.0,6414,97,1871,1,135
250,8/21/2021,650,417183,213,222681,210,209946,6.0,34141,7.0,35349,14.0,11458,172,179366,13.0,12697,11.0,6425,239,2110,0,135
251,8/22/2021,311,417494,148,222829,139,210085,1.0,34142,2.0,35351,18.0,11476,100,179466,9.0,12706,12.0,6437,32,2142,2,137
252,8/23/2021,529,418023,260,223089,225,210310,11.0,34153,10.0,35361,20.0,11496,169,179635,13.0,12719,23.0,6460,67,2209,1,138
253,8/24/2021,578,418601,277,223366,288,210598,12.0,34165,8.0,35369,28.0,11524,227,179862,14.0,12733,19.0,6479,57,2266,2,140
254,8/25/2021,610,419211,326,223692,271,210869,11.0,34176,13.0,35382,23.0,11547,206,180068,10.0,12743,32.0,6511,56,2322,2,142
255,8/26/2021,545,419756,260,223952,260,211129,9.0,34185,13.0,35395,18.0,11565,201,180269,23.0,12766,18.0,6529,56,2378,1,143
256,8/27/2021,896,420652,356,224308,404,211533,14.0,34199,11.0,35406,37.0,11602,298,180567,26.0,12792,43.0,6572,175,2553,6,149
257,8/28/2021,1459,422111,203,224511,248,211781,8.0,34207,5.0,35411,23.0,11625,185,180752,13.0,12805,27.0,6599,1001,3554,13,162
258,8/29/2021,1075,423186,162,224673,139,211920,4.0,34211,4.0,35415,9.0,11634,113,180865,12.0,12817,5.0,6604,768,4322,11,173
259,8/30/2021,626,423812,273,224946,286,212206,10.0,34221,13.0,35428,24.0,11658,222,181087,8.0,12825,32.0,6636,97,4419,5,178
260,8/31/2021,802,424614,233,225179,230,212436,7.0,34228,12.0,35440,20.0,11678,181,181268,17.0,12842,12.0,6648,345,4764,6,184
261,9/1/2021,981,425595,254,225433,231,212667,13.0,34241,16.0,35456,21.0,11699,177,181445,14.0,12856,19.0,6667,516,5280,3,187
262,9/2/2021,818,426413,181,225614,204,212871,15.0,34256,13.0,35469,18.0,11717,152,181597,17.0,12873,17.0,6684,454,5734,4,191
263,9/3/2021,850,427263,332,225946,374,213245,14.0,34270,11.0,35480,44.0,11761,276,181873,21.0,12894,33.0,6717,165,5899,2,193
264,9/4/2021,377,427640,162,226108,174,213419,7.0,34277,8.0,35488,14.0,11775,137,182010,11.0,12905,12.0,6729,49,5948,2,195
265,9/5/2021,250,427890,132,226240,106,213525,2.0,34279,4.0,35492,13.0,11788,79,182089,6.0,12911,8.0,6737,23,5971,0,195
266,9/6/2021,115,428005,44,226284,63,213588,1.0,34280,0.0,35492,5.0,11793,46,182135,8.0,12919,4.0,6741,13,5984,0,195
267,9/7/2021,946,428951,200,226484,278,213866,18.0,34298,12.0,35504,21.0,11814,216,182351,17.0,12936,24.0,6765,477,6461,5,200
268,9/8/2021,782,429733,217,226701,227,214093,11.0,34309,12.0,35516,24.0,11838,170,182521,11.0,12947,22.0,6787,360,6821,4,204
269,9/9/2021,407,430140,178,226879,196,214289,10.0,34319,7.0,35523,23.0,11861,144,182665,14.0,12961,15.0,6802,56,6877,0,204
270,9/10/2021,768,430908,352,227231,316,214605,9.0,34328,25.0,35548,28.0,11889,239,182904,21.0,12982,28.0,6830,140,7017,4,208
271,9/11/2021,1614,432522,157,227388,206,214811,11.0,34339,15.0,35563,17.0,11906,156,183060,17.0,12999,16.0,6846,1260,8277,6,214
272,9/12/2021,232,432754,102,227490,112,214923,0.0,34339,2.0,35565,11.0,11917,72,183132,10.0,13009,19.0,6865,16,8293,2,216
273,9/13/2021,500,433254,217,227707,257,215180,9.0,34348,8.0,35573,26.0,11943,191,183323,12.0,13021,28.0,6893,47,8340,0,216
274,9/14/2021,847,434101,202,227909,278,215458,13.0,34361,11.0,35584,18.0,11961,222,183545,16.0,13037,22.0,6915,399,8739,3,219
275,9/15/2021,831,434932,193,228102,270,215728,15.0,34376,13.0,35597,21.0,11982,199,183744,17.0,13054,33.0,6948,393,9132,3,222
276,9/16/2021,366,435298,136,228238,200,215928,9.0,34385,8.0,35605,33.0,12015,144,183888,12.0,13066,11.0,6959,45,9177,0,222
277,9/17/2021,752,436050,290,228528,397,216325,15.0,34400,13.0,35618,28.0,12043,297,184185,40.0,13106,32.0,6991,118,9295,2,224
278,9/18/2021,1804,437854,126,228654,173,216498,5.0,34405,18.0,35636,11.0,12054,129,184314,16.0,13122,17.0,7008,1503,10798,11,235
279,9/19/2021,186,438040,79,228733,106,216604,3.0,34408,2.0,35638,7.0,12061,82,184396,5.0,13127,12.0,7020,14,10812,0,235
280,9/20/2021,389,438429,143,228876,223,216827,8.0,34416,9.0,35647,28.0,12089,164,184560,11.0,13138,20.0,7040,55,10867,0,235
281,9/21/2021,774,439203,163,229039,206,217033,8.0,34424,12.0,35659,22.0,12111,157,184717,12.0,13150,15.0,7055,418,11285,3,238
282,9/22/2021,720,439923,162,229201,234,217267,5.0,34429,11.0,35670,14.0,12125,186,184903,16.0,13166,18.0,7073,359,11644,4,242
283,9/23/2021,357,440280,148,229349,183,217450,8.0,34437,4.0,35674,9.0,12134,135,185038,15.0,13181,24.0,7097,47,11691,2,244
284,9/24/2021,689,440969,201,229550,276,217726,16.0,34453,15.0,35689,20.0,12154,220,185258,12.0,13193,24.0,7121,234,11925,2,246
285,9/25/2021,1716,442685,132,229682,177,217903,11.0,34464,21.0,35710,15.0,12169,140,185398,11.0,13204,11.0,7132,1412,13337,4,250
286,9/26/2021,265,442950,69,229751,87,217990,3.0,34467,4.0,35714,11.0,12180,65,185463,4.0,13208,7.0,7139,107,13444,2,252
287,9/27/2021,574,443524,158,229909,125,218115,7.0,34474,11.0,35725,7.0,12187,97,185560,8.0,13216,13.0,7152,307,13751,1,253
288,9/28/2021,1136,444660,155,230064,203,218318,19.0,34493,23.0,35748,14.0,12201,154,185714,10.0,13226,25.0,7177,797,14548,4,257
289,9/29/2021,1132,445792,174,230238,167,218485,10.0,34503,23.0,35771,14.0,12215,126,185840,7.0,13233,20.0,7197,803,15351,5,262
290,9/30/2021,711,446503,161,230399,168,218653,15.0,34518,7.0,35778,11.0,12226,128,185968,12.0,13245,17.0,7214,407,15758,7,269
291,10/1/2021,1205,447708,178,230577,314,218967,20.0,34538,14.0,35792,25.0,12251,246,186214,21.0,13266,22.0,7236,726,16484,8,277
292,10/2/2021,1801,449509,113,230690,114,219081,11.0,34549,12.0,35804,9.0,12260,94,186308,6.0,13272,5.0,7241,1572,18056,7,284
293,10/3/2021,400,449909,64,230754,113,219194,1.0,34550,2.0,35806,20.0,12280,76,186384,7.0,13279,10.0,7251,236,18292,0,284
294,10/4/2021,807,450716,115,230869,160,219354,7.0,34557,14.0,35820,27.0,12307,104,186488,17.0,13296,12.0,7263,538,18830,3,287
295,10/5/2021,1141,451857,139,231008,143,219497,11.0,34568,19.0,35839,14.0,12321,106,186594,10.0,13306,13.0,7276,873,19703,1,288
296,10/6/2021,1015,452872,109,231117,156,219653,7.0,34575,14.0,35853,11.0,12332,124,186718,5.0,13311,16.0,7292,765,20468,4,292
297,10/7/2021,830,453702,138,231255,112,219765,8.0,34583,17.0,35870,8.0,12340,88,186806,6.0,13317,10.0,7302,601,21069,1,293
298,10/8/2021,1044,454746,160,231415,246,220011,18.0,34601,10.0,35880,22.0,12362,193,186999,10.0,13327,21.0,7323,655,21724,0,293
299,10/9/2021,1675,456421,104,231519,132,220143,11.0,34612,6.0,35886,22.0,12384,98,187097,4.0,13331,8.0,7331,1435,23159,8,301
300,10/10/2021,248,456669,54,231573,65,220208,1.0,34613,4.0,35890,5.0,12389,51,187148,4.0,13335,5.0,7336,128,23287,2,303
301,10/11/2021,819,457488,117,231690,137,220345,15.0,34628,19.0,35909,3.0,12392,114,187262,9.0,13344,11.0,7347,574,23861,2,305
302,10/12/2021,1024,458512,114,231804,131,220476,8.0,34636,16.0,35925,17.0,12409,102,187364,4.0,13348,8.0,7355,789,24650,3,308
303,10/13/2021,974,459486,122,231926,151,220627,16.0,34652,10.0,35935,16.0,12425,112,187476,14.0,13362,9.0,7364,716,25366,8,316
304,10/14/2021,719,460205,98,232024,127,220754,15.0,34667,8.0,35943,21.0,12446,94,187570,7.0,13369,5.0,7369,501,25867,4,320
305,10/15/2021,1005,461210,173,232197,207,220961,10.0,34677,9.0,35952,15.0,12461,163,187733,12.0,13381,17.0,7386,654,26521,8,328
306,10/16/2021,812,462022,69,232266,82,221043,4.0,34681,3.0,35955,7.0,12468,70,187803,2.0,13383,3.0,7389,658,27179,7,335
307,10/17/2021,195,462217,47,232313,61,221104,1.0,34682,2.0,35957,4.0,12472,46,187849,2.0,13385,9.0,7398,86,27265,1,336
308,10/18/2021,660,462877,115,232428,137,221241,10.0,34692,3.0,35960,13.0,12485,106,187955,7.0,13392,11.0,7409,422,27687,4,340
309,10/19/2021,1061,463938,129,232557,133,221374,3.0,34695,12.0,35972,8.0,12493,107,188062,8.0,13400,10.0,7419,809,28496,4,344
310,10/20/2021,893,464831,119,232676,122,221496,7.0,34702,11.0,35983,9.0,12502,91,188153,7.0,13407,15.0,7434,663,29159,7,351
311,10/21/2021,545,465376,112,232788,127,221623,10.0,34712,7.0,35990,13.0,12515,85,188238,11.0,13418,18.0,7452,325,29484,6,357
312,10/22/2021,1510,466886,195,232983,162,221785,7.0,34719,13.0,36003,18.0,12533,109,188347,8.0,13426,27.0,7479,1172,30656,7,364
313,10/23/2021,1861,468747,85,233068,76,221861,9.0,34728,13.0,36016,1.0,12534,65,188412,4.0,13430,6.0,7485,1695,32351,10,374
314,10/24/2021,601,469348,82,233150,74,221935,6.0,34734,9.0,36025,7.0,12541,58,188470,4.0,13434,5.0,7490,452,32803,4,378
315,10/25/2021,1480,470828,139,233289,114,222049,20.0,34754,19.0,36044,8.0,12549,91,188561,7.0,13441,8.0,7498,1231,34034,11,389
316,10/26/2021,2146,472974,175,233464,135,222184,6.0,34760,17.0,36061,15.0,12564,102,188663,8.0,13449,10.0,7508,1833,35867,16,405
317,10/27/2021,1977,474951,147,233611,107,222291,5.0,34765,18.0,36079,5.0,12569,85,188748,10.0,13459,7.0,7515,1730,37597,8,413
318,10/28/2021,1805,476756,144,233755,115,222406,4.0,34769,24.0,36103,7.0,12576,92,188840,4.0,13463,12.0,7527,1542,39139,14,427
319,10/29/2021,1744,478500,180,233935,133,222539,4.0,34773,13.0,36116,8.0,12584,108,188948,5.0,13468,12.0,7539,1430,40569,13,440
320,10/30/2021,1581,480081,73,234008,76,222615,5.0,34778,6.0,36122,4.0,12588,60,189008,7.0,13475,5.0,7544,1424,41993,16,456
321,10/31/2021,461,480542,47,234055,37,222652,1.0,34779,6.0,36128,7.0,12595,27,189035,1.0,13476,2.0,7546,372,42365,5,461
322,11/1/2021,1383,481925,154,234209,114,222766,3.0,34782,13.0,36141,9.0,12604,81,189116,7.0,13483,17.0,7563,1109,43474,19,480
323,11/2/2021,1848,483773,126,234335,106,222872,8.0,34790,15.0,36156,11.0,12615,77,189193,8.0,13491,10.0,7573,1616,45090,15,495
324,11/3/2021,1769,485542,162,234497,118,222990,9.0,34799,21.0,36177,10.0,12625,83,189276,6.0,13497,19.0,7592,1491,46581,17,512
325,11/4/2021,1434,486976,144,234641,92,223082,5.0,34804,14.0,36191,1.0,12626,75,189351,5.0,13502,11.0,7603,1218,47799,9,521
326,11/5/2021,2052,489028,237,234878,167,223249,12.0,34816,12.0,36203,11.0,12637,135,189486,8.0,13510,13.0,7616,1666,49465,15,536
327,11/6/2021,1603,490631,228,235106,77,223326,2.0,34818,8.0,36211,5.0,12642,63,189549,4.0,13514,5.0,7621,1289,50754,16,552
328,11/7/2021,537,491168,126,235232,43,223369,1.0,34819,8.0,36219,4.0,12646,32,189581,1.0,13515,6.0,7627,362,51116,7,559
329,11/8/2021,1535,492703,394,235626,109,223478,6.0,34825,9.0,36228,8.0,12654,87,189668,3.0,13518,11.0,7638,1045,52161,6,565
330,11/9/2021,2672,495375,946,236572,134,223612,5.0,34830,20.0,36248,12.0,12666,88,189756,9.0,13527,25.0,7663,1602,53763,12,577
331,11/10/2021,2529,497904,827,237399,116,223728,8.0,34838,16.0,36264,10.0,12676,86,189842,10.0,13537,10.0,7673,1586,55349,20,597
332,11/11/2021,2350,500254,957,238356,99,223827,6.0,34844,8.0,36272,11.0,12687,71,189913,11.0,13548,6.0,7679,1297,56646,19,616
333,11/12/2021,2595,502849,758,239114,144,223971,9.0,34853,20.0,36292,14.0,12701,110,190023,9.0,13557,11.0,7690,1683,58329,24,640
334,11/13/2021,1942,504791,404,239518,70,224041,2.0,34855,9.0,36301,4.0,12705,47,190070,7.0,13564,12.0,7702,1468,59797,9,649
335,11/14/2021,1499,506290,911,240429,57,224098,1.0,34856,2.0,36303,7.0,12712,35,190105,6.0,13570,9.0,7711,539,60336,2,651
336,11/15/2021,2004,508294,445,240874,101,224199,5.0,34861,10.0,36313,12.0,12724,69,190174,7.0,13577,13.0,7724,1465,61801,7,658
337,11/16/2021,2453,510747,447,241321,106,224305,3.0,34864,18.0,36331,16.0,12740,74,190248,7.0,13584,9.0,7733,1885,63686,29,687
338,11/17/2021,2754,513501,635,241956,130,224435,7.0,34871,19.0,36350,9.0,12749,105,190353,6.0,13590,10.0,7743,1976,65662,36,723
339,11/18/2021,2043,515544,387,242343,110,224545,6.0,34877,11.0,36361,10.0,12759,83,190436,11.0,13601,6.0,7749,1536,67198,26,749
340,11/19/2021,2599,518143,718,243061,155,224700,3.0,34880,16.0,36377,11.0,12770,124,190560,10.0,13611,10.0,7759,1719,68917,27,776
341,11/20/2021,1895,520038,536,243597,45,224745,2.0,34882,5.0,36382,4.0,12774,35,190595,2.0,13613,4.0,7763,1300,70217,18,794
342,11/21/2021,659,520697,120,243717,43,224788,0.0,34882,1.0,36383,2.0,12776,31,190626,3.0,13616,7.0,7770,491,70708,7,801
343,11/22/2021,2017,522714,423,244140,112,224900,7.0,34889,21.0,36404,1.0,12777,90,190716,7.0,13623,14.0,7784,1476,72184,25,826
344,11/23/2021,1885,524599,281,244421,92,224992,4.0,34893,16.0,36420,9.0,12786,68,190784,9.0,13632,6.0,7790,1506,73690,16,842
345,11/24/2021,1539,526138,213,244634,95,225087,5.0,34898,11.0,36431,10.0,12796,75,190859,5.0,13637,5.0,7795,1235,74925,11,853
346,11/25/2021,52,526190,9,244643,0,225087,0.0,34898,0.0,36431,0.0,12796,0,190859,0.0,13637,,7795,41,74966,2,855
347,11/26/2021,1275,527465,191,244834,143,225230,2.0,34900,5.0,36436,14.0,12810,111,190970,12.0,13649,6.0,7801,953,75919,6,861
348,11/27/2021,985,528450,137,244971,130,225360,2.0,34902,2.0,36438,9.0,12819,106,191076,7.0,13656,8.0,7809,716,76635,8,869
349,11/28/2021,556,529006,91,245062,87,225447,3.0,34905,1.0,36439,6.0,12825,71,191147,5.0,13661,5.0,7814,376,77011,5,874
350,11/29/2021,1908,530914,258,245320,351,225798,7.0,34912,14.0,36453,26.0,12851,289,191436,24.0,13685,12.0,7826,1294,78305,16,890
351,11/30/2021,2720,533634,342,245662,716,226514,2.0,34914,12.0,36465,46.0,12897,608,192044,49.0,13734,13.0,7839,1647,79952,32,922
352,12/1/2021,2568,536202,271,245933,661,227175,6.0,34920,12.0,36477,28.0,12925,576,192620,52.0,13786,5.0,7844,1624,81576,26,948
353,12/2/2021,2867,539069,355,246288,836,228011,6.0,34926,15.0,36492,64.0,12989,680,193300,70.0,13856,22.0,7866,1662,83238,33,981
354,12/3/2021,2638,541707,275,246563,682,228693,9.0,34935,4.0,36496,57.0,13046,536,193836,66.0,13922,23.0,7889,1684,84922,13,994
355,12/4/2021,2210,543917,160,246723,355,229048,3.0,34938,1.0,36497,18.0,13064,278,194114,29.0,13951,30.0,7919,1692,86614,8,1002
356,12/5/2021,1397,545314,98,246821,817,229865,1.0,34939,0.0,36497,65.0,13129,652,194766,71.0,14022,29.0,7948,485,87099,4,1006
357,12/6/2021,1980,547294,238,247059,396,230261,5.0,34944,6.0,36503,50.0,13179,305,195071,30.0,14052,11.0,7959,1347,88446,12,1018
358,12/7/2021,2481,549775,304,247363,375,230636,6.0,34950,8.0,36511,42.0,13221,296,195367,23.0,14075,14.0,7973,1800,90246,19,1037
359,12/8/2021,2271,552046,265,247628,441,231077,5.0,34955,12.0,36523,32.0,13253,363,195730,35.0,14110,11.0,7984,1571,91817,11,1048
360,12/9/2021,2197,554243,301,247929,401,231478,1.0,34956,8.0,36531,26.0,13279,307,196037,35.0,14145,33.0,8017,1490,93307,15,1063
361,12/10/2021,2124,556367,232,248161,332,231810,7.0,34963,8.0,36539,33.0,13312,250,196287,28.0,14173,21.0,8038,1552,94859,16,1079
362,12/11/2021,1795,558162,132,248293,455,232265,3.0,34966,1.0,36540,61.0,13373,333,196620,37.0,14210,24.0,8062,1201,96060,7,1086
363,12/12/2021,428,558590,54,248347,63,232328,1.0,34967,3.0,36543,4.0,13377,46,196666,7.0,14217,6.0,8068,311,96371,2,1088
364,12/13/2021,1767,560357,292,248639,345,232673,3.0,34970,7.0,36550,26.0,13403,276,196942,31.0,14248,12.0,8080,1139,97510,9,1097
365,12/14/2021,2224,562581,268,248907,258,232931,5.0,34975,3.0,36553,25.0,13428,206,197148,14.0,14262,13.0,8093,1697,99207,23,1120
366,12/15/2021,1760,564341,199,249106,154,233085,2.0,34977,4.0,36557,8.0,13436,122,197270,13.0,14275,11.0,8104,1409,100616,12,1132
367,12/16/2021,1841,566182,322,249428,171,233256,3.0,34980,7.0,36564,17.0,13453,140,197410,9.0,14284,5.0,8109,1339,101955,24,1156
368,12/17/2021,2145,568327,303,249731,351,233607,3.0,34983,10.0,36574,26.0,13479,277,197687,37.0,14321,11.0,8120,1480,103435,21,1177
369,12/18/2021,1838,570165,176,249907,179,233786,3.0,34986,4.0,36578,17.0,13496,149,197836,6.0,14327,7.0,8127,1461,104896,22,1199
370,12/19/2021,447,570612,40,249947,50,233836,1.0,34987,3.0,36581,5.0,13501,39,197875,2.0,14329,4.0,8131,355,105251,2,1201
371,12/20/2021,1609,572221,203,250150,179,234015,3.0,34990,9.0,36590,27.0,13528,132,198007,10.0,14339,10.0,8141,1221,106472,13,1214
372,12/21/2021,2240,574461,311,250461,177,234192,6.0,34996,8.0,36598,27.0,13555,123,198130,15.0,14354,12.0,8153,1744,108216,19,1233
373,12/22/2021,1907,576368,216,250677,197,234389,4.0,35000,9.0,36607,26.0,13581,148,198278,17.0,14371,6.0,8159,1480,109696,19,1252
374,12/23/2021,1285,577653,216,250893,147,234536,2.0,35002,4.0,36611,21.0,13602,100,198378,14.0,14385,12.0,8171,922,110618,12,1264
375,12/24/2021,328,577981,43,250936,51,234587,2.0,35004,2.0,36613,3.0,13605,43,198421,4.0,14389,1.0,8172,235,110853,1,1265
376,12/25/2021,16,577997,4,250940,2,234589,1.0,35005,0.0,36613,,13605,2,198423,0.0,14389,,8172,10,110863,0,1265
377,12/26/2021,362,578359,59,250999,57,234646,1.0,35006,0.0,36613,8.0,13613,41,198464,5.0,14394,3.0,8175,245,111108,4,1269
378,12/27/2021,1302,579661,182,251181,163,234809,4.0,35010,5.0,36618,17.0,13630,124,198588,15.0,14409,7.0,8182,947,112055,17,1286
379,12/28/2021,1934,581595,277,251458,199,235008,6.0,35016,12.0,36630,30.0,13660,139,198727,15.0,14424,15.0,8197,1442,113497,20,1306
380,12/29/2021,1733,583328,211,251669,178,235186,3.0,35019,7.0,36637,27.0,13687,128,198855,14.0,14438,9.0,8206,1339,114836,18,1324
381,12/30/2021,1404,584732,222,251891,168,235354,3.0,35022,8.0,36645,22.0,13709,125,198980,12.0,14450,9.0,8215,1008,115844,13,1337
382,12/31/2021,519,585251,94,251985,53,235407,0.0,35022,2.0,36647,7.0,13716,39,199019,3.0,14453,4.0,8219,364,116208,9,1346
383,1/1/2022,93,585344,11,251996,12,235419,0.0,35022,0.0,36647,0.0,13716,10,199029,1.0,14454,1.0,8220,66,116274,2,1348
384,1/2/2022,321,585665,46,252042,38,235457,0.0,35022,1.0,36648,7.0,13723,24,199053,7.0,14461,0.0,8220,237,116511,1,1349
385,1/3/2022,1630,587295,329,252371,292,235749,3.0,35025,5.0,36653,30.0,13753,234,199287,20.0,14481,8.0,8228,999,117510,18,1367
386,1/4/2022,1702,588997,262,252633,194,235943,7.0,35032,6.0,36659,27.0,13780,144,199431,14.0,14495,9.0,8237,1240,118750,17,1384
387,1/5/2022,1347,590344,202,252835,114,236057,2.0,35034,8.0,36667,8.0,13788,90,199521,6.0,14501,10.0,8247,1028,119778,14,1398
388,1/6/2022,1262,591606,257,253092,176,236233,2.0,35036,5.0,36672,24.0,13812,124,199645,7.0,14508,21.0,8268,826,120604,11,1409
389,1/7/2022,2074,593680,251,253343,241,236474,5.0,35041,8.0,36680,29.0,13841,180,199825,22.0,14530,10.0,8278,1577,122181,16,1425
390,1/8/2022,1601,595281,122,253465,91,236565,1.0,35042,3.0,36683,8.0,13849,70,199895,6.0,14536,7.0,8285,1370,123551,18,1443
391,1/9/2022,504,595785,91,253556,57,236622,0.0,35042,2.0,36685,14.0,13863,34,199929,3.0,14539,6.0,8291,351,123902,5,1448
392,1/10/2022,1575,597360,289,253845,131,236753,2.0,35044,6.0,36691,13.0,13876,98,200027,12.0,14551,8.0,8299,1150,125052,15,1463
393,1/11/2022,1601,598961,229,254074,195,236948,2.0,35046,4.0,36695,25.0,13901,146,200173,8.0,14559,16.0,8315,1172,126224,19,1482
394,1/12/2022,1405,600366,173,254247,107,237055,1.0,35047,5.0,36700,21.0,13922,66,200239,14.0,14573,6.0,8321,1117,127341,16,1498
395,1/13/2022,1123,601489,198,254445,125,237180,3.0,35050,3.0,36703,10.0,13932,87,200326,15.0,14588,13.0,8334,798,128139,8,1506
396,1/14/2022,1647,603136,270,254715,136,237316,1.0,35051,8.0,36711,20.0,13952,92,200418,17.0,14605,7.0,8341,1232,129371,21,1527
397,1/15/2022,1228,604364,137,254852,68,237384,0.0,35051,2.0,36713,6.0,13958,54,200472,7.0,14612,1.0,8342,1009,130380,14,1541
398,1/16/2022,294,604658,47,254899,26,237410,1.0,35052,0.0,36713,1.0,13959,21,200493,4.0,14616,0.0,8342,218,130598,2,1543
399,1/17/2022,803,605461,159,255058,92,237502,2.0,35054,5.0,36718,11.0,13970,70,200563,8.0,14624,3.0,8345,541,131139,13,1556
400,1/18/2022,893,606354,156,255214,116,237618,2.0,35056,5.0,36723,22.0,13992,84,200647,4.0,14628,6.0,8351,613,131752,16,1572
401,1/19/2022,776,607130,126,255340,91,237709,4.0,35060,7.0,36730,9.0,14001,65,200712,6.0,14634,11.0,8362,557,132309,12,1584
402,1/20/2022,839,607969,148,255488,125,237834,0.0,35060,10.0,36740,17.0,14018,88,200800,9.0,14643,11.0,8373,565,132874,7,1591
403,1/21/2022,1227,609196,173,255661,108,237942,2.0,35062,2.0,36742,11.0,14029,79,200879,7.0,14650,11.0,8384,942,133816,9,1600
404,1/22/2022,834,610030,90,255751,75,238017,1.0,35063,1.0,36743,12.0,14041,51,200930,4.0,14654,8.0,8392,645,134461,21,1621
405,1/23/2022,234,610264,28,255779,38,238055,1.0,35064,0.0,36743,4.0,14045,27,200957,7.0,14661,0.0,8392,168,134629,1,1622
406,1/24/2022,540,610804,85,255864,96,238151,1.0,35065,1.0,36744,14.0,14059,68,201025,8.0,14669,6.0,8398,354,134983,8,1630
407,1/25/2022,678,611482,116,255980,120,238271,3.0,35068,2.0,36746,11.0,14070,82,201107,20.0,14689,7.0,8405,425,135408,18,1648
408,1/26/2022,656,612138,104,256084,107,238378,5.0,35073,3.0,36749,11.0,14081,78,201185,11.0,14700,7.0,8412,441,135849,9,1657
409,1/27/2022,635,612773,115,256199,147,238525,3.0,35076,1.0,36750,26.0,14107,107,201292,7.0,14707,7.0,8419,362,136211,15,1672
410,1/28/2022,978,613751,162,256361,127,238652,4.0,35080,6.0,36756,18.0,14125,79,201371,13.0,14720,17.0,8436,670,136881,24,1696
411,1/29/2022,566,614317,65,256426,72,238724,1.0,35081,3.0,36759,9.0,14134,52,201423,8.0,14728,3.0,8439,419,137300,9,1705
412,1/30/2022,199,614516,34,256460,42,238766,1.0,35082,1.0,36760,15.0,14149,23,201446,1.0,14729,3.0,8442,123,137423,2,1707
413,1/31/2022,566,615082,134,256594,95,238861,3.0,35085,1.0,36761,15.0,14164,62,201508,9.0,14738,9.0,8451,326,137749,14,1721
414,2/1/2022,583,615665,99,256693,118,238979,1.0,35086,3.0,36764,22.0,14186,83,201591,10.0,14748,3.0,8454,340,138089,26,1747
415,2/2/2022,132,615797,20,256713,35,239014,0.0,35086,1.0,36765,2.0,14188,30,201621,2.0,14750,1.0,8455,78,138167,2,1749
416,2/3/2022,383,616180,76,256789,111,239125,1.0,35087,3.0,36768,24.0,14212,75,201696,6.0,14756,6.0,8461,193,138360,7,1756
417,2/4/2022,649,616829,114,256903,133,239258,7.0,35094,5.0,36773,18.0,14230,106,201802,4.0,14760,5.0,8466,360,138720,44,1800
418,2/5/2022,459,617288,59,256962,99,239357,2.0,35096,0.0,36773,7.0,14237,78,201880,5.0,14765,9.0,8475,281,139001,21,1821
419,2/6/2022,124,617412,20,256982,22,239379,0.0,35096,1.0,36774,1.0,14238,12,201892,6.0,14771,3.0,8478,78,139079,4,1825
420,2/7/2022,362,617774,61,257043,91,239470,1.0,35097,0.0,36774,10.0,14248,70,201962,4.0,14775,7.0,8485,204,139283,8,1833
421,2/8/2022,452,618226,85,257128,105,239575,2.0,35099,4.0,36778,20.0,14268,73,202035,5.0,14780,7.0,8492,231,139514,39,1872
422,2/9/2022,356,618582,60,257188,78,239653,3.0,35102,1.0,36779,16.0,14284,48,202083,3.0,14783,11.0,8503,205,139719,15,1887
423,2/10/2022,381,618963,86,257274,77,239730,2.0,35104,3.0,36782,15.0,14299,50,202133,6.0,14789,6.0,8509,207,139926,10,1897
424,2/11/2022,550,619513,83,257357,147,239877,3.0,35107,1.0,36783,27.0,14326,97,202230,9.0,14798,14.0,8523,292,140218,33,1930
425,2/12/2022,254,619767,41,257398,45,239922,0.0,35107,0.0,36783,5.0,14331,33,202263,5.0,14803,2.0,8525,153,140371,17,1947
426,2/13/2022,80,619847,18,257416,19,239941,0.0,35107,0.0,36783,0.0,14331,13,202276,4.0,14807,2.0,8527,40,140411,5,1952
427,2/14/2022,241,620088,38,257454,46,239987,2.0,35109,2.0,36785,10.0,14341,30,202306,2.0,14809,4.0,8531,149,140560,9,1961
428,2/15/2022,318,620406,50,257504,85,240072,0.0,35109,0.0,36785,15.0,14356,56,202362,6.0,14815,8.0,8539,153,140713,33,1994
429,2/16/2022,229,620635,40,257544,61,240133,3.0,35112,1.0,36786,12.0,14368,41,202403,5.0,14820,3.0,8542,107,140820,24,2018
430,2/17/2022,171,620806,30,257574,40,240173,0.0,35112,0.0,36786,7.0,14375,28,202431,4.0,14824,1.0,8543,91,140911,11,2029
431,2/18/2022,497,621303,105,257679,97,240270,1.0,35113,3.0,36789,14.0,14389,58,202489,14.0,14838,11.0,8554,265,141176,29,2058
432,2/19/2022,217,621520,25,257704,54,240324,0.0,35113,0.0,36789,9.0,14398,37,202526,2.0,14840,6.0,8560,121,141297,18,2076
433,2/20/2022,77,621597,17,257721,17,240341,0.0,35113,0.0,36789,0.0,14398,15,202541,0.0,14840,2.0,8562,38,141335,5,2081
434,2/21/2022,251,621848,55,257776,72,240413,2.0,35115,1.0,36790,16.0,14414,45,202586,4.0,14844,7.0,8569,118,141453,9,2090
435,2/22/2022,272,622120,49,257825,77,240490,5.0,35120,0.0,36790,6.0,14420,58,202644,5.0,14849,8.0,8577,123,141576,27,2117
436,2/23/2022,216,622336,43,257868,43,240533,1.0,35121,0.0,36790,4.0,14424,30,202674,5.0,14854,4.0,8581,118,141694,12,2129
437,2/24/2022,204,622540,32,257900,43,240576,0.0,35121,1.0,36791,9.0,14433,27,202701,1.0,14855,6.0,8587,118,141812,13,2142
438,2/25/2022,316,622856,54,257954,95,240671,2.0,35123,1.0,36792,13.0,14446,62,202763,12.0,14867,8.0,8595,145,141957,24,2166
439,2/26/2022,183,623039,23,257977,41,240712,1.0,35124,1.0,36793,2.0,14448,29,202792,6.0,14873,4.0,8599,108,142065,11,2177
440,2/27/2022,74,623113,16,257993,13,240725,0.0,35124,1.0,36794,0.0,14448,11,202803,1.0,14874,1.0,8600,43,142108,2,2179
441,2/28/2022,182,623295,48,258041,37,240762,0.0,35124,0.0,36794,8.0,14456,18,202821,5.0,14879,6.0,8606,84,142192,14,2193
442,3/1/2022,221,623516,34,258075,48,240810,4.0,35128,3.0,36797,3.0,14459,43,202864,2.0,14881,0.0,8606,108,142300,35,2228
443,3/2/2022,152,623668,27,258102,36,240846,2.0,35130,0.0,36797,4.0,14463,21,202885,6.0,14887,5.0,8611,79,142379,12,2240
444,3/3/2022,175,623843,35,258137,42,240888,3.0,35133,2.0,36799,10.0,14473,27,202912,3.0,14890,2.0,8613,91,142470,8,2248
445,3/4/2022,341,624184,51,258188,73,240961,5.0,35138,5.0,36804,13.0,14486,51,202963,4.0,14894,5.0,8618,181,142651,41,2289
446,3/5/2022,126,624310,22,258210,19,240980,0.0,35138,0.0,36804,5.0,14491,13,202976,1.0,14895,0.0,8618,73,142724,12,2301
447,3/6/2022,75,624385,28,258238,20,241000,0.0,35138,0.0,36804,2.0,14493,15,202991,1.0,14896,2.0,8620,25,142749,2,2303
448,3/7/2022,154,624539,26,258264,31,241031,1.0,35139,0.0,36804,9.0,14502,17,203008,2.0,14898,3.0,8623,88,142837,9,2312
449,3/8/2022,212,624751,32,258296,36,241067,0.0,35139,2.0,36806,5.0,14507,23,203031,3.0,14901,5.0,8628,106,142943,37,2349
450,3/9/2022,102,624853,13,258309,21,241088,3.0,35142,3.0,36809,3.0,14510,17,203048,0.0,14901,1.0,8629,63,143006,6,2355
451,3/10/2022,104,624957,27,258336,26,241114,1.0,35143,0.0,36809,2.0,14512,20,203068,2.0,14903,2.0,8631,48,143054,4,2359
452,3/11/2022,242,625199,39,258375,77,241191,5.0,35148,1.0,36810,15.0,14527,48,203116,9.0,14912,5.0,8636,92,143146,36,2395
453,3/12/2022,134,625333,26,258401,31,241222,1.0,35149,1.0,36811,3.0,14530,25,203141,1.0,14913,2.0,8638,63,143209,14,2409
454,3/13/2022,46,625379,6,258407,8,241230,0.0,35149,0.0,36811,0.0,14530,6,203147,2.0,14915,0.0,8638,30,143239,3,2412
455,3/14/2022,124,625503,14,258421,39,241269,0.0,35149,0.0,36811,7.0,14537,23,203170,8.0,14923,1.0,8639,63,143302,8,2420
456,3/15/2022,165,625668,29,258450,21,241290,0.0,35149,2.0,36813,4.0,14541,11,203181,4.0,14927,2.0,8641,77,143379,40,2460
457,3/16/2022,136,625804,32,258482,28,241318,0.0,35149,1.0,36814,2.0,14543,20,203201,3.0,14930,3.0,8644,68,143447,11,2471
458,3/17/2022,102,625906,20,258502,12,241330,1.0,35150,0.0,36814,1.0,14544,7,203208,2.0,14932,2.0,8646,60,143507,9,2480
459,3/18/2022,265,626171,21,258523,38,241368,1.0,35151,1.0,36815,2.0,14546,28,203236,6.0,14938,2.0,8648,119,143626,87,2567
460,3/19/2022,113,626284,7,258530,16,241384,0.0,35151,0.0,36815,3.0,14549,9,203245,2.0,14940,2.0,8650,58,143684,32,2599
461,3/20/2022,46,626330,5,258535,8,241392,0.0,35151,0.0,36815,,14549,8,203253,0.0,14940,0.0,8650,24,143708,9,2608
462,3/21/2022,114,626444,14,258549,32,241424,0.0,35151,1.0,36816,5.0,14554,16,203269,6.0,14946,5.0,8655,62,143770,7,2615
463,3/22/2022,166,626610,18,258567,20,241444,1.0,35152,2.0,36818,1.0,14555,17,203286,1.0,14947,1.0,8656,65,143835,64,2679
464,3/23/2022,116,626726,14,258581,23,241467,0.0,35152,0.0,36818,4.0,14559,13,203299,4.0,14951,2.0,8658,63,143898,17,2696
465,3/24/2022,120,626846,22,258603,24,241491,0.0,35152,2.0,36820,4.0,14563,17,203316,2.0,14953,1.0,8659,69,143967,7,2703
466,3/25/2022,214,627060,27,258630,32,241523,0.0,35152,1.0,36821,6.0,14569,21,203337,2.0,14955,3.0,8662,106,144073,49,2752
467,3/26/2022,101,627161,7,258637,13,241536,0.0,35152,0.0,36821,0.0,14569,12,203349,1.0,14956,0.0,8662,42,144115,37,2789
468,3/27/2022,31,627192,9,258646,4,241540,0.0,35152,0.0,36821,0.0,14569,3,203352,0.0,14956,1.0,8663,15,144130,3,2792
469,3/28/2022,98,627290,22,258668,16,241556,0.0,35152,1.0,36822,1.0,14570,12,203364,3.0,14959,0.0,8663,50,144180,10,2802
470,3/29/2022,244,627534,21,258689,20,241576,2.0,35154,1.0,36823,1.0,14571,14,203378,0.0,14959,5.0,8668,66,144246,138,2940
471,3/30/2022,382,627916,29,258718,24,241600,4.0,35158,4.0,36827,3.0,14574,18,203396,2.0,14961,1.0,8669,65,144311,263,3203
472,3/31/2022,599,628515,32,258750,41,241641,4.0,35162,1.0,36828,4.0,14578,32,203428,2.0,14963,3.0,8672,90,144401,437,3640
473,4/1/2022,867,629382,34,258784,39,241680,5.0,35167,3.0,36831,5.0,14583,29,203457,2.0,14965,3.0,8675,91,144492,698,4338
474,4/2/2022,653,630035,15,258799,25,241705,4.0,35171,1.0,36832,1.0,14584,21,203478,0.0,14965,3.0,8678,61,144553,552,4890
475,4/3/2022,147,630182,6,258805,7,241712,1.0,35172,1.0,36833,0.0,14584,5,203483,2.0,14967,0.0,8678,19,144572,115,5005
476,4/4/2022,496,630678,18,258823,25,241737,6.0,35178,2.0,36835,2.0,14586,21,203504,1.0,14968,1.0,8679,66,144638,387,5392
477,4/5/2022,869,631547,36,258859,29,241766,1.0,35179,5.0,36840,4.0,14590,22,203526,1.0,14969,2.0,8681,59,144697,745,6137
478,4/6/2022,517,632064,25,258884,31,241797,6.0,35185,5.0,36845,0.0,14590,28,203554,1.0,14970,2.0,8683,47,144744,417,6554
479,4/7/2022,647,632711,30,258914,22,241819,3.0,35188,6.0,36851,2.0,14592,13,203567,3.0,14973,4.0,8687,61,144805,536,7090
480,4/8/2022,1134,633845,48,258962,42,241861,6.0,35194,8.0,36859,5.0,14597,31,203598,3.0,14976,3.0,8690,96,144901,943,8033
481,4/9/2022,680,634525,35,258997,16,241877,4.0,35198,4.0,36863,3.0,14600,10,203608,2.0,14978,1.0,8691,41,144942,586,8619
482,4/10/2022,192,634717,14,259011,7,241884,2.0,35200,1.0,36864,0.0,14600,7,203615,0.0,14978,0.0,8691,35,144977,135,8754
483,4/11/2022,633,635350,20,259031,28,241912,2.0,35202,3.0,36867,3.0,14603,19,203634,3.0,14981,3.0,8694,55,145032,528,9282
484,4/12/2022,862,636212,29,259060,29,241941,9.0,35211,5.0,36872,4.0,14607,22,203656,3.0,14984,0.0,8694,61,145093,741,10023
485,4/13/2022,668,636880,31,259091,24,241965,5.0,35216,6.0,36878,0.0,14607,22,203678,1.0,14985,1.0,8695,63,145156,549,10572
486,4/14/2022,613,637493,27,259118,23,241988,4.0,35220,0.0,36878,4.0,14611,13,203691,2.0,14987,4.0,8699,94,145250,473,11045
487,4/15/2022,934,638427,41,259159,45,242033,5.0,35225,4.0,36882,10.0,14621,31,203722,3.0,14990,1.0,8700,91,145341,755,11800
488,4/16/2022,499,638926,18,259177,17,242050,2.0,35227,0.0,36882,2.0,14623,13,203735,2.0,14992,0.0,8700,37,145378,427,12227
489,4/17/2022,70,638996,8,259185,5,242055,2.0,35229,1.0,36883,0.0,14623,4,203739,0.0,14992,1.0,8701,12,145390,45,12272
490,4/18/2022,562,639558,39,259224,25,242080,9.0,35238,5.0,36888,3.0,14626,20,203759,1.0,14993,1.0,8702,61,145451,438,12710
491,4/19/2022,804,640362,42,259266,32,242112,10.0,35248,9.0,36897,2.0,14628,25,203784,3.0,14996,2.0,8704,82,145533,651,13361
492,4/20/2022,484,640846,21,259287,25,242137,3.0,35251,3.0,36900,6.0,14634,17,203801,2.0,14998,0.0,8704,52,145585,387,13748
493,4/21/2022,472,641318,21,259308,32,242169,8.0,35259,2.0,36902,2.0,14636,25,203826,3.0,15001,2.0,8706,45,145630,377,14125
494,4/22/2022,704,642022,26,259334,37,242206,2.0,35261,4.0,36906,4.0,14640,30,203856,3.0,15004,0.0,8706,66,145696,574,14699
495,4/23/2022,622,642644,20,259354,25,242231,9.0,35270,2.0,36908,1.0,14641,20,203876,2.0,15006,2.0,8708,61,145757,517,15216
496,4/24/2022,109,642753,8,259362,6,242237,0.0,35270,2.0,36910,0.0,14641,5,203881,0.0,15006,1.0,8709,21,145778,74,15290
497,4/25/2022,395,643148,28,259390,17,242254,4.0,35274,4.0,36914,4.0,14645,11,203892,0.0,15006,2.0,8711,47,145825,303,15593
498,4/26/2022,558,643706,26,259416,24,242278,3.0,35277,3.0,36917,2.0,14647,17,203909,2.0,15008,3.0,8714,74,145899,433,16026
499,4/27/2022,473,644179,22,259438,23,242301,8.0,35285,4.0,36921,2.0,14649,15,203924,2.0,15010,4.0,8718,64,145963,364,16390
500,4/28/2022,473,644652,32,259470,28,242329,7.0,35292,4.0,36925,3.0,14652,20,203944,2.0,15012,3.0,8721,44,146007,370,16760
501,4/29/2022,761,645413,29,259499,35,242364,4.0,35296,2.0,36927,6.0,14658,24,203968,2.0,15014,3.0,8724,69,146076,625,17385
502,4/30/2022,392,645805,6,259505,19,242383,1.0,35297,0.0,36927,1.0,14659,18,203986,0.0,15014,0.0,8724,44,146120,323,17708
503,5/1/2022,107,645912,12,259517,12,242395,0.0,35297,2.0,36929,1.0,14660,9,203995,0.0,15014,2.0,8726,18,146138,65,17773
504,5/2/2022,382,646294,18,259535,18,242413,0.0,35297,4.0,36933,2.0,14662,12,204007,2.0,15016,2.0,8728,58,146196,290,18063
505,5/3/2022,656,646950,30,259565,30,242443,5.0,35302,6.0,36939,3.0,14665,25,204032,2.0,15018,0.0,8728,76,146272,523,18586
506,5/4/2022,520,647470,25,259590,27,242470,4.0,35306,5.0,36944,4.0,14669,19,204051,2.0,15020,2.0,8730,64,146336,398,18984
507,5/5/2022,405,647875,17,259607,20,242490,3.0,35309,3.0,36947,2.0,14671,15,204066,3.0,15023,0.0,8730,50,146386,318,19302
508,5/6/2022,620,648495,33,259640,35,242525,3.0,35312,2.0,36949,5.0,14676,27,204093,2.0,15025,1.0,8731,65,146451,483,19785
509,5/7/2022,373,648868,17,259657,22,242547,1.0,35313,1.0,36950,2.0,14678,17,204110,1.0,15026,2.0,8733,42,146493,291,20076
510,5/8/2022,73,648941,4,259661,7,242554,0.0,35313,0.0,36950,0.0,14678,4,204114,1.0,15027,2.0,8735,14,146507,48,20124
511,5/9/2022,405,649346,26,259687,16,242570,3.0,35316,1.0,36951,1.0,14679,11,204125,2.0,15029,2.0,8737,55,146562,307,20431
512,5/10/2022,604,649950,29,259716,35,242605,13.0,35329,4.0,36955,3.0,14682,25,204150,3.0,15032,4.0,8741,80,146642,457,20888
513,5/11/2022,399,650349,29,259745,26,242631,8.0,35337,4.0,36959,6.0,14688,13,204163,3.0,15035,4.0,8745,32,146674,312,21200
514,5/12/2022,348,650697,18,259763,20,242651,3.0,35340,2.0,36961,0.0,14688,18,204181,2.0,15037,0.0,8745,50,146724,259,21459
515,5/13/2022,664,651361,24,259787,38,242689,6.0,35346,3.0,36964,4.0,14692,26,204207,2.0,15039,6.0,8751,89,146813,510,21969
516,5/14/2022,385,651746,16,259803,12,242701,1.0,35347,3.0,36967,1.0,14693,10,204217,1.0,15040,0.0,8751,34,146847,322,22291
517,5/15/2022,126,651872,6,259809,4,242705,0.0,35347,0.0,36967,0.0,14693,4,204221,0.0,15040,0.0,8751,17,146864,98,22389
518,5/16/2022,452,652324,25,259834,24,242729,0.0,35347,1.0,36968,5.0,14698,16,204237,1.0,15041,2.0,8753,74,146938,326,22715
519,5/17/2022,529,652853,26,259860,24,242753,7.0,35354,4.0,36972,0.0,14698,20,204257,0.0,15041,4.0,8757,65,147003,413,23128
520,5/18/2022,327,653180,11,259871,18,242771,5.0,35359,0.0,36972,5.0,14703,12,204269,0.0,15041,1.0,8758,41,147044,254,23382
521,5/19/2022,477,653657,26,259897,25,242796,3.0,35362,4.0,36976,5.0,14708,18,204287,0.0,15041,2.0,8760,55,147099,367,23749
522,5/20/2022,728,654385,22,259919,33,242829,5.0,35367,4.0,36980,3.0,14711,27,204314,2.0,15043,1.0,8761,110,147209,562,24311
523,5/21/2022,485,654870,20,259939,13,242842,3.0,35370,4.0,36984,0.0,14711,12,204326,1.0,15044,0.0,8761,69,147278,383,24694
524,5/22/2022,174,655044,6,259945,5,242847,1.0,35371,0.0,36984,0.0,14711,3,204329,2.0,15046,0.0,8761,37,147315,124,24818
525,5/23/2022,534,655578,24,259969,18,242865,1.0,35372,3.0,36987,1.0,14712,15,204344,0.0,15046,2.0,8763,113,147428,379,25197
526,5/24/2022,601,656179,48,260017,24,242889,4.0,35376,6.0,36993,2.0,14714,15,204359,0.0,15046,7.0,8770,83,147511,449,25646
527,5/25/2022,430,656609,23,260040,20,242909,3.0,35379,6.0,36999,0.0,14714,13,204372,6.0,15052,1.0,8771,72,147583,312,25958
528,5/26/2022,435,657044,21,260061,22,242931,4.0,35383,6.0,37005,2.0,14716,16,204388,1.0,15053,3.0,8774,102,147685,291,26249
529,5/27/2022,889,657933,24,260085,39,242970,7.0,35390,3.0,37008,5.0,14721,29,204417,3.0,15056,2.0,8776,167,147852,656,26905
530,5/28/2022,315,658248,10,260095,12,242982,1.0,35391,0.0,37008,0.0,14721,11,204428,0.0,15056,1.0,8777,29,147881,260,27165
531,5/29/2022,141,658389,4,260099,7,242989,0.0,35391,2.0,37010,1.0,14722,6,204434,0.0,15056,0.0,8777,40,147921,88,27253
532,5/30/2022,31,658420,1,260100,0,242989,0.0,35391,0.0,37010,0.0,14722,0,204434,0.0,15056,,8777,3,147924,27,27280
533,5/31/2022,820,659240,29,260129,28,243017,8.0,35399,6.0,37016,2.0,14724,22,204456,3.0,15059,1.0,8778,117,148041,644,27924
534,6/1/2022,601,659841,30,260159,22,243039,6.0,35405,3.0,37019,1.0,14725,18,204474,2.0,15061,1.0,8779,90,148131,458,28382
535,6/2/2022,683,660524,21,260180,28,243067,3.0,35408,0.0,37019,4.0,14729,20,204494,2.0,15063,2.0,8781,81,148212,551,28933
536,6/3/2022,983,661507,28,260208,25,243092,6.0,35414,5.0,37024,3.0,14732,20,204514,2.0,15065,0.0,8781,122,148334,805,29738
537,6/4/2022,696,662203,20,260228,25,243117,5.0,35419,1.0,37025,1.0,14733,24,204538,0.0,15065,0.0,8781,67,148401,580,30318
538,6/5/2022,132,662335,4,260232,5,243122,0.0,35419,0.0,37025,1.0,14734,3,204541,1.0,15066,0.0,8781,19,148420,104,30422
539,6/6/2022,576,662911,23,260255,25,243147,2.0,35421,1.0,37026,5.0,14739,19,204560,0.0,15066,1.0,8782,67,148487,457,30879
540,6/7/2022,785,663696,33,260288,38,243185,5.0,35426,3.0,37029,5.0,14744,31,204591,1.0,15067,1.0,8783,123,148610,586,31465
541,6/8/2022,394,664090,26,260314,19,243204,2.0,35428,3.0,37032,1.0,14745,15,204606,0.0,15067,3.0,8786,56,148666,291,31756
542,6/9/2022,455,664545,16,260330,15,243219,4.0,35432,1.0,37033,3.0,14748,12,204618,0.0,15067,0.0,8786,73,148739,351,32107
543,6/10/2022,741,665286,25,260355,37,243256,1.0,35433,1.0,37034,3.0,14751,30,204648,2.0,15069,2.0,8788,111,148850,567,32674
544,6/11/2022,372,665658,11,260366,15,243271,2.0,35435,2.0,37036,0.0,14751,11,204659,2.0,15071,2.0,8790,57,148907,288,32962
545,6/12/2022,130,665788,4,260370,2,243273,1.0,35436,0.0,37036,1.0,14752,1,204660,0.0,15071,0.0,8790,28,148935,95,33057
546,6/13/2022,508,666296,21,260391,35,243308,3.0,35439,1.0,37037,3.0,14755,25,204685,3.0,15074,4.0,8794,85,149020,365,33422
547,6/14/2022,577,666873,31,260422,26,243334,4.0,35443,4.0,37041,2.0,14757,20,204705,2.0,15076,2.0,8796,100,149120,418,33840
548,6/15/2022,370,667243,15,260437,25,243359,2.0,35445,3.0,37044,4.0,14761,18,204723,1.0,15077,2.0,8798,72,149192,255,34095
549,6/16/2022,380,667623,12,260449,21,243380,8.0,35453,2.0,37046,0.0,14761,18,204741,2.0,15079,1.0,8799,65,149257,277,34372
550,6/17/2022,695,668318,33,260482,16,243396,3.0,35456,6.0,37052,1.0,14762,13,204754,1.0,15080,1.0,8800,93,149350,546,34918
551,6/18/2022,334,668652,8,260490,13,243409,3.0,35459,1.0,37053,0.0,14762,10,204764,1.0,15081,2.0,8802,46,149396,266,35184
552,6/19/2022,55,668707,2,260492,2,243411,0.0,35459,0.0,37053,0.0,14762,2,204766,0.0,15081,0.0,8802,13,149409,38,35222
553,6/20/2022,405,669112,29,260521,21,243432,5.0,35464,8.0,37061,2.0,14764,17,204783,2.0,15083,0.0,8802,75,149484,280,35502
554,6/21/2022,443,669555,24,260545,19,243451,1.0,35465,5.0,37066,0.0,14764,16,204799,0.0,15083,3.0,8805,83,149567,316,35818
555,6/22/2022,321,669876,46,260591,11,243462,0.0,35465,1.0,37067,1.0,14765,8,204807,1.0,15084,1.0,8806,65,149632,196,36014
556,6/23/2022,390,670266,102,260693,20,243482,4.0,35469,3.0,37070,2.0,14767,14,204821,0.0,15084,4.0,8810,59,149691,208,36222
557,6/24/2022,502,670768,107,260800,32,243514,0.0,35469,0.0,37070,3.0,14770,23,204844,5.0,15089,1.0,8811,69,149760,290,36512
558,6/25/2022,289,671057,32,260832,12,243526,0.0,35469,1.0,37071,1.0,14771,11,204855,0.0,15089,0.0,8811,46,149806,196,36708
559,6/26/2022,79,671136,14,260846,5,243531,0.0,35469,0.0,37071,0.0,14771,1,204856,4.0,15093,0.0,8811,17,149823,43,36751
560,6/27/2022,295,671431,78,260924,14,243545,3.0,35472,4.0,37075,1.0,14772,10,204866,2.0,15095,1.0,8812,47,149870,154,36905
561,6/28/2022,456,671887,112,261036,36,243581,2.0,35474,2.0,37077,3.0,14775,29,204895,2.0,15097,2.0,8814,77,149947,233,37138
562,6/29/2022,323,672210,98,261134,16,243597,1.0,35475,2.0,37079,5.0,14780,10,204905,0.0,15097,1.0,8815,69,150016,141,37279
563,6/30/2022,401,672611,101,261235,15,243612,4.0,35479,4.0,37083,1.0,14781,13,204918,1.0,15098,0.0,8815,66,150082,215,37494
564,7/1/2022,500,673111,130,261365,13,243625,3.0,35482,4.0,37087,2.0,14783,10,204928,0.0,15098,1.0,8816,84,150166,268,37762
565,7/2/2022,82,673193,11,261376,1,243626,0.0,35482,2.0,37089,0.0,14783,1,204929,0.0,15098,0.0,8816,18,150184,52,37814
566,7/3/2022,42,673235,3,261379,5,243631,0.0,35482,0.0,37089,0.0,14783,3,204932,0.0,15098,2.0,8818,9,150193,25,37839
567,7/4/2022,9,673244,2,261381,0,243631,0.0,35482,0.0,37089,0.0,14783,0,204932,0.0,15098,0.0,8818,2,150195,5,37844
568,7/5/2022,351,673595,83,261464,24,243655,1.0,35483,1.0,37090,2.0,14785,20,204952,1.0,15099,1.0,8819,58,150253,187,38031
569,7/6/2022,329,673924,84,261548,21,243676,1.0,35484,3.0,37093,1.0,14786,16,204968,3.0,15102,1.0,8820,63,150316,164,38195
570,7/7/2022,348,674272,79,261627,14,243690,4.0,35488,8.0,37101,0.0,14786,14,204982,0.0,15102,0.0,8820,63,150379,188,38383
571,7/8/2022,515,674787,105,261732,22,243712,3.0,35491,2.0,37103,4.0,14790,15,204997,3.0,15105,0.0,8820,65,150444,317,38700
572,7/9/2022,213,675000,17,261749,12,243724,1.0,35492,1.0,37104,1.0,14791,8,205005,0.0,15105,3.0,8823,23,150467,161,38861
573,7/10/2022,48,675048,14,261763,3,243727,0.0,35492,1.0,37105,,14791,2,205007,1.0,15106,0.0,8823,6,150473,24,38885
574,7/11/2022,285,675333,58,261821,15,243742,3.0,35495,3.0,37108,1.0,14792,12,205019,2.0,15108,0.0,8823,42,150515,170,39055
575,7/12/2022,381,675714,78,261899,25,243767,3.0,35498,0.0,37108,1.0,14793,18,205037,4.0,15112,2.0,8825,71,150586,199,39254
576,7/13/2022,385,676099,54,261953,30,243797,0.0,35498,4.0,37112,1.0,14794,24,205061,3.0,15115,2.0,8827,56,150642,242,39496
577,7/14/2022,385,676484,79,262032,25,243822,3.0,35501,0.0,37112,3.0,14797,16,205077,2.0,15117,4.0,8831,71,150713,206,39702
578,7/15/2022,588,677072,81,262113,28,243850,2.0,35503,5.0,37117,0.0,14797,21,205098,3.0,15120,4.0,8835,76,150789,398,40100
579,7/16/2022,326,677398,24,262137,14,243864,2.0,35505,1.0,37118,1.0,14798,12,205110,1.0,15121,0.0,8835,35,150824,247,40347
580,7/17/2022,75,677473,15,262152,5,243869,0.0,35505,0.0,37118,0.0,14798,4,205114,0.0,15121,1.0,8836,12,150836,43,40390
581,7/18/2022,390,677863,43,262195,50,243919,4.0,35509,3.0,37121,3.0,14801,40,205154,3.0,15124,4.0,8840,84,150920,211,40601
582,7/19/2022,427,678290,63,262258,43,243962,4.0,35513,3.0,37124,3.0,14804,33,205187,4.0,15128,3.0,8843,77,150997,242,40843
583,7/20/2022,279,678569,42,262300,48,244010,5.0,35518,0.0,37124,1.0,14805,44,205231,3.0,15131,0.0,8843,57,151054,132,40975
584,7/21/2022,353,678922,62,262362,64,244074,4.0,35522,2.0,37126,5.0,14810,51,205282,4.0,15135,4.0,8847,64,151118,159,41134
585,7/22/2022,657,679579,99,262461,115,244189,2.0,35524,2.0,37128,6.0,14816,92,205374,14.0,15149,3.0,8850,97,151215,340,41474
586,7/23/2022,246,679825,10,262471,22,244211,3.0,35527,0.0,37128,0.0,14816,22,205396,0.0,15149,0.0,8850,32,151247,178,41652
587,7/24/2022,78,679903,10,262481,14,244225,0.0,35527,0.0,37128,0.0,14816,12,205408,2.0,15151,0.0,8850,9,151256,45,41697
588,7/25/2022,297,680200,36,262517,29,244254,1.0,35528,1.0,37129,1.0,14817,22,205430,4.0,15155,2.0,8852,72,151328,158,41855
589,7/26/2022,437,680637,46,262563,82,244336,1.0,35529,3.0,37132,3.0,14820,65,205495,11.0,15166,3.0,8855,75,151403,229,42084
590,7/27/2022,302,680939,31,262594,66,244402,4.0,35533,3.0,37135,4.0,14824,57,205552,4.0,15170,1.0,8856,53,151456,148,42232
591,7/28/2022,275,681214,31,262625,66,244468,2.0,35535,1.0,37136,3.0,14827,50,205602,8.0,15178,5.0,8861,42,151498,135,42367
592,7/29/2022,437,681651,58,262683,101,244569,3.0,35538,2.0,37138,9.0,14836,81,205683,7.0,15185,4.0,8865,71,151569,203,42570
593,7/30/2022,133,681784,6,262689,13,244582,1.0,35539,1.0,37139,1.0,14837,12,205695,0.0,15185,,8865,18,151587,93,42663
594,7/31/2022,48,681832,4,262693,5,244587,0.0,35539,1.0,37140,,14837,3,205698,2.0,15187,0.0,8865,13,151600,26,42689
595,8/1/2022,223,682055,39,262732,38,244625,1.0,35540,2.0,37142,2.0,14839,33,205731,3.0,15190,0.0,8865,53,151653,90,42779
596,8/2/2022,344,682399,41,262773,73,244698,1.0,35541,1.0,37143,2.0,14841,61,205792,7.0,15197,3.0,8868,68,151721,160,42939
597,8/3/2022,202,682601,37,262810,35,244733,2.0,35543,1.0,37144,2.0,14843,31,205823,2.0,15199,0.0,8868,52,151773,76,43015
598,8/4/2022,234,682835,40,262850,41,244774,2.0,35545,0.0,37144,1.0,14844,37,205860,1.0,15200,2.0,8870,59,151832,93,43108
599,8/5/2022,363,683198,45,262895,84,244858,1.0,35546,3.0,37147,2.0,14846,74,205934,6.0,15206,2.0,8872,69,151901,159,43267
600,8/6/2022,217,683415,63,262958,30,244888,1.0,35547,0.0,37147,1.0,14847,26,205960,3.0,15209,0.0,8872,46,151947,77,43344
601,8/7/2022,52,683467,15,262973,5,244893,0.0,35547,1.0,37148,1.0,14848,4,205964,0.0,15209,0.0,8872,20,151967,12,43356
602,8/8/2022,187,683654,29,263002,29,244922,2.0,35549,0.0,37148,2.0,14850,26,205990,1.0,15210,0.0,8872,68,152035,59,43415
603,8/9/2022,289,683943,46,263048,73,244995,4.0,35553,0.0,37148,2.0,14852,61,206051,7.0,15217,3.0,8875,73,152108,89,43504
604,8/10/2022,206,684149,37,263085,62,245057,0.0,35553,0.0,37148,4.0,14856,52,206103,3.0,15220,3.0,8878,37,152145,69,43573
605,8/11/2022,213,684362,29,263114,38,245095,1.0,35554,1.0,37149,2.0,14858,29,206132,4.0,15224,3.0,8881,61,152206,80,43653
606,8/12/2022,306,684668,60,263174,54,245149,1.0,35555,4.0,37153,3.0,14861,43,206175,6.0,15230,2.0,8883,70,152276,122,43775
607,8/13/2022,158,684826,19,263193,34,245183,1.0,35556,1.0,37154,2.0,14863,23,206198,6.0,15236,3.0,8886,34,152310,70,43845
608,8/14/2022,38,684864,4,263197,8,245191,0.0,35556,0.0,37154,1.0,14864,5,206203,0.0,15236,2.0,8888,11,152321,15,43860
609,8/15/2022,142,685006,22,263219,31,245222,2.0,35558,0.0,37154,3.0,14867,20,206223,7.0,15243,1.0,8889,46,152367,44,43904
610,8/16/2022,229,685235,50,263269,57,245279,0.0,35558,2.0,37156,10.0,14877,43,206266,2.0,15245,2.0,8891,36,152403,83,43987
611,8/17/2022,151,685386,31,263300,34,245313,3.0,35561,2.0,37158,4.0,14881,28,206294,2.0,15247,0.0,8891,27,152430,58,44045
612,8/18/2022,132,685518,35,263335,23,245336,0.0,35561,4.0,37162,4.0,14885,18,206312,0.0,15247,1.0,8892,25,152455,48,44093
613,8/19/2022,269,685787,65,263400,60,245396,1.0,35562,7.0,37169,2.0,14887,51,206363,2.0,15249,5.0,8897,48,152503,95,44188
614,8/20/2022,83,685870,8,263408,12,245408,2.0,35564,0.0,37169,0.0,14887,10,206373,2.0,15251,0.0,8897,15,152518,40,44228
615,8/21/2022,11,685881,2,263410,0,245408,,35564,,37169,,14887,0,206373,,15251,0.0,8897,5,152523,4,44232
616,8/22/2022,118,685999,19,263429,27,245435,0.0,35564,0.0,37169,0.0,14887,25,206398,2.0,15253,0.0,8897,31,152554,42,44274
617,8/23/2022,162,686161,31,263460,41,245476,1.0,35565,1.0,37170,2.0,14889,37,206435,1.0,15254,1.0,8898,28,152582,58,44332
618,8/24/2022,143,686304,31,263491,39,245515,1.0,35566,0.0,37170,3.0,14892,33,206468,2.0,15256,1.0,8899,26,152608,44,44376
619,8/25/2022,105,686409,35,263526,32,245547,0.0,35566,2.0,37172,2.0,14894,20,206488,4.0,15260,6.0,8905,12,152620,28,44404
620,8/26/2022,217,686626,44,263570,51,245598,0.0,35566,1.0,37173,1.0,14895,41,206529,8.0,15268,1.0,8906,42,152662,76,44480
621,8/27/2022,55,686681,8,263578,7,245605,0.0,35566,0.0,37173,1.0,14896,5,206534,1.0,15269,0.0,8906,17,152679,23,44503
622,8/28/2022,19,686700,2,263580,3,245608,0.0,35566,0.0,37173,,14896,2,206536,1.0,15270,0.0,8906,5,152684,8,44511
623,8/29/2022,128,686828,20,263600,31,245639,0.0,35566,0.0,37173,3.0,14899,23,206559,4.0,15274,1.0,8907,32,152716,46,44557
624,8/30/2022,141,686969,26,263626,29,245668,0.0,35566,0.0,37173,0.0,14899,26,206585,2.0,15276,1.0,8908,33,152749,48,44605
625,8/31/2022,54,687023,13,263639,22,245690,0.0,35566,0.0,37173,1.0,14900,20,206605,0.0,15276,1.0,8909,12,152761,7,44612
