,Date,daily number of doses received by Larimer County residents,total number of doses recevied by residents,daily number of residents receiving first dose,total number of residents receiving first dose,daily number of residents vaccinated,total number of residents vaccinated,daily number of 70+ vaccinated,total number of 70+ vaccinated,daily number of 70+ at least one dose,total number of 70+ at least one dose,daily number of Latinx residents vaccinated,total of Latinx residents vaccinated,daily number of White non-Latinx residents vaccinated,total of White non-Latinx residents vaccinated,daily number of non-White non-Latinx residents vaccinated,total of non-White non-Latinx residents vaccinated,dailyUnknown,totalUnknown,daily_additional_doses,total_additional_doses,daily_second_booster ,total_second_boosters
0,12/14/2020,31,31,31,31,0,0,0.0,0,1.0,1,0.0,0,0,0,0.0,0,,0,0,0,0,0
1,12/15/2020,15,46,15,46,0,0,,0,,1,,0,0,0,0.0,0,,0,0,0,0,0
2,12/16/2020,310,356,310,356,0,0,0.0,0,1.0,2,0.0,0,0,0,0.0,0,0.0,0,0,0,0,0
3,12/17/2020,995,1351,995,1351,0,0,0.0,0,11.0,13,0.0,0,0,0,0.0,0,0.0,0,0,0,0,0
4,12/18/2020,1053,2404,1053,2404,0,0,0.0,0,15.0,28,0.0,0,0,0,0.0,0,0.0,0,0,0,0,0
5,12/19/2020,723,3127,723,3127,0,0,0.0,0,13.0,41,0.0,0,0,0,0.0,0,0.0,0,0,0,0,0
6,12/20/2020,270,3397,270,3397,0,0,0.0,0,4.0,45,0.0,0,0,0,0.0,0,0.0,0,0,0,0,0
7,12/21/2020,358,3755,358,3755,0,0,0.0,0,3.0,48,0.0,0,0,0,0.0,0,0.0,0,0,0,0,0
8,12/22/2020,356,4111,356,4111,0,0,0.0,0,7.0,55,0.0,0,0,0,0.0,0,0.0,0,0,0,0,0
9,12/23/2020,451,4562,451,4562,0,0,0.0,0,7.0,62,0.0,0,0,0,0.0,0,0.0,0,0,0,0,0
10,12/24/2020,108,4670,108,4670,0,0,0.0,0,3.0,65,0.0,0,0,0,0.0,0,0.0,0,0,0,0,0
11,12/25/2020,1,4671,1,4671,0,0,,0,,65,,0,0,0,,0,,0,0,0,0,0
12,12/26/2020,229,4900,229,4900,0,0,0.0,0,3.0,68,0.0,0,0,0,0.0,0,0.0,0,0,0,0,0
13,12/27/2020,275,5175,275,5175,0,0,0.0,0,195.0,263,0.0,0,0,0,0.0,0,,0,0,0,0,0
14,12/28/2020,721,5896,721,5896,0,0,0.0,0,387.0,650,0.0,0,0,0,0.0,0,0.0,0,0,0,0,0
15,12/29/2020,901,6797,900,6796,1,1,0.0,0,452.0,1102,0.0,0,1,1,0.0,0,0.0,0,0,0,0,0
16,12/30/2020,877,7674,876,7672,1,2,0.0,0,257.0,1359,0.0,0,1,2,0.0,0,0.0,0,0,0,0,0
17,12/31/2020,906,8580,905,8577,2,4,1.0,1,340.0,1699,0.0,0,2,4,0.0,0,0.0,0,0,0,0,0
18,1/1/2021,8,8588,7,8584,2,6,,1,,1699,,0,2,6,,0,0.0,0,0,0,0,0
19,1/2/2021,384,8972,384,8968,0,6,0.0,1,136.0,1835,0.0,0,0,6,0.0,0,0.0,0,0,0,0,0
20,1/3/2021,129,9101,128,9096,2,8,0.0,1,58.0,1893,0.0,0,2,8,0.0,0,0.0,0,0,0,0,0
21,1/4/2021,597,9698,581,9677,16,24,0.0,1,314.0,2207,0.0,0,13,21,2.0,2,1.0,1,0,0,0,0
22,1/5/2021,651,10349,640,10317,11,35,0.0,1,406.0,2613,0.0,0,11,32,0.0,2,0.0,1,0,0,0,0
23,1/6/2021,1259,11608,938,11255,320,355,3.0,4,532.0,3145,18.0,18,279,311,18.0,20,5.0,6,1,1,0,0
24,1/7/2021,1676,13284,712,11967,963,1318,12.0,16,407.0,3552,34.0,52,870,1181,45.0,65,14.0,20,1,2,0,0
25,1/8/2021,1996,15280,992,12959,1003,2321,12.0,28,487.0,4039,47.0,99,892,2073,42.0,107,22.0,42,1,3,0,0
26,1/9/2021,1231,16511,536,13495,695,3016,16.0,44,309.0,4348,17.0,116,629,2702,35.0,142,14.0,56,0,3,0,0
27,1/10/2021,716,17227,437,13932,279,3295,4.0,48,271.0,4619,10.0,126,253,2955,13.0,155,3.0,59,0,3,0,0
28,1/11/2021,1148,18375,798,14730,350,3645,1.0,49,533.0,5152,10.0,136,318,3273,18.0,173,4.0,63,0,3,0,0
29,1/12/2021,1183,19558,885,15615,298,3943,8.0,57,515.0,5667,15.0,151,256,3529,19.0,192,8.0,71,0,3,0,0
30,1/13/2021,1078,20636,831,16446,247,4190,1.0,58,367.0,6034,23.0,174,199,3728,16.0,208,9.0,80,0,3,0,0
31,1/14/2021,877,21513,841,17287,36,4226,1.0,59,495.0,6529,2.0,176,31,3759,1.0,209,2.0,82,0,3,0,0
32,1/15/2021,1224,22737,1208,18495,16,4242,0.0,59,758.0,7287,0.0,176,16,3775,0.0,209,0.0,82,0,3,0,0
33,1/16/2021,985,23722,971,19466,14,4256,1.0,60,582.0,7869,0.0,176,13,3788,1.0,210,0.0,82,0,3,0,0
34,1/17/2021,64,23786,58,19524,6,4262,0.0,60,22.0,7891,0.0,176,4,3792,2.0,212,0.0,82,0,3,0,0
35,1/18/2021,1021,24807,814,20338,204,4466,49.0,109,598.0,8489,8.0,184,177,3969,12.0,224,7.0,89,3,6,0,0
36,1/19/2021,1254,26061,1112,21450,139,4605,7.0,116,728.0,9217,7.0,191,119,4088,6.0,230,7.0,96,2,8,1,1
37,1/20/2021,1438,27499,1216,22666,220,4825,13.0,129,573.0,9790,14.0,205,179,4267,9.0,239,18.0,114,1,9,1,2
38,1/21/2021,2262,29761,2039,24705,223,5048,11.0,140,1580.0,11370,14.0,219,185,4452,16.0,255,8.0,122,1,10,0,2
39,1/22/2021,1752,31513,1469,26174,283,5331,93.0,233,1094.0,12464,34.0,253,228,4680,14.0,269,7.0,129,0,10,0,2
40,1/23/2021,908,32421,577,26751,331,5662,55.0,288,428.0,12892,8.0,261,304,4984,13.0,282,6.0,135,0,10,0,2
41,1/24/2021,389,32810,104,26855,285,5947,207.0,495,61.0,12953,8.0,269,269,5253,8.0,290,,135,0,10,0,2
42,1/25/2021,1415,34225,792,27647,619,6566,369.0,864,552.0,13505,13.0,282,581,5834,16.0,306,9.0,144,4,14,0,2
43,1/26/2021,1624,35849,700,28347,922,7488,456.0,1320,439.0,13944,30.0,312,840,6674,39.0,345,13.0,157,1,15,1,3
44,1/27/2021,1842,37691,775,29122,1066,8554,531.0,1851,337.0,14281,40.0,352,971,7645,47.0,392,8.0,165,1,16,0,3
45,1/28/2021,1365,39056,555,29677,809,9363,352.0,2203,303.0,14584,25.0,377,742,8387,29.0,421,13.0,178,1,17,0,3
46,1/29/2021,1646,40702,1161,30838,484,9847,167.0,2370,826.0,15410,23.0,400,419,8806,32.0,453,10.0,188,1,18,0,3
47,1/30/2021,1222,41924,737,31575,483,10330,208.0,2578,599.0,16009,24.0,424,435,9241,19.0,472,5.0,193,2,20,0,3
48,1/31/2021,654,42578,424,31999,226,10556,77.0,2655,365.0,16374,5.0,429,200,9441,15.0,487,6.0,199,3,23,1,4
49,2/1/2021,1669,44247,952,32951,711,11267,464.0,3119,667.0,17041,20.0,449,653,10094,28.0,515,10.0,209,7,30,0,4
50,2/2/2021,1878,46125,740,33691,1138,12405,737.0,3856,582.0,17623,45.0,494,1047,11141,36.0,551,10.0,219,0,30,0,4
51,2/3/2021,1280,47405,593,34284,688,13093,322.0,4178,229.0,17852,48.0,542,583,11724,46.0,597,11.0,230,0,30,0,4
52,2/4/2021,2528,49933,1782,36066,745,13838,496.0,4674,1536.0,19388,31.0,573,666,12390,38.0,635,10.0,240,1,31,0,4
53,2/5/2021,2581,52514,1529,37595,1047,14885,687.0,5361,1303.0,20691,38.0,611,958,13348,33.0,668,18.0,258,6,37,0,4
54,2/6/2021,2228,54742,1602,39197,626,15511,455.0,5816,1238.0,21929,11.0,622,586,13934,21.0,689,8.0,266,0,37,0,4
55,2/7/2021,236,54978,89,39286,144,15655,97.0,5913,27.0,21956,7.0,629,129,14063,4.0,693,4.0,270,3,40,0,4
56,2/8/2021,2458,57436,1580,40866,879,16534,595.0,6508,1125.0,23081,26.0,655,809,14872,28.0,721,16.0,286,0,40,0,4
57,2/9/2021,2384,59820,1528,42394,855,17389,523.0,7031,985.0,24066,26.0,681,770,15642,38.0,759,21.0,307,2,42,0,4
58,2/10/2021,1592,61412,972,43366,613,18002,314.0,7345,288.0,24354,25.0,706,544,16186,29.0,788,15.0,322,7,49,0,4
59,2/11/2021,3530,64942,2000,45366,1529,19531,1050.0,8395,809.0,25163,55.0,761,1393,17579,56.0,844,25.0,347,3,52,0,4
60,2/12/2021,3274,68216,1817,47183,1453,20984,958.0,9353,796.0,25959,59.0,820,1335,18914,47.0,891,12.0,359,4,56,0,4
61,2/13/2021,3002,71218,2366,49549,634,21618,310.0,9663,675.0,26634,14.0,834,582,19496,26.0,917,12.0,371,2,58,0,4
62,2/14/2021,437,71655,354,49903,82,21700,57.0,9720,44.0,26678,2.0,836,75,19571,3.0,920,2.0,373,1,59,0,4
63,2/15/2021,2616,74271,2121,52024,495,22195,322.0,10042,257.0,26935,18.0,854,464,20035,12.0,932,1.0,374,0,59,0,4
64,2/16/2021,2750,77021,1911,53935,839,23034,494.0,10536,229.0,27164,36.0,890,764,20799,22.0,954,17.0,391,0,59,0,4
65,2/17/2021,1644,78665,654,54589,986,24020,482.0,11018,154.0,27318,31.0,921,897,21696,39.0,993,19.0,410,4,63,0,4
66,2/18/2021,2641,81306,1680,56269,957,24977,730.0,11748,279.0,27597,37.0,958,880,22576,32.0,1025,8.0,418,4,67,0,4
67,2/19/2021,2437,83743,1033,57302,1400,26377,1032.0,12780,158.0,27755,45.0,1003,1293,23869,47.0,1072,15.0,433,4,71,0,4
68,2/20/2021,1654,85397,679,57981,973,27350,793.0,13573,129.0,27884,23.0,1026,909,24778,31.0,1103,10.0,443,2,73,0,4
69,2/21/2021,117,85514,44,58025,71,27421,40.0,13613,8.0,27892,1.0,1027,67,24845,2.0,1105,1.0,444,2,75,0,4
70,2/22/2021,2029,87543,761,58786,1264,28685,928.0,14541,149.0,28041,38.0,1065,1175,26020,41.0,1146,10.0,454,4,79,0,4
71,2/23/2021,1233,88776,523,59309,709,29394,469.0,15010,163.0,28204,21.0,1086,639,26659,37.0,1183,12.0,466,1,80,0,4
72,2/24/2021,1418,90194,756,60065,660,30054,280.0,15290,138.0,28342,28.0,1114,609,27268,19.0,1202,4.0,470,2,82,0,4
73,2/25/2021,3875,94069,2071,62136,1801,31855,1507.0,16797,353.0,28695,48.0,1162,1699,28967,39.0,1241,15.0,485,2,84,1,5
74,2/26/2021,3278,97347,1161,63297,2114,33969,1742.0,18539,203.0,28898,32.0,1194,1993,30960,60.0,1301,29.0,514,3,87,0,5
75,2/27/2021,3498,100845,1669,64966,1825,35794,1559.0,20098,548.0,29446,35.0,1229,1706,32666,57.0,1358,27.0,541,4,91,0,5
76,2/28/2021,437,101282,364,65330,70,35864,43.0,20141,116.0,29562,2.0,1231,65,32731,1.0,1359,2.0,543,3,94,0,5
77,3/1/2021,2964,104246,1471,66801,1498,37362,1075.0,21216,303.0,29865,55.0,1286,1386,34117,46.0,1405,11.0,554,14,108,0,5
78,3/2/2021,3255,107501,1731,68532,1521,38883,1043.0,22259,384.0,30249,37.0,1323,1413,35530,44.0,1449,27.0,581,3,111,0,5
79,3/3/2021,1674,109175,1096,69628,583,39466,180.0,22439,208.0,30457,32.0,1355,519,36049,26.0,1475,6.0,587,0,111,0,5
80,3/4/2021,3025,112200,1598,71226,1460,40926,823.0,23262,171.0,30628,43.0,1398,1340,37389,58.0,1533,19.0,606,2,113,0,5
81,3/5/2021,3489,115689,2062,73288,1472,42398,818.0,24080,424.0,31052,42.0,1440,1363,38752,43.0,1576,24.0,630,3,116,0,5
82,3/6/2021,4128,119817,2338,75626,2713,45111,864.0,24944,269.0,31321,171.0,1611,2382,41134,127.0,1703,33.0,663,3,119,1,6
83,3/7/2021,428,120245,311,75937,151,45262,36.0,24980,23.0,31344,4.0,1615,143,41277,2.0,1705,2.0,665,0,119,0,6
84,3/8/2021,2824,123069,1061,76998,1918,47180,275.0,25255,76.0,31420,54.0,1669,1776,43053,66.0,1771,22.0,687,4,123,0,6
85,3/9/2021,3193,126262,1656,78654,1640,48820,263.0,25518,96.0,31516,54.0,1723,1493,44546,69.0,1840,24.0,711,10,133,0,6
86,3/10/2021,2412,128674,1394,80048,1099,49919,309.0,25827,88.0,31604,54.0,1777,991,45537,37.0,1877,17.0,728,3,136,0,6
87,3/11/2021,4182,132856,2387,82435,1901,51820,402.0,26229,135.0,31739,64.0,1841,1747,47284,71.0,1948,19.0,747,6,142,0,6
88,3/12/2021,3960,136816,2581,85016,1480,53300,204.0,26433,68.0,31807,94.0,1935,1296,48580,59.0,2007,31.0,778,8,150,0,6
89,3/13/2021,224,137040,140,85156,135,53435,21.0,26454,6.0,31813,1.0,1936,127,48707,5.0,2012,2.0,780,1,151,0,6
90,3/14/2021,105,137145,62,85218,43,53478,9.0,26463,0.0,31813,1.0,1937,40,48747,1.0,2013,1.0,781,1,152,0,6
91,3/15/2021,920,138065,377,85595,569,54047,90.0,26553,15.0,31828,20.0,1957,523,49270,17.0,2030,9.0,790,2,154,0,6
92,3/16/2021,3307,141372,2128,87723,1224,55271,233.0,26786,45.0,31873,67.0,2024,1095,50365,46.0,2076,16.0,806,1,155,0,6
93,3/17/2021,2924,144296,1787,89510,1190,56461,238.0,27024,88.0,31961,41.0,2065,1091,51456,41.0,2117,17.0,823,7,162,0,6
94,3/18/2021,4019,148315,2082,91592,1962,58423,344.0,27368,91.0,32052,98.0,2163,1780,53236,65.0,2182,19.0,842,13,175,0,6
95,3/19/2021,3016,151331,1748,93340,1284,59707,224.0,27592,43.0,32095,64.0,2227,1154,54390,46.0,2228,20.0,862,11,186,1,7
96,3/20/2021,3085,154416,1965,95305,1164,60871,316.0,27908,52.0,32147,37.0,2264,1040,55430,63.0,2291,24.0,886,7,193,0,7
97,3/21/2021,687,155103,412,95717,293,61164,27.0,27935,5.0,32152,13.0,2277,260,55690,19.0,2310,1.0,887,5,198,0,7
98,3/22/2021,3124,158227,2250,97967,898,62062,195.0,28130,57.0,32209,19.0,2296,827,56517,39.0,2349,13.0,900,8,206,0,7
99,3/23/2021,4470,162697,3576,101543,1749,63811,203.0,28333,74.0,32283,66.0,2362,1524,58041,107.0,2456,52.0,952,2,208,0,7
100,3/24/2021,3170,165867,2433,103976,796,64607,123.0,28456,36.0,32319,46.0,2408,705,58746,28.0,2484,17.0,969,5,213,0,7
101,3/25/2021,5067,170934,3042,107018,2040,66647,313.0,28769,69.0,32388,68.0,2476,1866,60612,73.0,2557,33.0,1002,12,225,3,10
102,3/26/2021,4603,175537,2729,109747,1909,68556,330.0,29099,67.0,32455,121.0,2597,1645,62257,113.0,2670,30.0,1032,11,236,0,10
103,3/27/2021,3354,178891,1909,111656,1450,70006,331.0,29430,20.0,32475,49.0,2646,1332,63589,49.0,2719,20.0,1052,4,240,0,10
104,3/28/2021,1189,180080,826,112482,365,70371,92.0,29522,17.0,32492,12.0,2658,334,63923,16.0,2735,3.0,1055,1,241,0,10
105,3/29/2021,4011,184091,2700,115182,1330,71701,234.0,29756,55.0,32547,41.0,2699,1244,65167,33.0,2768,12.0,1067,3,244,0,10
106,3/30/2021,4387,188478,2757,117939,1710,73411,248.0,30004,75.0,32622,57.0,2756,1554,66721,78.0,2846,21.0,1088,7,251,0,10
107,3/31/2021,3627,192105,2588,120527,1108,74519,172.0,30176,48.0,32670,47.0,2803,987,67708,51.0,2897,23.0,1111,7,258,0,10
108,4/1/2021,5201,197306,3374,123901,1871,76390,155.0,30331,79.0,32749,76.0,2879,1699,69407,73.0,2970,23.0,1134,23,281,1,11
109,4/2/2021,4730,202036,2531,126432,2243,78633,243.0,30574,51.0,32800,83.0,2962,2033,71440,98.0,3068,29.0,1163,6,287,1,12
110,4/3/2021,4282,206318,3523,129955,876,79509,100.0,30674,41.0,32841,38.0,3000,783,72223,37.0,3105,18.0,1181,6,293,0,12
111,4/4/2021,388,206706,269,130224,173,79682,6.0,30680,7.0,32848,3.0,3003,155,72378,13.0,3118,2.0,1183,2,295,0,12
112,4/5/2021,4721,211427,3782,134006,1081,80763,80.0,30760,47.0,32895,70.0,3073,931,73309,55.0,3173,25.0,1208,3,298,0,12
113,4/6/2021,5179,216606,3043,137049,2658,83421,91.0,30851,63.0,32958,91.0,3164,2333,75642,170.0,3343,64.0,1272,10,308,1,13
114,4/7/2021,5007,221613,3695,140744,3523,86944,84.0,30935,108.0,33066,155.0,3319,3024,78666,251.0,3594,93.0,1365,11,319,0,13
115,4/8/2021,6683,228296,4498,145242,3992,90936,165.0,31100,120.0,33186,169.0,3488,3515,82181,220.0,3814,88.0,1453,17,336,0,13
116,4/9/2021,5749,234045,3289,148531,4188,95124,96.0,31196,69.0,33255,198.0,3686,3644,85825,245.0,4059,101.0,1554,13,349,2,15
117,4/10/2021,4437,238482,3164,151695,2365,97489,71.0,31267,70.0,33325,129.0,3815,2007,87832,163.0,4222,66.0,1620,5,354,0,15
118,4/11/2021,1052,239534,797,152492,366,97855,7.0,31274,11.0,33336,16.0,3831,300,88132,38.0,4260,12.0,1632,0,354,0,15
119,4/12/2021,5066,244600,3644,156136,2678,100533,98.0,31372,97.0,33433,102.0,3933,2330,90462,177.0,4437,69.0,1701,12,366,0,15
120,4/13/2021,5042,249642,3556,159692,1519,102052,56.0,31428,77.0,33510,73.0,4006,1320,91782,101.0,4538,25.0,1726,10,376,0,15
121,4/14/2021,2968,252610,1434,161126,1524,103576,86.0,31514,24.0,33534,92.0,4098,1330,93112,73.0,4611,29.0,1755,10,386,0,15
122,4/15/2021,4962,257572,2327,163453,2620,106196,102.0,31616,61.0,33595,220.0,4318,2177,95289,166.0,4777,57.0,1812,16,402,1,16
123,4/16/2021,3933,261505,2082,165535,1833,108029,45.0,31661,34.0,33629,66.0,4384,1598,96887,134.0,4911,35.0,1847,17,419,1,17
124,4/17/2021,4588,266093,2389,167924,2189,110218,38.0,31699,57.0,33686,103.0,4487,1907,98794,133.0,5044,46.0,1893,10,429,1,18
125,4/18/2021,1065,267158,408,168332,650,110868,15.0,31714,10.0,33696,47.0,4534,540,99334,35.0,5079,28.0,1921,6,435,1,19
126,4/19/2021,3863,271021,1402,169734,2446,113314,44.0,31758,39.0,33735,169.0,4703,2056,101390,164.0,5243,57.0,1978,14,449,1,20
127,4/20/2021,4709,275730,1852,171586,2831,116145,46.0,31804,71.0,33806,160.0,4863,2409,103799,198.0,5441,64.0,2042,22,471,4,24
128,4/21/2021,3226,278956,718,172304,2490,118635,37.0,31841,31.0,33837,152.0,5015,2096,105895,168.0,5609,74.0,2116,20,491,0,24
129,4/22/2021,4659,283615,1772,174076,2868,121503,46.0,31887,62.0,33899,144.0,5159,2463,108358,193.0,5802,68.0,2184,19,510,0,24
130,4/23/2021,3603,287218,1173,175249,2417,123920,41.0,31928,31.0,33930,76.0,5235,2133,110491,129.0,5931,79.0,2263,15,525,0,24
131,4/24/2021,3368,290586,1121,176370,2237,126157,14.0,31942,20.0,33950,108.0,5343,1897,112388,193.0,6124,39.0,2302,10,535,0,24
132,4/25/2021,828,291414,364,176734,462,126619,6.0,31948,8.0,33958,106.0,5449,280,112668,39.0,6163,37.0,2339,3,538,0,24
133,4/26/2021,4391,295805,1109,177843,3274,129893,38.0,31986,30.0,33988,151.0,5600,2819,115487,213.0,6376,91.0,2430,10,548,0,24
134,4/27/2021,3379,299184,1201,179044,2183,132076,41.0,32027,38.0,34026,82.0,5682,1921,117408,138.0,6514,42.0,2472,14,562,1,25
135,4/28/2021,3007,302191,710,179754,2309,134385,45.0,32072,22.0,34048,170.0,5852,1871,119279,204.0,6718,64.0,2536,18,580,1,26
136,4/29/2021,3986,306177,823,180577,3171,137556,72.0,32144,32.0,34080,232.0,6084,2600,121879,233.0,6951,106.0,2642,10,590,0,26
137,4/30/2021,2906,309083,651,181228,2266,139822,50.0,32194,24.0,34104,74.0,6158,1929,123808,203.0,7154,60.0,2702,21,611,0,26
138,5/1/2021,3691,312774,821,182049,2849,142671,36.0,32230,19.0,34123,283.0,6441,2223,126031,204.0,7358,139.0,2841,36,647,1,27
139,5/2/2021,545,313319,239,182288,323,142994,7.0,32237,2.0,34125,12.0,6453,259,126290,43.0,7401,9.0,2850,4,651,0,27
140,5/3/2021,3427,316746,638,182926,2801,145795,47.0,32284,34.0,34159,110.0,6563,2403,128693,212.0,7613,76.0,2926,13,664,0,27
141,5/4/2021,4352,321098,688,183614,3708,149503,71.0,32355,26.0,34185,149.0,6712,3181,131874,260.0,7873,118.0,3044,10,674,2,29
142,5/5/2021,2237,323335,476,184090,1814,151317,62.0,32417,24.0,34209,88.0,6800,1500,133374,147.0,8020,79.0,3123,7,681,2,31
143,5/6/2021,3703,327038,824,184914,3054,154371,100.0,32517,38.0,34247,182.0,6982,2541,135915,203.0,8223,128.0,3251,9,690,5,36
144,5/7/2021,2954,329992,538,185452,2554,156925,45.0,32562,11.0,34258,136.0,7118,2105,138020,213.0,8436,100.0,3351,14,704,1,37
145,5/8/2021,3007,332999,563,186015,2609,159534,47.0,32609,16.0,34274,170.0,7288,2116,140136,195.0,8631,128.0,3479,10,714,0,37
146,5/9/2021,383,333382,147,186162,250,159784,4.0,32613,2.0,34276,11.0,7299,208,140344,22.0,8653,9.0,3488,3,717,0,37
147,5/10/2021,2443,335825,378,186540,2126,161910,65.0,32678,16.0,34292,91.0,7390,1732,142076,206.0,8859,97.0,3585,8,725,3,40
148,5/11/2021,2719,338544,531,187071,2242,164152,95.0,32773,23.0,34315,193.0,7583,1751,143827,205.0,9064,93.0,3678,15,740,1,41
149,5/12/2021,1249,339793,465,187536,866,165018,26.0,32799,14.0,34329,54.0,7637,688,144515,86.0,9150,38.0,3716,7,747,0,41
150,5/13/2021,3264,343057,1029,188565,2263,167281,86.0,32885,25.0,34354,148.0,7785,1840,146355,168.0,9318,107.0,3823,12,759,4,45
151,5/14/2021,2473,345530,1281,189846,1324,168605,57.0,32942,30.0,34384,66.0,7851,1105,147460,100.0,9418,53.0,3876,12,771,2,47
152,5/15/2021,3039,348569,1510,191356,1655,170260,44.0,32986,17.0,34401,117.0,7968,1318,148778,148.0,9566,72.0,3948,7,778,3,50
153,5/16/2021,946,349515,544,191900,446,170706,11.0,32997,5.0,34406,88.0,8056,283,149061,33.0,9599,42.0,3990,1,779,2,52
154,5/17/2021,2438,351953,1202,193102,1330,172036,36.0,33033,27.0,34433,50.0,8106,1113,150174,109.0,9708,58.0,4048,5,784,1,53
155,5/18/2021,2587,354540,1158,194260,1469,173505,46.0,33079,22.0,34455,77.0,8183,1242,151416,85.0,9793,65.0,4113,10,794,4,57
156,5/19/2021,1884,356424,1153,195413,811,174316,28.0,33107,19.0,34474,43.0,8226,660,152076,68.0,9861,40.0,4153,4,798,1,58
157,5/20/2021,1991,358415,938,196351,1110,175426,44.0,33151,28.0,34502,97.0,8323,887,152963,78.0,9939,48.0,4201,11,809,2,60
158,5/21/2021,1654,360069,925,197276,833,176259,21.0,33172,15.0,34517,43.0,8366,666,153629,67.0,10006,57.0,4258,14,823,2,62
159,5/22/2021,1694,361763,795,198071,939,177198,9.0,33181,13.0,34530,122.0,8488,660,154289,75.0,10081,82.0,4340,9,832,2,64
160,5/23/2021,684,362447,342,198413,372,177570,2.0,33183,5.0,34535,67.0,8555,230,154519,21.0,10102,54.0,4394,1,833,0,64
161,5/24/2021,1351,363798,544,198957,881,178451,37.0,33220,20.0,34555,41.0,8596,711,155230,85.0,10187,44.0,4438,12,845,2,66
162,5/25/2021,1231,365029,507,199464,768,179219,24.0,33244,18.0,34573,57.0,8653,580,155810,66.0,10253,65.0,4503,7,852,0,66
163,5/26/2021,972,366001,551,200015,562,179781,21.0,33265,25.0,34598,41.0,8694,447,156257,44.0,10297,30.0,4533,3,855,1,67
164,5/27/2021,1312,367313,664,200679,732,180513,32.0,33297,20.0,34618,59.0,8753,588,156845,56.0,10353,29.0,4562,6,861,1,68
165,5/28/2021,1050,368363,608,201287,504,181017,20.0,33317,23.0,34641,34.0,8787,393,157238,51.0,10404,26.0,4588,11,872,0,68
166,5/29/2021,1027,369390,494,201781,579,181596,19.0,33336,8.0,34649,33.0,8820,461,157699,45.0,10449,40.0,4628,6,878,0,68
167,5/30/2021,333,369723,218,201999,151,181747,5.0,33341,3.0,34652,14.0,8834,109,157808,18.0,10467,10.0,4638,3,881,2,70
168,5/31/2021,338,370061,191,202190,175,181922,8.0,33349,6.0,34658,7.0,8841,146,157954,11.0,10478,11.0,4649,10,891,1,71
169,6/1/2021,1019,371080,409,202599,630,182552,29.0,33378,18.0,34676,51.0,8892,488,158442,45.0,10523,46.0,4695,40,931,1,72
170,6/2/2021,724,371804,369,202968,421,182973,16.0,33394,8.0,34684,35.0,8927,337,158779,24.0,10547,25.0,4720,3,934,1,73
171,6/3/2021,1316,373120,520,203488,860,183833,22.0,33416,11.0,34695,51.0,8978,707,159486,63.0,10610,39.0,4759,4,938,0,73
172,6/4/2021,1500,374620,400,203888,1153,184986,16.0,33432,11.0,34706,71.0,9049,966,160452,70.0,10680,46.0,4805,3,941,1,74
173,6/5/2021,1426,376046,362,204250,1093,186079,13.0,33445,6.0,34712,62.0,9111,892,161344,96.0,10776,43.0,4848,10,951,2,76
174,6/6/2021,564,376610,146,204396,438,186517,5.0,33450,3.0,34715,51.0,9162,346,161690,28.0,10804,13.0,4861,1,952,0,76
175,6/7/2021,1197,377807,340,204736,913,187430,16.0,33466,12.0,34727,67.0,9229,732,162422,82.0,10886,32.0,4893,8,960,1,77
176,6/8/2021,1095,378902,250,204986,875,188305,18.0,33484,5.0,34732,59.0,9288,713,163135,71.0,10957,32.0,4925,7,967,0,77
177,6/9/2021,1084,379986,282,205268,857,189162,15.0,33499,11.0,34743,75.0,9363,664,163799,75.0,11032,43.0,4968,4,971,1,78
178,6/10/2021,1335,381321,345,205613,1036,190198,21.0,33520,4.0,34747,95.0,9458,815,164614,73.0,11105,53.0,5021,11,982,1,79
179,6/11/2021,1115,382436,321,205934,848,191046,19.0,33539,13.0,34760,61.0,9519,662,165276,81.0,11186,44.0,5065,2,984,0,79
180,6/12/2021,1047,383483,287,206221,811,191857,16.0,33555,9.0,34769,71.0,9590,631,165907,67.0,11253,42.0,5107,1,985,0,79
181,6/13/2021,372,383855,99,206320,291,192148,4.0,33559,1.0,34770,35.0,9625,211,166118,25.0,11278,20.0,5127,3,988,0,79
182,6/14/2021,846,384701,289,206609,613,192761,15.0,33574,4.0,34774,48.0,9673,467,166585,44.0,11322,54.0,5181,3,991,0,79
183,6/15/2021,707,385408,243,206852,489,193250,20.0,33594,10.0,34784,44.0,9717,394,166979,34.0,11356,17.0,5198,2,993,1,80
184,6/16/2021,645,386053,209,207061,471,193721,13.0,33607,5.0,34789,40.0,9757,351,167330,41.0,11397,39.0,5237,5,998,0,80
185,6/17/2021,703,386756,255,207316,476,194197,15.0,33622,9.0,34798,45.0,9802,352,167682,50.0,11447,29.0,5266,7,1005,1,81
186,6/18/2021,1046,387802,378,207694,704,194901,21.0,33643,11.0,34809,57.0,9859,560,168242,57.0,11504,30.0,5296,13,1018,0,81
187,6/19/2021,646,388448,155,207849,512,195413,10.0,33653,6.0,34815,51.0,9910,379,168621,55.0,11559,27.0,5323,4,1022,0,81
188,6/20/2021,296,388744,111,207960,193,195606,3.0,33656,2.0,34817,37.0,9947,118,168739,15.0,11574,23.0,5346,5,1027,0,81
189,6/21/2021,520,389264,214,208174,340,195946,5.0,33661,7.0,34824,30.0,9977,253,168992,34.0,11608,23.0,5369,4,1031,0,81
190,6/22/2021,617,389881,252,208426,403,196349,13.0,33674,8.0,34832,31.0,10008,317,169309,27.0,11635,28.0,5397,1,1032,0,81
191,6/23/2021,509,390390,185,208611,351,196700,8.0,33682,10.0,34842,42.0,10050,253,169562,35.0,11670,21.0,5418,9,1041,1,82
192,6/24/2021,533,390923,207,208818,352,197052,13.0,33695,9.0,34851,35.0,10085,271,169833,24.0,11694,22.0,5440,2,1043,0,82
193,6/25/2021,693,391616,273,209091,445,197497,13.0,33708,9.0,34860,44.0,10129,333,170166,42.0,11736,26.0,5466,3,1046,0,82
194,6/26/2021,605,392221,164,209255,455,197952,9.0,33717,8.0,34868,79.0,10208,300,170466,47.0,11783,29.0,5495,3,1049,1,83
195,6/27/2021,183,392404,66,209321,119,198071,2.0,33719,3.0,34871,10.0,10218,87,170553,12.0,11795,10.0,5505,2,1051,0,83
196,6/28/2021,488,392892,206,209527,289,198360,7.0,33726,6.0,34877,39.0,10257,206,170759,26.0,11821,18.0,5523,8,1059,0,83
197,6/29/2021,566,393458,258,209785,340,198700,17.0,33743,11.0,34888,43.0,10300,249,171008,23.0,11844,25.0,5548,8,1067,2,85
198,6/30/2021,423,393881,206,209991,230,198930,8.0,33751,11.0,34899,20.0,10320,173,171181,17.0,11861,20.0,5568,8,1075,2,87
199,7/1/2021,514,394395,218,210209,309,199239,9.0,33760,7.0,34906,24.0,10344,230,171411,34.0,11895,21.0,5589,14,1089,2,89
200,7/2/2021,573,394968,273,210482,313,199552,7.0,33767,7.0,34913,28.0,10372,244,171655,25.0,11920,16.0,5605,6,1095,0,89
201,7/3/2021,303,395271,118,210600,192,199744,4.0,33771,3.0,34916,29.0,10401,125,171780,20.0,11940,18.0,5623,5,1100,0,89
202,7/4/2021,55,395326,20,210620,35,199779,1.0,33772,0.0,34916,4.0,10405,22,171802,1.0,11941,8.0,5631,0,1100,0,89
203,7/5/2021,324,395650,143,210763,178,199957,4.0,33776,1.0,34917,18.0,10423,124,171926,26.0,11967,10.0,5641,9,1109,0,89
204,7/6/2021,471,396121,192,210955,289,200246,4.0,33780,5.0,34922,45.0,10468,209,172135,21.0,11988,14.0,5655,4,1113,0,89
205,7/7/2021,386,396507,215,211170,190,200436,8.0,33788,6.0,34928,23.0,10491,138,172273,13.0,12001,16.0,5671,5,1118,0,89
206,7/8/2021,431,396938,203,211373,251,200687,9.0,33797,8.0,34936,25.0,10516,177,172450,26.0,12027,23.0,5694,4,1122,1,90
207,7/9/2021,479,397417,193,211566,297,200984,10.0,33807,2.0,34938,39.0,10555,216,172666,24.0,12051,18.0,5712,2,1124,2,92
208,7/10/2021,267,397684,154,211720,133,201117,5.0,33812,2.0,34940,5.0,10560,110,172776,10.0,12061,8.0,5720,2,1126,0,92
209,7/11/2021,222,397906,120,211840,125,201242,6.0,33818,7.0,34947,11.0,10571,93,172869,9.0,12070,12.0,5732,7,1133,2,94
210,7/12/2021,392,398298,205,212045,200,201442,6.0,33824,4.0,34951,27.0,10598,134,173003,22.0,12092,17.0,5749,4,1137,0,94
211,7/13/2021,439,398737,226,212271,234,201676,17.0,33841,9.0,34960,29.0,10627,181,173184,12.0,12104,12.0,5761,4,1141,0,94
212,7/14/2021,288,399025,154,212425,160,201836,8.0,33849,5.0,34965,20.0,10647,116,173300,9.0,12113,15.0,5776,5,1146,1,95
213,7/15/2021,366,399391,188,212613,186,202022,1.0,33850,4.0,34969,16.0,10663,139,173439,14.0,12127,17.0,5793,6,1152,0,95
214,7/16/2021,509,399900,244,212857,281,202303,8.0,33858,9.0,34978,24.0,10687,214,173653,21.0,12148,22.0,5815,1,1153,0,95
215,7/17/2021,276,400176,158,213015,137,202440,12.0,33870,4.0,34982,13.0,10700,106,173759,8.0,12156,10.0,5825,3,1156,0,95
216,7/18/2021,192,400368,115,213130,93,202533,3.0,33873,3.0,34985,13.0,10713,66,173825,7.0,12163,7.0,5832,3,1159,0,95
217,7/19/2021,406,400774,203,213333,210,202743,9.0,33882,8.0,34993,26.0,10739,154,173979,18.0,12181,12.0,5844,4,1163,2,97
218,7/20/2021,427,401201,214,213547,221,202964,6.0,33888,8.0,35001,12.0,10751,170,174149,25.0,12206,14.0,5858,6,1169,2,99
219,7/21/2021,346,401547,188,213735,178,203142,14.0,33902,14.0,35015,15.0,10766,132,174281,14.0,12220,17.0,5875,4,1173,1,100
220,7/22/2021,400,401947,233,213968,177,203319,7.0,33909,17.0,35032,21.0,10787,131,174412,18.0,12238,7.0,5882,7,1180,1,101
221,7/23/2021,559,402506,327,214295,240,203559,7.0,33916,10.0,35042,37.0,10824,166,174578,19.0,12257,18.0,5900,6,1186,0,101
222,7/24/2021,349,402855,211,214506,162,203721,9.0,33925,9.0,35051,20.0,10844,119,174697,9.0,12266,14.0,5914,2,1188,1,102
223,7/25/2021,191,403046,137,214643,66,203787,0.0,33925,4.0,35055,7.0,10851,48,174745,5.0,12271,6.0,5920,4,1192,0,102
224,7/26/2021,356,403402,206,214849,152,203939,3.0,33928,6.0,35061,11.0,10862,105,174850,20.0,12291,16.0,5936,10,1202,0,102
225,7/27/2021,431,403833,235,215084,183,204122,5.0,33933,16.0,35077,23.0,10885,127,174977,20.0,12311,13.0,5949,27,1229,0,102
226,7/28/2021,474,404307,284,215368,226,204348,4.0,33937,10.0,35087,30.0,10915,148,175125,17.0,12328,31.0,5980,5,1234,2,104
227,7/29/2021,519,404826,312,215680,239,204587,8.0,33945,7.0,35094,26.0,10941,180,175305,14.0,12342,19.0,5999,13,1247,1,105
228,7/30/2021,698,405524,483,216163,253,204840,10.0,33955,14.0,35108,29.0,10970,189,175494,17.0,12359,18.0,6017,9,1256,1,106
229,7/31/2021,336,405860,200,216363,137,204977,4.0,33959,1.0,35109,16.0,10986,108,175602,8.0,12367,5.0,6022,11,1267,0,106
230,8/1/2021,299,406159,176,216539,106,205083,0.0,33959,2.0,35111,14.0,11000,66,175668,10.0,12377,16.0,6038,32,1299,3,109
231,8/2/2021,455,406614,297,216836,185,205268,5.0,33964,14.0,35125,22.0,11022,129,175797,19.0,12396,15.0,6053,8,1307,2,111
232,8/3/2021,563,407177,345,217181,247,205515,6.0,33970,14.0,35139,40.0,11062,164,175961,16.0,12412,27.0,6080,5,1312,1,112
233,8/4/2021,399,407576,277,217458,154,205669,6.0,33976,13.0,35152,11.0,11073,115,176076,8.0,12420,20.0,6100,2,1314,1,113
234,8/5/2021,442,408018,282,217740,173,205842,6.0,33982,10.0,35162,21.0,11094,126,176202,16.0,12436,10.0,6110,8,1322,0,113
235,8/6/2021,681,408699,458,218198,275,206117,13.0,33995,16.0,35178,23.0,11117,207,176409,23.0,12459,22.0,6132,8,1330,0,113
236,8/7/2021,451,409150,312,218510,163,206280,4.0,33999,11.0,35189,12.0,11129,132,176541,5.0,12464,14.0,6146,5,1335,1,114
237,8/8/2021,213,409363,123,218633,97,206377,3.0,34002,5.0,35194,8.0,11137,68,176609,9.0,12473,12.0,6158,5,1340,2,116
238,8/9/2021,462,409825,274,218907,219,206596,4.0,34006,6.0,35200,20.0,11157,165,176774,11.0,12484,23.0,6181,8,1348,2,118
239,8/10/2021,504,410329,298,219205,230,206826,6.0,34012,13.0,35213,25.0,11182,179,176953,13.0,12497,13.0,6194,6,1354,4,122
240,8/11/2021,416,410745,260,219465,182,207008,11.0,34023,5.0,35218,18.0,11200,138,177091,14.0,12511,12.0,6206,3,1357,0,122
241,8/12/2021,539,411284,318,219783,265,207273,7.0,34030,15.0,35233,30.0,11230,188,177279,23.0,12534,24.0,6230,7,1364,2,124
242,8/13/2021,661,411945,375,220158,305,207578,10.0,34040,9.0,35242,30.0,11260,225,177504,20.0,12554,30.0,6260,7,1371,1,125
243,8/14/2021,509,412454,259,220417,258,207836,7.0,34047,7.0,35249,11.0,11271,219,177723,10.0,12564,18.0,6278,52,1423,2,127
244,8/15/2021,266,412720,129,220546,123,207959,2.0,34049,2.0,35251,11.0,11282,89,177812,6.0,12570,17.0,6295,22,1445,0,127
245,8/16/2021,543,413263,311,220857,177,208136,4.0,34053,11.0,35262,15.0,11297,138,177950,12.0,12582,12.0,6307,85,1530,3,130
246,8/17/2021,488,413751,228,221085,196,208332,17.0,34070,10.0,35272,17.0,11314,148,178098,12.0,12594,19.0,6326,90,1620,0,130
247,8/18/2021,596,414347,326,221411,271,208603,6.0,34076,15.0,35287,31.0,11345,185,178283,14.0,12608,41.0,6367,74,1694,4,134
248,8/19/2021,568,414915,278,221689,266,208869,7.0,34083,9.0,35296,21.0,11366,208,178491,22.0,12630,15.0,6382,84,1778,1,135
249,8/20/2021,850,415765,334,222023,473,209342,16.0,34099,11.0,35307,46.0,11412,374,178865,30.0,12660,23.0,6405,97,1875,1,136
250,8/21/2021,647,416412,213,222236,210,209552,6.0,34105,7.0,35314,14.0,11426,173,179038,13.0,12673,10.0,6415,236,2111,0,136
251,8/22/2021,310,416722,150,222386,137,209689,1.0,34106,2.0,35316,18.0,11444,98,179136,9.0,12682,12.0,6427,31,2142,2,138
252,8/23/2021,528,417250,260,222646,224,209913,11.0,34117,10.0,35326,19.0,11463,169,179305,13.0,12695,23.0,6450,67,2209,1,139
253,8/24/2021,575,417825,277,222923,285,210198,12.0,34129,8.0,35334,28.0,11491,225,179530,14.0,12709,18.0,6468,57,2266,2,141
254,8/25/2021,606,418431,326,223249,268,210466,11.0,34140,13.0,35347,22.0,11513,203,179733,10.0,12719,33.0,6501,55,2321,2,143
255,8/26/2021,541,418972,258,223507,258,210724,9.0,34149,13.0,35360,18.0,11531,199,179932,23.0,12742,18.0,6519,56,2377,1,144
256,8/27/2021,895,419867,356,223863,401,211125,15.0,34164,11.0,35371,37.0,11568,295,180227,27.0,12769,42.0,6561,176,2553,6,150
257,8/28/2021,1458,421325,202,224065,247,211372,8.0,34172,5.0,35376,23.0,11591,185,180412,13.0,12782,26.0,6587,1002,3555,13,163
258,8/29/2021,1077,422402,161,224226,139,211511,4.0,34176,4.0,35380,9.0,11600,113,180525,12.0,12794,5.0,6592,772,4327,10,173
259,8/30/2021,620,423022,269,224495,285,211796,10.0,34186,13.0,35393,24.0,11624,221,180746,8.0,12802,32.0,6624,97,4424,5,178
260,8/31/2021,802,423824,232,224727,231,212027,7.0,34193,12.0,35405,20.0,11644,182,180928,17.0,12819,12.0,6636,345,4769,6,184
261,9/1/2021,980,424804,252,224979,228,212255,13.0,34206,16.0,35421,21.0,11665,174,181102,13.0,12832,20.0,6656,519,5288,3,187
262,9/2/2021,815,425619,179,225158,203,212458,15.0,34221,13.0,35434,18.0,11683,150,181252,17.0,12849,18.0,6674,454,5742,4,191
263,9/3/2021,845,426464,331,225489,371,212829,14.0,34235,11.0,35445,44.0,11727,274,181526,21.0,12870,32.0,6706,164,5906,2,193
264,9/4/2021,375,426839,162,225651,173,213002,7.0,34242,8.0,35453,14.0,11741,136,181662,11.0,12881,12.0,6718,48,5954,2,195
265,9/5/2021,250,427089,131,225782,107,213109,2.0,34244,4.0,35457,13.0,11754,79,181741,7.0,12888,8.0,6726,23,5977,0,195
266,9/6/2021,114,427203,43,225825,63,213172,1.0,34245,0.0,35457,5.0,11759,46,181787,8.0,12896,4.0,6730,13,5990,0,195
267,9/7/2021,946,428149,198,226023,279,213451,18.0,34263,12.0,35469,22.0,11781,217,182004,17.0,12913,23.0,6753,477,6467,5,200
268,9/8/2021,784,428933,218,226241,229,213680,11.0,34274,12.0,35481,25.0,11806,171,182175,11.0,12924,22.0,6775,359,6826,4,204
269,9/9/2021,404,429337,176,226417,195,213875,10.0,34284,7.0,35488,23.0,11829,143,182318,14.0,12938,15.0,6790,56,6882,0,204
270,9/10/2021,766,430103,348,226765,316,214191,9.0,34293,24.0,35512,28.0,11857,239,182557,21.0,12959,28.0,6818,141,7023,4,208
271,9/11/2021,1614,431717,157,226922,206,214397,11.0,34304,15.0,35527,17.0,11874,156,182713,17.0,12976,16.0,6834,1260,8283,6,214
272,9/12/2021,233,431950,101,227023,114,214511,0.0,34304,2.0,35529,11.0,11885,74,182787,10.0,12986,19.0,6853,16,8299,2,216
273,9/13/2021,500,432450,217,227240,256,214767,9.0,34313,8.0,35537,26.0,11911,190,182977,12.0,12998,28.0,6881,48,8347,0,216
274,9/14/2021,846,433296,202,227442,279,215046,13.0,34326,13.0,35550,17.0,11928,225,183202,15.0,13013,22.0,6903,397,8744,3,219
275,9/15/2021,830,434126,192,227634,270,215316,15.0,34341,14.0,35564,21.0,11949,199,183401,17.0,13030,33.0,6936,393,9137,3,222
276,9/16/2021,367,434493,136,227770,200,215516,9.0,34350,8.0,35572,33.0,11982,144,183545,12.0,13042,11.0,6947,46,9183,0,222
277,9/17/2021,749,435242,287,228057,394,215910,15.0,34365,13.0,35585,28.0,12010,296,183841,39.0,13081,31.0,6978,119,9302,2,224
278,9/18/2021,1804,437046,126,228183,173,216083,5.0,34370,18.0,35603,11.0,12021,129,183970,16.0,13097,17.0,6995,1503,10805,11,235
279,9/19/2021,187,437233,79,228262,107,216190,3.0,34373,2.0,35605,7.0,12028,83,184053,5.0,13102,12.0,7007,14,10819,0,235
280,9/20/2021,385,437618,144,228406,219,216409,8.0,34381,9.0,35614,28.0,12056,160,184213,11.0,13113,20.0,7027,54,10873,0,235
281,9/21/2021,774,438392,165,228571,206,216615,8.0,34389,13.0,35627,22.0,12078,157,184370,12.0,13125,15.0,7042,416,11289,3,238
282,9/22/2021,721,439113,162,228733,234,216849,5.0,34394,11.0,35638,14.0,12092,186,184556,16.0,13141,18.0,7060,360,11649,4,242
283,9/23/2021,354,439467,146,228879,180,217029,8.0,34402,4.0,35642,9.0,12101,133,184689,14.0,13155,24.0,7084,48,11697,2,244
284,9/24/2021,690,440157,202,229081,276,217305,16.0,34418,15.0,35657,19.0,12120,221,184910,12.0,13167,24.0,7108,234,11931,2,246
285,9/25/2021,1714,441871,131,229212,176,217481,11.0,34429,21.0,35678,15.0,12135,138,185048,11.0,13178,12.0,7120,1411,13342,5,251
286,9/26/2021,265,442136,69,229281,86,217567,3.0,34432,4.0,35682,11.0,12146,64,185112,4.0,13182,7.0,7127,108,13450,2,253
287,9/27/2021,568,442704,156,229437,122,217689,7.0,34439,11.0,35693,7.0,12153,94,185206,8.0,13190,13.0,7140,306,13756,1,254
288,9/28/2021,1134,443838,156,229593,203,217892,19.0,34458,23.0,35716,14.0,12167,154,185360,10.0,13200,25.0,7165,794,14550,4,258
289,9/29/2021,1131,444969,172,229765,167,218059,10.0,34468,21.0,35737,14.0,12181,127,185487,7.0,13207,19.0,7184,803,15353,6,264
290,9/30/2021,707,445676,158,229923,167,218226,15.0,34483,7.0,35744,11.0,12192,128,185615,11.0,13218,17.0,7201,406,15759,8,272
291,10/1/2021,1193,446869,175,230098,313,218539,20.0,34503,14.0,35758,25.0,12217,245,185860,21.0,13239,22.0,7223,717,16476,8,280
292,10/2/2021,1797,448666,112,230210,114,218653,11.0,34514,12.0,35770,9.0,12226,94,185954,6.0,13245,5.0,7228,1569,18045,7,287
293,10/3/2021,397,449063,64,230274,112,218765,1.0,34515,2.0,35772,19.0,12245,76,186030,7.0,13252,10.0,7238,234,18279,0,287
294,10/4/2021,801,449864,112,230386,159,218924,7.0,34522,13.0,35785,27.0,12272,102,186132,17.0,13269,13.0,7251,536,18815,3,290
295,10/5/2021,1132,450996,139,230525,139,219063,11.0,34533,19.0,35804,13.0,12285,104,186236,9.0,13278,13.0,7264,868,19683,1,291
296,10/6/2021,1012,452008,107,230632,156,219219,7.0,34540,14.0,35818,11.0,12296,125,186361,5.0,13283,15.0,7279,764,20447,4,295
297,10/7/2021,829,452837,138,230770,111,219330,7.0,34547,17.0,35835,8.0,12304,87,186448,6.0,13289,10.0,7289,601,21048,1,296
298,10/8/2021,1043,453880,161,230931,246,219576,18.0,34565,10.0,35845,22.0,12326,193,186641,10.0,13299,21.0,7310,653,21701,0,296
299,10/9/2021,1678,455558,105,231036,132,219708,11.0,34576,6.0,35851,22.0,12348,98,186739,4.0,13303,8.0,7318,1437,23138,8,304
300,10/10/2021,246,455804,52,231088,65,219773,1.0,34577,3.0,35854,5.0,12353,51,186790,4.0,13307,5.0,7323,128,23266,2,306
301,10/11/2021,820,456624,116,231204,137,219910,16.0,34593,19.0,35873,3.0,12356,114,186904,9.0,13316,11.0,7334,574,23840,4,310
302,10/12/2021,1027,457651,114,231318,132,220042,8.0,34601,16.0,35889,17.0,12373,103,187007,4.0,13320,8.0,7342,790,24630,4,314
303,10/13/2021,971,458622,122,231440,151,220193,16.0,34617,10.0,35899,16.0,12389,112,187119,14.0,13334,9.0,7351,714,25344,7,321
304,10/14/2021,718,459340,98,231538,125,220318,15.0,34632,8.0,35907,21.0,12410,92,187211,7.0,13341,5.0,7356,502,25846,4,325
305,10/15/2021,1001,460341,172,231710,207,220525,10.0,34642,9.0,35916,15.0,12425,163,187374,12.0,13353,17.0,7373,651,26497,8,333
306,10/16/2021,812,461153,69,231779,81,220606,4.0,34646,3.0,35919,7.0,12432,69,187443,2.0,13355,3.0,7376,659,27156,6,339
307,10/17/2021,196,461349,47,231826,62,220668,1.0,34647,2.0,35921,4.0,12436,47,187490,2.0,13357,9.0,7385,85,27241,2,341
308,10/18/2021,660,462009,115,231941,137,220805,10.0,34657,3.0,35924,13.0,12449,106,187596,7.0,13364,11.0,7396,422,27663,4,345
309,10/19/2021,1056,463065,128,232069,132,220937,3.0,34660,12.0,35936,8.0,12457,106,187702,8.0,13372,10.0,7406,806,28469,4,349
310,10/20/2021,895,463960,120,232189,121,221058,7.0,34667,12.0,35948,9.0,12466,90,187792,7.0,13379,15.0,7421,665,29134,7,356
311,10/21/2021,543,464503,109,232298,127,221185,10.0,34677,7.0,35955,13.0,12479,85,187877,11.0,13390,18.0,7439,327,29461,5,361
312,10/22/2021,1493,465996,194,232492,162,221347,7.0,34684,13.0,35968,18.0,12497,109,187986,8.0,13398,27.0,7466,1156,30617,7,368
313,10/23/2021,1858,467854,86,232578,74,221421,9.0,34693,14.0,35982,1.0,12498,63,188049,4.0,13402,6.0,7472,1692,32309,11,379
314,10/24/2021,598,468452,81,232659,73,221494,6.0,34699,9.0,35991,7.0,12505,57,188106,4.0,13406,5.0,7477,450,32759,5,384
315,10/25/2021,1481,469933,140,232799,114,221608,20.0,34719,19.0,36010,8.0,12513,91,188197,7.0,13413,8.0,7485,1232,33991,11,395
316,10/26/2021,2136,472069,175,232974,135,221743,6.0,34725,17.0,36027,15.0,12528,102,188299,8.0,13421,10.0,7495,1823,35814,16,411
317,10/27/2021,1978,474047,147,233121,108,221851,5.0,34730,18.0,36045,5.0,12533,86,188385,10.0,13431,7.0,7502,1730,37544,8,419
318,10/28/2021,1801,475848,145,233266,113,221964,4.0,34734,24.0,36069,6.0,12539,91,188476,4.0,13435,12.0,7514,1538,39082,15,434
319,10/29/2021,1735,477583,180,233446,133,222097,4.0,34738,15.0,36084,8.0,12547,108,188584,5.0,13440,12.0,7526,1421,40503,13,447
320,10/30/2021,1583,479166,76,233522,77,222174,5.0,34743,7.0,36091,5.0,12552,60,188644,7.0,13447,5.0,7531,1423,41926,15,462
321,10/31/2021,462,479628,48,233570,37,222211,1.0,34744,6.0,36097,7.0,12559,27,188671,1.0,13448,2.0,7533,373,42299,4,466
322,11/1/2021,1363,480991,149,233719,111,222322,3.0,34747,13.0,36110,9.0,12568,78,188749,7.0,13455,17.0,7550,1098,43397,17,483
323,11/2/2021,1844,482835,125,233844,106,222428,8.0,34755,15.0,36125,11.0,12579,77,188826,8.0,13463,10.0,7560,1612,45009,16,499
324,11/3/2021,1758,484593,157,234001,117,222545,9.0,34764,20.0,36145,10.0,12589,82,188908,6.0,13469,19.0,7579,1486,46495,17,516
325,11/4/2021,1423,486016,142,234143,91,222636,5.0,34769,14.0,36159,1.0,12590,74,188982,5.0,13474,11.0,7590,1210,47705,9,525
326,11/5/2021,2048,488064,233,234376,167,222803,12.0,34781,11.0,36170,11.0,12601,135,189117,8.0,13482,13.0,7603,1666,49371,15,540
327,11/6/2021,1594,489658,222,234598,77,222880,2.0,34783,8.0,36178,5.0,12606,63,189180,4.0,13486,5.0,7608,1287,50658,16,556
328,11/7/2021,534,490192,127,234725,42,222922,1.0,34784,8.0,36186,4.0,12610,31,189211,1.0,13487,6.0,7614,359,51017,7,563
329,11/8/2021,1531,491723,392,235117,109,223031,6.0,34790,9.0,36195,8.0,12618,87,189298,3.0,13490,11.0,7625,1042,52059,7,570
330,11/9/2021,2671,494394,949,236066,134,223165,5.0,34795,20.0,36215,12.0,12630,88,189386,9.0,13499,25.0,7650,1597,53656,13,583
331,11/10/2021,2522,496916,824,236890,116,223281,8.0,34803,16.0,36231,10.0,12640,86,189472,10.0,13509,10.0,7660,1582,55238,20,603
332,11/11/2021,2344,499260,954,237844,98,223379,6.0,34809,7.0,36238,11.0,12651,70,189542,11.0,13520,6.0,7666,1295,56533,19,622
333,11/12/2021,2590,501850,756,238600,142,223521,9.0,34818,20.0,36258,14.0,12665,108,189650,9.0,13529,11.0,7677,1682,58215,24,646
334,11/13/2021,1937,503787,404,239004,70,223591,2.0,34820,9.0,36267,4.0,12669,47,189697,7.0,13536,12.0,7689,1463,59678,9,655
335,11/14/2021,1492,505279,907,239911,57,223648,1.0,34821,2.0,36269,7.0,12676,35,189732,6.0,13542,9.0,7698,536,60214,2,657
336,11/15/2021,2001,507280,446,240357,101,223749,5.0,34826,10.0,36279,12.0,12688,69,189801,7.0,13549,13.0,7711,1460,61674,8,665
337,11/16/2021,2443,509723,446,240803,105,223854,3.0,34829,18.0,36297,16.0,12704,73,189874,7.0,13556,9.0,7720,1876,63550,29,694
338,11/17/2021,2754,512477,634,241437,130,223984,7.0,34836,19.0,36316,9.0,12713,105,189979,6.0,13562,10.0,7730,1978,65528,35,729
339,11/18/2021,2041,514518,388,241825,111,224095,6.0,34842,11.0,36327,10.0,12723,84,190063,11.0,13573,6.0,7736,1531,67059,27,756
340,11/19/2021,2592,517110,716,242541,155,224250,3.0,34845,16.0,36343,11.0,12734,124,190187,10.0,13583,10.0,7746,1715,68774,26,782
341,11/20/2021,1897,519007,538,243079,45,224295,2.0,34847,5.0,36348,4.0,12738,35,190222,2.0,13585,4.0,7750,1299,70073,19,801
342,11/21/2021,659,519666,121,243200,43,224338,0.0,34847,1.0,36349,2.0,12740,31,190253,3.0,13588,7.0,7757,490,70563,7,808
343,11/22/2021,2008,521674,424,243624,111,224449,7.0,34854,21.0,36370,1.0,12741,90,190343,7.0,13595,13.0,7770,1467,72030,25,833
344,11/23/2021,1880,523554,282,243906,92,224541,4.0,34858,16.0,36386,9.0,12750,68,190411,9.0,13604,6.0,7776,1501,73531,15,848
345,11/24/2021,1538,525092,214,244120,95,224636,5.0,34863,11.0,36397,10.0,12760,74,190485,5.0,13609,6.0,7782,1235,74766,9,857
346,11/25/2021,50,525142,9,244129,0,224636,0.0,34863,0.0,36397,0.0,12760,0,190485,0.0,13609,,7782,39,74805,2,859
347,11/26/2021,1276,526418,192,244321,143,224779,2.0,34865,5.0,36402,14.0,12774,111,190596,12.0,13621,6.0,7788,953,75758,6,865
348,11/27/2021,976,527394,136,244457,126,224905,2.0,34867,2.0,36404,9.0,12783,104,190700,7.0,13628,6.0,7794,713,76471,7,872
349,11/28/2021,548,527942,88,244545,84,224989,2.0,34869,1.0,36405,6.0,12789,67,190767,5.0,13633,6.0,7800,374,76845,5,877
350,11/29/2021,1899,529841,258,244803,345,225334,7.0,34876,14.0,36419,25.0,12814,284,191051,24.0,13657,12.0,7812,1291,78136,16,893
351,11/30/2021,2720,532561,341,245144,716,226050,2.0,34878,12.0,36431,46.0,12860,608,191659,49.0,13706,13.0,7825,1647,79783,33,926
352,12/1/2021,2560,535121,272,245416,660,226710,6.0,34884,12.0,36443,28.0,12888,575,192234,52.0,13758,5.0,7830,1612,81395,30,956
353,12/2/2021,2866,537987,353,245769,835,227545,6.0,34890,15.0,36458,64.0,12952,679,192913,69.0,13827,23.0,7853,1664,83059,33,989
354,12/3/2021,2627,540614,275,246044,680,228225,9.0,34899,4.0,36462,57.0,13009,534,193447,66.0,13893,23.0,7876,1675,84734,13,1002
355,12/4/2021,2206,542820,160,246204,356,228581,3.0,34902,1.0,36463,18.0,13027,278,193725,30.0,13923,30.0,7906,1687,86421,8,1010
356,12/5/2021,1392,544212,97,246301,815,229396,1.0,34903,0.0,36463,65.0,13092,648,194373,72.0,13995,30.0,7936,483,86904,4,1014
357,12/6/2021,1970,546182,238,246539,390,229786,5.0,34908,6.0,36469,49.0,13141,298,194671,29.0,14024,14.0,7950,1343,88247,12,1026
358,12/7/2021,2479,548661,305,246844,374,230160,6.0,34914,8.0,36477,42.0,13183,293,194964,23.0,14047,16.0,7966,1797,90044,19,1045
359,12/8/2021,2264,550925,266,247110,437,230597,5.0,34919,12.0,36489,32.0,13215,359,195323,35.0,14082,11.0,7977,1568,91612,10,1055
360,12/9/2021,2197,553122,301,247411,401,230998,1.0,34920,8.0,36497,26.0,13241,306,195629,36.0,14118,33.0,8010,1490,93102,15,1070
361,12/10/2021,2117,555239,233,247644,332,231330,7.0,34927,8.0,36505,33.0,13274,250,195879,28.0,14146,21.0,8031,1543,94645,17,1087
362,12/11/2021,1794,557033,134,247778,455,231785,3.0,34930,1.0,36506,61.0,13335,333,196212,37.0,14183,24.0,8055,1198,95843,7,1094
363,12/12/2021,428,557461,55,247833,62,231847,1.0,34931,3.0,36509,4.0,13339,45,196257,7.0,14190,6.0,8061,311,96154,2,1096
364,12/13/2021,1769,559230,293,248126,346,232193,3.0,34934,7.0,36516,26.0,13365,277,196534,31.0,14221,12.0,8073,1139,97293,9,1105
365,12/14/2021,2222,561452,271,248397,259,232452,5.0,34939,4.0,36520,26.0,13391,204,196738,14.0,14235,15.0,8088,1691,98984,23,1128
366,12/15/2021,1763,563215,199,248596,153,232605,2.0,34941,4.0,36524,8.0,13399,120,196858,13.0,14248,12.0,8100,1413,100397,12,1140
367,12/16/2021,1838,565053,321,248917,171,232776,3.0,34944,7.0,36531,17.0,13416,139,196997,9.0,14257,6.0,8106,1339,101736,22,1162
368,12/17/2021,2139,567192,303,249220,350,233126,3.0,34947,10.0,36541,26.0,13442,278,197275,36.0,14293,10.0,8116,1476,103212,21,1183
369,12/18/2021,1829,569021,174,249394,178,233304,3.0,34950,4.0,36545,17.0,13459,148,197423,6.0,14299,7.0,8123,1455,104667,22,1205
370,12/19/2021,448,569469,41,249435,49,233353,1.0,34951,3.0,36548,5.0,13464,37,197460,3.0,14302,4.0,8127,356,105023,2,1207
371,12/20/2021,1601,571070,200,249635,178,233531,3.0,34954,9.0,36557,27.0,13491,131,197591,10.0,14312,10.0,8137,1217,106240,13,1220
372,12/21/2021,2232,573302,306,249941,173,233704,6.0,34960,8.0,36565,27.0,13518,118,197709,15.0,14327,13.0,8150,1745,107985,18,1238
373,12/22/2021,1904,575206,217,250158,198,233902,4.0,34964,9.0,36574,26.0,13544,148,197857,17.0,14344,7.0,8157,1476,109461,18,1256
374,12/23/2021,1277,576483,215,250373,146,234048,2.0,34966,4.0,36578,21.0,13565,98,197955,14.0,14358,13.0,8170,916,110377,12,1268
375,12/24/2021,326,576809,43,250416,49,234097,2.0,34968,2.0,36580,3.0,13568,41,197996,4.0,14362,1.0,8171,235,110612,1,1269
376,12/25/2021,16,576825,4,250420,2,234099,1.0,34969,0.0,36580,,13568,2,197998,0.0,14362,,8171,10,110622,0,1269
377,12/26/2021,358,577183,57,250477,57,234156,1.0,34970,0.0,36580,8.0,13576,41,198039,5.0,14367,3.0,8174,243,110865,4,1273
378,12/27/2021,1299,578482,183,250660,163,234319,4.0,34974,5.0,36585,17.0,13593,124,198163,15.0,14382,7.0,8181,943,111808,17,1290
379,12/28/2021,1931,580413,275,250935,200,234519,6.0,34980,12.0,36597,30.0,13623,140,198303,15.0,14397,15.0,8196,1441,113249,19,1309
380,12/29/2021,1730,582143,212,251147,177,234696,3.0,34983,7.0,36604,27.0,13650,127,198430,14.0,14411,9.0,8205,1336,114585,18,1327
381,12/30/2021,1402,583545,221,251368,169,234865,3.0,34986,8.0,36612,22.0,13672,126,198556,12.0,14423,9.0,8214,1006,115591,13,1340
382,12/31/2021,517,584062,93,251461,53,234918,0.0,34986,2.0,36614,6.0,13678,40,198596,3.0,14426,4.0,8218,363,115954,9,1349
383,1/1/2022,93,584155,11,251472,12,234930,0.0,34986,0.0,36614,0.0,13678,10,198606,1.0,14427,1.0,8219,66,116020,2,1351
384,1/2/2022,321,584476,46,251518,38,234968,0.0,34986,1.0,36615,7.0,13685,24,198630,7.0,14434,0.0,8219,237,116257,1,1352
385,1/3/2022,1621,586097,327,251845,291,235259,3.0,34989,5.0,36620,30.0,13715,233,198863,20.0,14454,8.0,8227,994,117251,17,1369
386,1/4/2022,1704,587801,262,252107,195,235454,7.0,34996,6.0,36626,27.0,13742,146,199009,13.0,14467,9.0,8236,1241,118492,17,1386
387,1/5/2022,1342,589143,199,252306,114,235568,2.0,34998,8.0,36634,8.0,13750,90,199099,6.0,14473,10.0,8246,1027,119519,13,1399
388,1/6/2022,1255,590398,255,252561,176,235744,2.0,35000,5.0,36639,24.0,13774,124,199223,7.0,14480,21.0,8267,820,120339,12,1411
389,1/7/2022,2073,592471,252,252813,242,235986,5.0,35005,8.0,36647,30.0,13804,180,199403,22.0,14502,10.0,8277,1575,121914,15,1426
390,1/8/2022,1598,594069,123,252936,89,236075,1.0,35006,3.0,36650,6.0,13810,70,199473,6.0,14508,7.0,8284,1368,123282,18,1444
391,1/9/2022,506,594575,91,253027,57,236132,0.0,35006,2.0,36652,14.0,13824,34,199507,3.0,14511,6.0,8290,353,123635,5,1449
392,1/10/2022,1571,596146,288,253315,131,236263,2.0,35008,6.0,36658,13.0,13837,98,199605,12.0,14523,8.0,8298,1147,124782,15,1464
393,1/11/2022,1595,597741,228,253543,194,236457,2.0,35010,4.0,36662,26.0,13863,145,199750,8.0,14531,15.0,8313,1167,125949,20,1484
394,1/12/2022,1402,599143,173,253716,105,236562,1.0,35011,5.0,36667,21.0,13884,64,199814,14.0,14545,6.0,8319,1117,127066,15,1499
395,1/13/2022,1117,600260,197,253913,124,236686,3.0,35014,3.0,36670,10.0,13894,86,199900,15.0,14560,13.0,8332,794,127860,8,1507
396,1/14/2022,1642,601902,270,254183,136,236822,1.0,35015,8.0,36678,20.0,13914,92,199992,17.0,14577,7.0,8339,1227,129087,21,1528
397,1/15/2022,1227,603129,138,254321,67,236889,0.0,35015,2.0,36680,6.0,13920,53,200045,7.0,14584,1.0,8340,1007,130094,15,1543
398,1/16/2022,292,603421,46,254367,25,236914,1.0,35016,0.0,36680,1.0,13921,20,200065,4.0,14588,0.0,8340,218,130312,2,1545
399,1/17/2022,804,604225,160,254527,92,237006,2.0,35018,5.0,36685,11.0,13932,70,200135,8.0,14596,3.0,8343,542,130854,12,1557
400,1/18/2022,889,605114,155,254682,115,237121,2.0,35020,4.0,36689,22.0,13954,83,200218,4.0,14600,6.0,8349,611,131465,16,1573
401,1/19/2022,774,605888,127,254809,91,237212,4.0,35024,7.0,36696,9.0,13963,65,200283,6.0,14606,11.0,8360,554,132019,12,1585
402,1/20/2022,837,606725,148,254957,125,237337,0.0,35024,9.0,36705,16.0,13979,89,200372,9.0,14615,11.0,8371,563,132582,7,1592
403,1/21/2022,1228,607953,174,255131,107,237444,2.0,35026,2.0,36707,11.0,13990,77,200449,7.0,14622,12.0,8383,942,133524,10,1602
404,1/22/2022,830,608783,91,255222,71,237515,0.0,35026,1.0,36708,12.0,14002,48,200497,4.0,14626,7.0,8390,642,134166,23,1625
405,1/23/2022,236,609019,29,255251,38,237553,1.0,35027,0.0,36708,4.0,14006,27,200524,7.0,14633,0.0,8390,169,134335,1,1626
406,1/24/2022,537,609556,85,255336,96,237649,1.0,35028,1.0,36709,14.0,14020,68,200592,8.0,14641,6.0,8396,351,134686,8,1634
407,1/25/2022,675,610231,116,255452,119,237768,3.0,35031,2.0,36711,11.0,14031,81,200673,20.0,14661,7.0,8403,424,135110,17,1651
408,1/26/2022,656,610887,105,255557,107,237875,5.0,35036,3.0,36714,11.0,14042,78,200751,11.0,14672,7.0,8410,440,135550,9,1660
409,1/27/2022,630,611517,115,255672,145,238020,3.0,35039,1.0,36715,26.0,14068,105,200856,7.0,14679,7.0,8417,360,135910,14,1674
410,1/28/2022,979,612496,162,255834,127,238147,4.0,35043,6.0,36721,18.0,14086,79,200935,13.0,14692,17.0,8434,671,136581,24,1698
411,1/29/2022,562,613058,63,255897,71,238218,1.0,35044,3.0,36724,9.0,14095,51,200986,8.0,14700,3.0,8437,418,136999,9,1707
412,1/30/2022,198,613256,33,255930,42,238260,1.0,35045,1.0,36725,15.0,14110,23,201009,1.0,14701,3.0,8440,123,137122,2,1709
413,1/31/2022,562,613818,133,256063,94,238354,3.0,35048,1.0,36726,14.0,14124,62,201071,9.0,14710,9.0,8449,324,137446,14,1723
414,2/1/2022,580,614398,99,256162,117,238471,1.0,35049,3.0,36729,22.0,14146,82,201153,10.0,14720,3.0,8452,338,137784,26,1749
415,2/2/2022,131,614529,20,256182,35,238506,0.0,35049,1.0,36730,2.0,14148,30,201183,2.0,14722,1.0,8453,77,137861,2,1751
416,2/3/2022,382,614911,77,256259,110,238616,1.0,35050,3.0,36733,23.0,14171,75,201258,6.0,14728,6.0,8459,192,138053,7,1758
417,2/4/2022,647,615558,113,256372,132,238748,7.0,35057,5.0,36738,18.0,14189,105,201363,4.0,14732,5.0,8464,360,138413,44,1802
418,2/5/2022,459,616017,59,256431,99,238847,2.0,35059,0.0,36738,7.0,14196,78,201441,5.0,14737,9.0,8473,281,138694,21,1823
419,2/6/2022,124,616141,20,256451,22,238869,0.0,35059,1.0,36739,1.0,14197,12,201453,6.0,14743,3.0,8476,78,138772,4,1827
420,2/7/2022,364,616505,62,256513,92,238961,1.0,35060,0.0,36739,10.0,14207,71,201524,4.0,14747,7.0,8483,204,138976,8,1835
421,2/8/2022,453,616958,86,256599,105,239066,2.0,35062,4.0,36743,20.0,14227,73,201597,5.0,14752,7.0,8490,231,139207,39,1874
422,2/9/2022,356,617314,61,256660,78,239144,3.0,35065,1.0,36744,16.0,14243,48,201645,3.0,14755,11.0,8501,204,139411,15,1889
423,2/10/2022,383,617697,85,256745,77,239221,2.0,35067,3.0,36747,15.0,14258,50,201695,6.0,14761,6.0,8507,211,139622,9,1898
424,2/11/2022,553,618250,83,256828,150,239371,3.0,35070,1.0,36748,27.0,14285,100,201795,9.0,14770,14.0,8521,291,139913,34,1932
425,2/12/2022,256,618506,41,256869,46,239417,1.0,35071,0.0,36748,5.0,14290,34,201829,5.0,14775,2.0,8523,154,140067,17,1949
426,2/13/2022,80,618586,18,256887,19,239436,0.0,35071,0.0,36748,0.0,14290,13,201842,4.0,14779,2.0,8525,40,140107,5,1954
427,2/14/2022,241,618827,38,256925,45,239481,2.0,35073,2.0,36750,10.0,14300,29,201871,2.0,14781,4.0,8529,150,140257,9,1963
428,2/15/2022,318,619145,49,256974,85,239566,0.0,35073,0.0,36750,15.0,14315,56,201927,6.0,14787,8.0,8537,153,140410,34,1997
429,2/16/2022,229,619374,40,257014,61,239627,3.0,35076,1.0,36751,12.0,14327,41,201968,5.0,14792,3.0,8540,107,140517,24,2021
430,2/17/2022,172,619546,30,257044,41,239668,0.0,35076,0.0,36751,8.0,14335,28,201996,4.0,14796,1.0,8541,91,140608,11,2032
431,2/18/2022,496,620042,105,257149,97,239765,1.0,35077,3.0,36754,14.0,14349,58,202054,14.0,14810,11.0,8552,265,140873,28,2060
432,2/19/2022,217,620259,25,257174,54,239819,0.0,35077,0.0,36754,9.0,14358,37,202091,2.0,14812,6.0,8558,121,140994,18,2078
433,2/20/2022,76,620335,17,257191,16,239835,0.0,35077,0.0,36754,0.0,14358,14,202105,0.0,14812,2.0,8560,38,141032,5,2083
434,2/21/2022,251,620586,56,257247,72,239907,2.0,35079,1.0,36755,16.0,14374,45,202150,4.0,14816,7.0,8567,117,141149,9,2092
435,2/22/2022,269,620855,48,257295,74,239981,5.0,35084,0.0,36755,6.0,14380,56,202206,4.0,14820,8.0,8575,122,141271,28,2120
436,2/23/2022,216,621071,45,257340,42,240023,1.0,35085,0.0,36755,4.0,14384,30,202236,4.0,14824,4.0,8579,117,141388,12,2132
437,2/24/2022,203,621274,32,257372,42,240065,0.0,35085,1.0,36756,8.0,14392,27,202263,1.0,14825,6.0,8585,118,141506,13,2145
438,2/25/2022,318,621592,54,257426,96,240161,2.0,35087,1.0,36757,13.0,14405,63,202326,12.0,14837,8.0,8593,147,141653,23,2168
439,2/26/2022,184,621776,25,257451,41,240202,1.0,35088,1.0,36758,2.0,14407,29,202355,6.0,14843,4.0,8597,107,141760,11,2179
440,2/27/2022,75,621851,16,257467,13,240215,0.0,35088,1.0,36759,0.0,14407,11,202366,1.0,14844,1.0,8598,44,141804,2,2181
441,2/28/2022,183,622034,48,257515,37,240252,0.0,35088,0.0,36759,8.0,14415,18,202384,5.0,14849,6.0,8604,85,141889,13,2194
442,3/1/2022,217,622251,33,257548,48,240300,4.0,35092,2.0,36761,3.0,14418,43,202427,2.0,14851,0.0,8604,105,141994,35,2229
443,3/2/2022,151,622402,27,257575,36,240336,2.0,35094,0.0,36761,4.0,14422,21,202448,6.0,14857,5.0,8609,78,142072,12,2241
444,3/3/2022,175,622577,35,257610,42,240378,3.0,35097,2.0,36763,10.0,14432,27,202475,3.0,14860,2.0,8611,91,142163,8,2249
445,3/4/2022,340,622917,52,257662,73,240451,5.0,35102,5.0,36768,13.0,14445,51,202526,4.0,14864,5.0,8616,179,142342,41,2290
446,3/5/2022,124,623041,21,257683,19,240470,0.0,35102,0.0,36768,5.0,14450,13,202539,1.0,14865,0.0,8616,72,142414,12,2302
447,3/6/2022,75,623116,28,257711,20,240490,0.0,35102,0.0,36768,2.0,14452,15,202554,1.0,14866,2.0,8618,25,142439,2,2304
448,3/7/2022,151,623267,26,257737,28,240518,1.0,35103,0.0,36768,9.0,14461,14,202568,2.0,14868,3.0,8621,88,142527,9,2313
449,3/8/2022,212,623479,32,257769,36,240554,0.0,35103,2.0,36770,5.0,14466,23,202591,3.0,14871,5.0,8626,106,142633,37,2350
450,3/9/2022,101,623580,13,257782,21,240575,3.0,35106,3.0,36773,3.0,14469,17,202608,0.0,14871,1.0,8627,62,142695,6,2356
451,3/10/2022,103,623683,27,257809,26,240601,1.0,35107,0.0,36773,2.0,14471,19,202627,2.0,14873,3.0,8630,48,142743,3,2359
452,3/11/2022,241,623924,38,257847,77,240678,5.0,35112,1.0,36774,15.0,14486,48,202675,8.0,14881,6.0,8636,92,142835,36,2395
453,3/12/2022,134,624058,26,257873,31,240709,1.0,35113,1.0,36775,3.0,14489,25,202700,1.0,14882,2.0,8638,63,142898,14,2409
454,3/13/2022,46,624104,6,257879,8,240717,0.0,35113,0.0,36775,0.0,14489,6,202706,2.0,14884,0.0,8638,30,142928,3,2412
455,3/14/2022,125,624229,14,257893,39,240756,0.0,35113,0.0,36775,7.0,14496,23,202729,8.0,14892,1.0,8639,64,142992,8,2420
456,3/15/2022,165,624394,30,257923,21,240777,0.0,35113,2.0,36777,4.0,14500,11,202740,4.0,14896,2.0,8641,76,143068,40,2460
457,3/16/2022,136,624530,32,257955,29,240806,0.0,35113,1.0,36778,2.0,14502,21,202761,3.0,14899,3.0,8644,67,143135,11,2471
458,3/17/2022,102,624632,20,257975,12,240818,1.0,35114,0.0,36778,1.0,14503,7,202768,2.0,14901,2.0,8646,60,143195,9,2480
459,3/18/2022,265,624897,21,257996,38,240856,1.0,35115,1.0,36779,2.0,14505,28,202796,6.0,14907,2.0,8648,119,143314,87,2567
460,3/19/2022,113,625010,7,258003,16,240872,0.0,35115,0.0,36779,3.0,14508,9,202805,2.0,14909,2.0,8650,58,143372,32,2599
461,3/20/2022,46,625056,5,258008,8,240880,0.0,35115,0.0,36779,,14508,8,202813,0.0,14909,0.0,8650,24,143396,9,2608
462,3/21/2022,114,625170,14,258022,32,240912,0.0,35115,1.0,36780,5.0,14513,16,202829,6.0,14915,5.0,8655,62,143458,7,2615
463,3/22/2022,164,625334,18,258040,19,240931,1.0,35116,2.0,36782,1.0,14514,16,202845,1.0,14916,1.0,8656,64,143522,64,2679
464,3/23/2022,117,625451,14,258054,25,240956,0.0,35116,0.0,36782,4.0,14518,15,202860,4.0,14920,2.0,8658,62,143584,17,2696
465,3/24/2022,119,625570,21,258075,23,240979,0.0,35116,2.0,36784,4.0,14522,17,202877,1.0,14921,1.0,8659,69,143653,7,2703
466,3/25/2022,213,625783,27,258102,32,241011,0.0,35116,1.0,36785,6.0,14528,21,202898,2.0,14923,3.0,8662,105,143758,49,2752
467,3/26/2022,100,625883,7,258109,12,241023,0.0,35116,0.0,36785,0.0,14528,11,202909,1.0,14924,0.0,8662,42,143800,37,2789
468,3/27/2022,30,625913,8,258117,4,241027,0.0,35116,0.0,36785,0.0,14528,3,202912,0.0,14924,1.0,8663,15,143815,3,2792
469,3/28/2022,96,626009,22,258139,15,241042,0.0,35116,1.0,36786,1.0,14529,12,202924,2.0,14926,0.0,8663,48,143863,11,2803
470,3/29/2022,244,626253,20,258159,20,241062,2.0,35118,0.0,36786,1.0,14530,14,202938,0.0,14926,5.0,8668,67,143930,138,2941
471,3/30/2022,382,626635,29,258188,24,241086,4.0,35122,4.0,36790,3.0,14533,18,202956,2.0,14928,1.0,8669,65,143995,263,3204
472,3/31/2022,597,627232,32,258220,41,241127,4.0,35126,1.0,36791,4.0,14537,32,202988,2.0,14930,3.0,8672,89,144084,436,3640
473,4/1/2022,860,628092,34,258254,38,241165,4.0,35130,3.0,36794,5.0,14542,28,203016,2.0,14932,3.0,8675,92,144176,692,4332
474,4/2/2022,652,628744,15,258269,25,241190,4.0,35134,1.0,36795,1.0,14543,21,203037,0.0,14932,3.0,8678,61,144237,551,4883
475,4/3/2022,146,628890,6,258275,7,241197,1.0,35135,1.0,36796,0.0,14543,5,203042,2.0,14934,0.0,8678,19,144256,114,4997
476,4/4/2022,493,629383,19,258294,25,241222,6.0,35141,2.0,36798,2.0,14545,21,203063,1.0,14935,1.0,8679,65,144321,384,5381
477,4/5/2022,869,630252,36,258330,29,241251,1.0,35142,5.0,36803,4.0,14549,22,203085,1.0,14936,2.0,8681,59,144380,745,6126
478,4/6/2022,515,630767,25,258355,31,241282,6.0,35148,5.0,36808,0.0,14549,28,203113,1.0,14937,2.0,8683,46,144426,416,6542
479,4/7/2022,643,631410,30,258385,22,241304,3.0,35151,6.0,36814,2.0,14551,13,203126,3.0,14940,4.0,8687,59,144485,534,7076
480,4/8/2022,1132,632542,47,258432,42,241346,6.0,35157,8.0,36822,5.0,14556,31,203157,3.0,14943,3.0,8690,96,144581,941,8017
481,4/9/2022,680,633222,35,258467,16,241362,4.0,35161,4.0,36826,3.0,14559,10,203167,2.0,14945,1.0,8691,42,144623,585,8602
482,4/10/2022,190,633412,14,258481,7,241369,2.0,35163,1.0,36827,0.0,14559,7,203174,0.0,14945,0.0,8691,33,144656,135,8737
483,4/11/2022,633,634045,20,258501,29,241398,2.0,35165,3.0,36830,3.0,14562,20,203194,3.0,14948,3.0,8694,55,144711,527,9264
484,4/12/2022,858,634903,29,258530,29,241427,9.0,35174,5.0,36835,4.0,14566,22,203216,3.0,14951,0.0,8694,61,144772,737,10001
485,4/13/2022,668,635571,31,258561,24,241451,5.0,35179,6.0,36841,0.0,14566,22,203238,1.0,14952,1.0,8695,63,144835,549,10550
486,4/14/2022,602,636173,25,258586,23,241474,4.0,35183,0.0,36841,4.0,14570,13,203251,2.0,14954,4.0,8699,94,144929,464,11014
487,4/15/2022,931,637104,40,258626,45,241519,5.0,35188,4.0,36845,10.0,14580,31,203282,3.0,14957,1.0,8700,91,145020,753,11767
488,4/16/2022,499,637603,18,258644,17,241536,2.0,35190,0.0,36845,2.0,14582,13,203295,2.0,14959,0.0,8700,38,145058,426,12193
489,4/17/2022,70,637673,8,258652,5,241541,2.0,35192,1.0,36846,0.0,14582,4,203299,0.0,14959,1.0,8701,12,145070,45,12238
490,4/18/2022,561,638234,39,258691,25,241566,9.0,35201,5.0,36851,3.0,14585,20,203319,1.0,14960,1.0,8702,61,145131,437,12675
491,4/19/2022,801,639035,42,258733,31,241597,10.0,35211,9.0,36860,2.0,14587,25,203344,3.0,14963,1.0,8703,80,145211,650,13325
492,4/20/2022,482,639517,21,258754,25,241622,3.0,35214,3.0,36863,6.0,14593,17,203361,2.0,14965,0.0,8703,50,145261,387,13712
493,4/21/2022,470,639987,21,258775,32,241654,8.0,35222,2.0,36865,2.0,14595,25,203386,3.0,14968,2.0,8705,44,145305,376,14088
494,4/22/2022,702,640689,25,258800,37,241691,2.0,35224,3.0,36868,4.0,14599,30,203416,3.0,14971,0.0,8705,66,145371,573,14661
495,4/23/2022,624,641313,21,258821,25,241716,9.0,35233,3.0,36871,1.0,14600,20,203436,2.0,14973,2.0,8707,62,145433,517,15178
496,4/24/2022,109,641422,8,258829,6,241722,0.0,35233,2.0,36873,0.0,14600,5,203441,0.0,14973,1.0,8708,21,145454,74,15252
497,4/25/2022,394,641816,27,258856,17,241739,4.0,35237,4.0,36877,4.0,14604,11,203452,0.0,14973,2.0,8710,48,145502,302,15554
498,4/26/2022,556,642372,26,258882,25,241764,3.0,35240,3.0,36880,2.0,14606,18,203470,2.0,14975,3.0,8713,74,145576,430,15984
499,4/27/2022,471,642843,21,258903,23,241787,8.0,35248,4.0,36884,2.0,14608,15,203485,2.0,14977,4.0,8717,65,145641,362,16346
500,4/28/2022,472,643315,32,258935,28,241815,7.0,35255,4.0,36888,3.0,14611,20,203505,2.0,14979,3.0,8720,45,145686,368,16714
501,4/29/2022,761,644076,29,258964,34,241849,4.0,35259,2.0,36890,6.0,14617,24,203529,2.0,14981,2.0,8722,69,145755,626,17340
502,4/30/2022,391,644467,6,258970,19,241868,1.0,35260,0.0,36890,1.0,14618,18,203547,0.0,14981,0.0,8722,45,145800,321,17661
503,5/1/2022,105,644572,12,258982,12,241880,0.0,35260,2.0,36892,1.0,14619,9,203556,0.0,14981,2.0,8724,17,145817,64,17725
504,5/2/2022,381,644953,19,259001,19,241899,0.0,35260,5.0,36897,2.0,14621,13,203569,2.0,14983,2.0,8726,58,145875,287,18012
505,5/3/2022,653,645606,30,259031,30,241929,5.0,35265,6.0,36903,3.0,14624,25,203594,2.0,14985,0.0,8726,75,145950,521,18533
506,5/4/2022,519,646125,24,259055,27,241956,4.0,35269,5.0,36908,4.0,14628,19,203613,2.0,14987,2.0,8728,64,146014,399,18932
507,5/5/2022,404,646529,18,259073,20,241976,3.0,35272,3.0,36911,2.0,14630,14,203627,3.0,14990,1.0,8729,50,146064,316,19248
508,5/6/2022,621,647150,33,259106,35,242011,3.0,35275,2.0,36913,5.0,14635,27,203654,2.0,14992,1.0,8730,65,146129,484,19732
509,5/7/2022,374,647524,17,259123,22,242033,1.0,35276,1.0,36914,2.0,14637,17,203671,1.0,14993,2.0,8732,42,146171,292,20024
510,5/8/2022,73,647597,4,259127,7,242040,0.0,35276,0.0,36914,0.0,14637,4,203675,1.0,14994,2.0,8734,14,146185,48,20072
511,5/9/2022,403,648000,26,259153,16,242056,3.0,35279,1.0,36915,1.0,14638,11,203686,2.0,14996,2.0,8736,55,146240,305,20377
512,5/10/2022,599,648599,27,259180,34,242090,13.0,35292,4.0,36919,3.0,14641,25,203711,2.0,14998,4.0,8740,80,146320,455,20832
513,5/11/2022,399,648998,29,259209,26,242116,8.0,35300,4.0,36923,6.0,14647,13,203724,3.0,15001,4.0,8744,33,146353,311,21143
514,5/12/2022,335,649333,18,259227,20,242136,3.0,35303,2.0,36925,0.0,14647,18,203742,2.0,15003,0.0,8744,49,146402,247,21390
515,5/13/2022,654,649987,23,259250,39,242175,6.0,35309,3.0,36928,4.0,14651,27,203769,2.0,15005,6.0,8750,87,146489,502,21892
516,5/14/2022,384,650371,17,259267,12,242187,1.0,35310,3.0,36931,1.0,14652,10,203779,1.0,15006,0.0,8750,33,146522,321,22213
517,5/15/2022,126,650497,6,259273,4,242191,0.0,35310,0.0,36931,0.0,14652,4,203783,0.0,15006,0.0,8750,17,146539,98,22311
518,5/16/2022,452,650949,25,259298,24,242215,0.0,35310,1.0,36932,5.0,14657,16,203799,1.0,15007,2.0,8752,74,146613,326,22637
519,5/17/2022,526,651475,25,259323,24,242239,7.0,35317,4.0,36936,0.0,14657,20,203819,0.0,15007,4.0,8756,66,146679,410,23047
520,5/18/2022,324,651799,11,259334,17,242256,5.0,35322,0.0,36936,4.0,14661,12,203831,0.0,15007,1.0,8757,40,146719,253,23300
521,5/19/2022,478,652277,26,259360,25,242281,3.0,35325,4.0,36940,5.0,14666,18,203849,0.0,15007,2.0,8759,55,146774,368,23668
522,5/20/2022,727,653004,22,259382,33,242314,5.0,35330,4.0,36944,3.0,14669,27,203876,2.0,15009,1.0,8760,110,146884,561,24229
523,5/21/2022,485,653489,20,259402,13,242327,3.0,35333,4.0,36948,0.0,14669,12,203888,1.0,15010,0.0,8760,68,146952,383,24612
524,5/22/2022,173,653662,6,259408,5,242332,1.0,35334,0.0,36948,0.0,14669,3,203891,2.0,15012,0.0,8760,36,146988,124,24736
525,5/23/2022,534,654196,24,259432,18,242350,1.0,35335,2.0,36950,1.0,14670,15,203906,0.0,15012,2.0,8762,113,147101,379,25115
526,5/24/2022,603,654799,48,259480,25,242375,5.0,35340,6.0,36956,2.0,14672,16,203922,0.0,15012,7.0,8769,84,147185,449,25564
527,5/25/2022,431,655230,23,259503,20,242395,3.0,35343,6.0,36962,0.0,14672,13,203935,6.0,15018,1.0,8770,72,147257,313,25877
528,5/26/2022,432,655662,19,259522,22,242417,4.0,35347,6.0,36968,2.0,14674,16,203951,1.0,15019,3.0,8773,101,147358,291,26168
529,5/27/2022,891,656553,24,259546,39,242456,7.0,35354,3.0,36971,5.0,14679,29,203980,3.0,15022,2.0,8775,168,147526,657,26825
530,5/28/2022,313,656866,10,259556,12,242468,1.0,35355,0.0,36971,0.0,14679,11,203991,0.0,15022,1.0,8776,29,147555,259,27084
531,5/29/2022,141,657007,4,259560,7,242475,0.0,35355,2.0,36973,1.0,14680,6,203997,0.0,15022,0.0,8776,40,147595,88,27172
532,5/30/2022,31,657038,1,259561,0,242475,0.0,35355,0.0,36973,0.0,14680,0,203997,0.0,15022,,8776,3,147598,27,27199
533,5/31/2022,815,657853,28,259589,28,242503,8.0,35363,6.0,36979,2.0,14682,22,204019,3.0,15025,1.0,8777,116,147714,641,27840
534,6/1/2022,598,658451,31,259620,22,242525,6.0,35369,3.0,36982,1.0,14683,18,204037,2.0,15027,1.0,8778,88,147802,456,28296
535,6/2/2022,683,659134,21,259641,30,242555,4.0,35373,0.0,36982,4.0,14687,22,204059,2.0,15029,2.0,8780,80,147882,550,28846
536,6/3/2022,979,660113,30,259671,25,242580,6.0,35379,6.0,36988,3.0,14690,20,204079,2.0,15031,0.0,8780,120,148002,802,29648
537,6/4/2022,695,660808,20,259691,26,242606,5.0,35384,1.0,36989,1.0,14691,25,204104,0.0,15031,0.0,8780,66,148068,579,30227
538,6/5/2022,133,660941,4,259695,5,242611,0.0,35384,0.0,36989,1.0,14692,3,204107,1.0,15032,0.0,8780,19,148087,105,30332
539,6/6/2022,578,661519,23,259718,25,242636,2.0,35386,1.0,36990,5.0,14697,19,204126,0.0,15032,1.0,8781,66,148153,460,30792
540,6/7/2022,780,662299,31,259749,38,242674,5.0,35391,3.0,36993,5.0,14702,31,204157,1.0,15033,1.0,8782,123,148276,583,31375
541,6/8/2022,395,662694,27,259776,19,242693,2.0,35393,2.0,36995,1.0,14703,15,204172,0.0,15033,3.0,8785,54,148330,293,31668
542,6/9/2022,455,663149,16,259792,15,242708,4.0,35397,1.0,36996,3.0,14706,12,204184,0.0,15033,0.0,8785,72,148402,352,32020
543,6/10/2022,737,663886,25,259817,37,242745,1.0,35398,1.0,36997,3.0,14709,30,204214,2.0,15035,2.0,8787,108,148510,566,32586
544,6/11/2022,373,664259,11,259828,15,242760,2.0,35400,2.0,36999,0.0,14709,11,204225,2.0,15037,2.0,8789,58,148568,288,32874
545,6/12/2022,130,664389,4,259832,2,242762,1.0,35401,0.0,36999,1.0,14710,1,204226,0.0,15037,0.0,8789,28,148596,95,32969
546,6/13/2022,505,664894,20,259852,35,242797,3.0,35404,1.0,37000,3.0,14713,25,204251,3.0,15040,4.0,8793,85,148681,363,33332
547,6/14/2022,577,665471,32,259884,26,242823,4.0,35408,4.0,37004,2.0,14715,20,204271,2.0,15042,2.0,8795,100,148781,417,33749
548,6/15/2022,365,665836,15,259899,24,242847,2.0,35410,3.0,37007,4.0,14719,17,204288,1.0,15043,2.0,8797,70,148851,253,34002
549,6/16/2022,379,666215,12,259911,20,242867,8.0,35418,2.0,37009,0.0,14719,18,204306,1.0,15044,1.0,8798,64,148915,278,34280
550,6/17/2022,693,666908,33,259944,16,242883,3.0,35421,6.0,37015,1.0,14720,13,204319,1.0,15045,1.0,8799,91,149006,546,34826
551,6/18/2022,332,667240,7,259951,13,242896,3.0,35424,1.0,37016,0.0,14720,10,204329,1.0,15046,2.0,8801,46,149052,265,35091
552,6/19/2022,55,667295,2,259953,2,242898,0.0,35424,0.0,37016,0.0,14720,2,204331,0.0,15046,0.0,8801,13,149065,38,35129
553,6/20/2022,402,667697,28,259981,21,242919,5.0,35429,7.0,37023,2.0,14722,17,204348,2.0,15048,0.0,8801,75,149140,278,35407
554,6/21/2022,440,668137,24,260005,18,242937,1.0,35430,5.0,37028,0.0,14722,15,204363,0.0,15048,3.0,8804,81,149221,316,35723
555,6/22/2022,319,668456,44,260049,11,242948,0.0,35430,1.0,37029,1.0,14723,8,204371,1.0,15049,1.0,8805,65,149286,196,35919
556,6/23/2022,388,668844,102,260151,19,242967,4.0,35434,3.0,37032,2.0,14725,13,204384,0.0,15049,4.0,8809,58,149344,208,36127
557,6/24/2022,502,669346,107,260258,32,242999,0.0,35434,0.0,37032,3.0,14728,23,204407,5.0,15054,1.0,8810,69,149413,290,36417
558,6/25/2022,289,669635,32,260290,12,243011,0.0,35434,1.0,37033,1.0,14729,11,204418,0.0,15054,0.0,8810,46,149459,196,36613
559,6/26/2022,79,669714,14,260304,5,243016,0.0,35434,0.0,37033,0.0,14729,1,204419,4.0,15058,0.0,8810,17,149476,43,36656
560,6/27/2022,292,670006,77,260381,15,243031,4.0,35438,4.0,37037,1.0,14730,11,204430,2.0,15060,1.0,8811,46,149522,152,36808
561,6/28/2022,451,670457,111,260492,35,243066,2.0,35440,2.0,37039,3.0,14733,28,204458,2.0,15062,2.0,8813,76,149598,231,37039
562,6/29/2022,323,670780,98,260590,16,243082,1.0,35441,2.0,37041,5.0,14738,10,204468,0.0,15062,1.0,8814,67,149665,143,37182
563,6/30/2022,396,671176,100,260690,13,243095,4.0,35445,4.0,37045,1.0,14739,11,204479,1.0,15063,0.0,8814,65,149730,214,37396
564,7/1/2022,495,671671,127,260817,13,243108,3.0,35448,4.0,37049,2.0,14741,10,204489,0.0,15063,1.0,8815,83,149813,267,37663
565,7/2/2022,82,671753,11,260828,1,243109,0.0,35448,2.0,37051,0.0,14741,1,204490,0.0,15063,0.0,8815,18,149831,52,37715
566,7/3/2022,42,671795,3,260831,5,243114,0.0,35448,0.0,37051,0.0,14741,3,204493,0.0,15063,2.0,8817,9,149840,25,37740
567,7/4/2022,9,671804,2,260833,0,243114,0.0,35448,0.0,37051,0.0,14741,0,204493,0.0,15063,0.0,8817,2,149842,5,37745
568,7/5/2022,349,672153,81,260914,24,243138,1.0,35449,1.0,37052,2.0,14743,20,204513,1.0,15064,1.0,8818,58,149900,187,37932
569,7/6/2022,326,672479,81,260995,21,243159,1.0,35450,3.0,37055,1.0,14744,16,204529,3.0,15067,1.0,8819,63,149963,164,38096
570,7/7/2022,342,672821,75,261070,14,243173,4.0,35454,8.0,37063,0.0,14744,14,204543,0.0,15067,0.0,8819,62,150025,187,38283
571,7/8/2022,510,673331,102,261172,22,243195,3.0,35457,2.0,37065,5.0,14749,14,204557,3.0,15070,0.0,8819,65,150090,315,38598
572,7/9/2022,213,673544,18,261190,12,243207,1.0,35458,1.0,37066,1.0,14750,8,204565,0.0,15070,3.0,8822,24,150114,159,38757
573,7/10/2022,48,673592,14,261204,3,243210,0.0,35458,1.0,37067,,14750,2,204567,1.0,15071,0.0,8822,6,150120,24,38781
574,7/11/2022,282,673874,58,261262,15,243225,3.0,35461,3.0,37070,1.0,14751,12,204579,2.0,15073,0.0,8822,41,150161,168,38949
575,7/12/2022,380,674254,79,261341,27,243252,3.0,35464,0.0,37070,2.0,14753,19,204598,4.0,15077,2.0,8824,67,150228,199,39148
576,7/13/2022,383,674637,55,261396,30,243282,0.0,35464,4.0,37074,1.0,14754,24,204622,3.0,15080,2.0,8826,54,150282,241,39389
577,7/14/2022,382,675019,77,261473,25,243307,3.0,35467,0.0,37074,3.0,14757,16,204638,2.0,15082,4.0,8830,73,150355,203,39592
578,7/15/2022,584,675603,79,261552,28,243335,2.0,35469,5.0,37079,0.0,14757,21,204659,3.0,15085,4.0,8834,76,150431,396,39988
579,7/16/2022,326,675929,25,261577,14,243349,2.0,35471,1.0,37080,1.0,14758,12,204671,1.0,15086,0.0,8834,35,150466,246,40234
580,7/17/2022,75,676004,15,261592,5,243354,0.0,35471,0.0,37080,0.0,14758,4,204675,0.0,15086,1.0,8835,12,150478,43,40277
581,7/18/2022,383,676387,42,261634,50,243404,4.0,35475,3.0,37083,3.0,14761,40,204715,3.0,15089,4.0,8839,80,150558,209,40486
582,7/19/2022,419,676806,61,261695,44,243448,5.0,35480,4.0,37087,3.0,14764,34,204749,4.0,15093,3.0,8842,76,150634,236,40722
583,7/20/2022,272,677078,39,261734,48,243496,5.0,35485,0.0,37087,1.0,14765,45,204794,2.0,15095,0.0,8842,54,150688,131,40853
584,7/21/2022,350,677428,61,261795,64,243560,4.0,35489,2.0,37089,5.0,14770,51,204845,4.0,15099,4.0,8846,63,150751,158,41011
585,7/22/2022,651,678079,99,261894,114,243674,2.0,35491,2.0,37091,6.0,14776,92,204937,13.0,15112,3.0,8849,96,150847,336,41347
586,7/23/2022,245,678324,10,261904,21,243695,3.0,35494,0.0,37091,0.0,14776,21,204958,0.0,15112,0.0,8849,32,150879,178,41525
587,7/24/2022,77,678401,10,261914,14,243709,0.0,35494,0.0,37091,0.0,14776,12,204970,2.0,15114,0.0,8849,8,150887,45,41570
588,7/25/2022,290,678691,35,261949,28,243737,1.0,35495,0.0,37091,1.0,14777,21,204991,4.0,15118,2.0,8851,68,150955,157,41727
589,7/26/2022,434,679125,45,261994,80,243817,1.0,35496,3.0,37094,3.0,14780,63,205054,11.0,15129,3.0,8854,75,151030,228,41955
590,7/27/2022,287,679412,31,262025,64,243881,4.0,35500,3.0,37097,4.0,14784,55,205109,4.0,15133,1.0,8855,52,151082,136,42091
591,7/28/2022,268,679680,28,262053,63,243944,2.0,35502,1.0,37098,3.0,14787,49,205158,7.0,15140,4.0,8859,42,151124,133,42224
592,7/29/2022,435,680115,57,262110,101,244045,3.0,35505,3.0,37101,9.0,14796,81,205239,7.0,15147,4.0,8863,71,151195,202,42426
593,7/30/2022,133,680248,6,262116,13,244058,1.0,35506,1.0,37102,1.0,14797,12,205251,0.0,15147,,8863,18,151213,93,42519
594,7/31/2022,47,680295,2,262118,5,244063,0.0,35506,1.0,37103,,14797,3,205254,2.0,15149,0.0,8863,13,151226,27,42546
595,8/1/2022,179,680474,0,262118,36,244099,1.0,35507,0.0,37103,2.0,14799,31,205285,3.0,15152,0.0,8863,52,151278,88,42634
596,8/2/2022,206,680680,0,262118,54,244153,1.0,35508,0.0,37103,2.0,14801,47,205332,3.0,15155,2.0,8865,38,151316,114,42748
