,Date,daily number of doses received by Larimer County residents,total number of doses recevied by residents,daily number of residents receiving first dose,total number of residents receiving first dose,daily number of residents vaccinated,total number of residents vaccinated,daily number of 70+ vaccinated,total number of 70+ vaccinated,daily number of 70+ at least one dose,total number of 70+ at least one dose,daily number of Latinx residents vaccinated,total of Latinx residents vaccinated,daily number of White non-Latinx residents vaccinated,total of White non-Latinx residents vaccinated,daily number of non-White non-Latinx residents vaccinated,total of non-White non-Latinx residents vaccinated,dailyUnknown,totalUnknown,daily_additional_doses,total_additional_doses
0,12/14/2020,32,32,32,32,1,1,0.0,0,1.0,1,0.0,0,1,1,0.0,0,,0,0,0
1,12/15/2020,13,45,13,45,0,1,,0,,1,,0,0,1,0.0,0,,0,0,0
2,12/16/2020,303,348,303,348,0,1,0.0,0,2.0,3,0.0,0,0,1,0.0,0,0.0,0,0,0
3,12/17/2020,990,1338,990,1338,0,1,0.0,0,11.0,14,0.0,0,0,1,0.0,0,0.0,0,0,0
4,12/18/2020,1057,2395,1057,2395,2,3,0.0,0,15.0,29,0.0,0,2,3,0.0,0,0.0,0,0,0
5,12/19/2020,722,3117,722,3117,0,3,0.0,0,14.0,43,0.0,0,0,3,0.0,0,0.0,0,0,0
6,12/20/2020,266,3383,266,3383,0,3,0.0,0,4.0,47,0.0,0,0,3,0.0,0,0.0,0,0,0
7,12/21/2020,358,3741,358,3741,3,6,0.0,0,3.0,50,0.0,0,3,6,0.0,0,0.0,0,0,0
8,12/22/2020,364,4105,364,4105,0,6,0.0,0,7.0,57,0.0,0,0,6,0.0,0,0.0,0,0,0
9,12/23/2020,440,4545,440,4545,0,6,0.0,0,6.0,63,0.0,0,0,6,0.0,0,0.0,0,0,0
10,12/24/2020,105,4650,105,4650,0,6,0.0,0,3.0,66,0.0,0,0,6,0.0,0,0.0,0,0,0
11,12/25/2020,1,4651,1,4651,0,6,,0,,66,,0,0,6,,0,,0,0,0
12,12/26/2020,228,4879,228,4879,1,7,0.0,0,3.0,69,0.0,0,1,7,0.0,0,0.0,0,0,0
13,12/27/2020,278,5157,278,5157,0,7,0.0,0,197.0,266,0.0,0,0,7,0.0,0,,0,0,0
14,12/28/2020,709,5866,709,5866,0,7,0.0,0,386.0,652,0.0,0,0,7,0.0,0,0.0,0,0,0
15,12/29/2020,911,6777,910,6776,1,8,0.0,0,461.0,1113,0.0,0,1,8,0.0,0,0.0,0,0,0
16,12/30/2020,882,7659,882,7658,0,8,0.0,0,273.0,1386,0.0,0,0,8,0.0,0,0.0,0,0,0
17,12/31/2020,895,8554,895,8553,0,8,0.0,0,343.0,1729,0.0,0,0,8,0.0,0,0.0,0,0,0
18,1/1/2021,4,8558,3,8556,1,9,,0,,1729,,0,1,9,,0,,0,0,0
19,1/2/2021,392,8950,392,8948,1,10,0.0,0,141.0,1870,0.0,0,1,10,0.0,0,0.0,0,0,0
20,1/3/2021,123,9073,123,9071,0,10,0.0,0,52.0,1922,0.0,0,0,10,0.0,0,0.0,0,0,0
21,1/4/2021,588,9661,575,9646,12,22,0.0,0,320.0,2242,0.0,0,10,20,2.0,2,0.0,0,0,0
22,1/5/2021,646,10307,637,10283,10,32,0.0,0,409.0,2651,0.0,0,9,29,1.0,3,0.0,0,0,0
23,1/6/2021,1232,11539,914,11197,310,342,4.0,4,515.0,3166,18.0,18,272,301,16.0,19,4.0,4,0,0
24,1/7/2021,1657,13196,702,11899,933,1275,11.0,15,406.0,3572,34.0,52,842,1143,42.0,61,15.0,19,0,0
25,1/8/2021,1991,15187,981,12880,995,2270,11.0,26,479.0,4051,48.0,100,884,2027,44.0,105,19.0,38,1,1
26,1/9/2021,1230,16417,529,13409,684,2954,12.0,38,303.0,4354,16.0,116,619,2646,37.0,142,12.0,50,0,1
27,1/10/2021,702,17119,427,13836,272,3226,4.0,42,260.0,4614,10.0,126,245,2891,14.0,156,3.0,53,0,1
28,1/11/2021,1149,18268,798,14634,348,3574,1.0,43,536.0,5150,10.0,136,316,3207,19.0,175,3.0,56,0,1
29,1/12/2021,1178,19446,880,15514,297,3871,8.0,51,517.0,5667,14.0,150,257,3464,18.0,193,8.0,64,1,2
30,1/13/2021,1079,20525,833,16347,243,4114,1.0,52,376.0,6043,23.0,173,197,3661,15.0,208,8.0,72,0,2
31,1/14/2021,872,21397,837,17184,35,4149,1.0,53,494.0,6537,2.0,175,31,3692,1.0,209,1.0,73,0,2
32,1/15/2021,1218,22615,1206,18390,12,4161,0.0,53,760.0,7297,0.0,175,12,3704,0.0,209,0.0,73,0,2
33,1/16/2021,985,23600,971,19361,14,4175,1.0,54,585.0,7882,0.0,175,13,3717,1.0,210,0.0,73,0,2
34,1/17/2021,54,23654,50,19411,4,4179,0.0,54,19.0,7901,0.0,175,2,3719,2.0,212,0.0,73,0,2
35,1/18/2021,1015,24669,813,20224,200,4379,48.0,102,599.0,8500,8.0,183,174,3893,13.0,225,5.0,78,2,4
36,1/19/2021,1258,25927,1117,21341,139,4518,8.0,110,737.0,9237,7.0,190,118,4011,6.0,231,8.0,86,0,4
37,1/20/2021,1421,27348,1202,22543,217,4735,17.0,127,570.0,9807,15.0,205,176,4187,9.0,240,17.0,103,1,5
38,1/21/2021,2252,29600,2043,24586,209,4944,7.0,134,1587.0,11394,13.0,218,174,4361,15.0,255,7.0,110,0,5
39,1/22/2021,1737,31337,1461,26047,275,5219,90.0,224,1091.0,12485,34.0,252,222,4583,13.0,268,6.0,116,0,5
40,1/23/2021,895,32232,560,26607,334,5553,58.0,282,416.0,12901,8.0,260,305,4888,13.0,281,8.0,124,0,5
41,1/24/2021,393,32625,104,26711,286,5839,206.0,488,61.0,12962,8.0,268,269,5157,9.0,290,,124,0,5
42,1/25/2021,1405,34030,784,27495,609,6448,360.0,848,554.0,13516,14.0,282,568,5725,15.0,305,12.0,136,0,5
43,1/26/2021,1622,35652,692,28187,917,7365,453.0,1301,441.0,13957,30.0,312,842,6567,32.0,337,13.0,149,0,5
44,1/27/2021,1837,37489,769,28956,1062,8427,535.0,1836,334.0,14291,40.0,352,968,7535,44.0,381,10.0,159,0,5
45,1/28/2021,1345,38834,539,29495,803,9230,356.0,2192,295.0,14586,25.0,377,735,8270,28.0,409,15.0,174,2,7
46,1/29/2021,1634,40468,1155,30650,476,9706,158.0,2350,826.0,15412,21.0,398,412,8682,33.0,442,10.0,184,0,7
47,1/30/2021,1230,41698,736,31386,490,10196,213.0,2563,599.0,16011,24.0,422,440,9122,20.0,462,6.0,190,0,7
48,1/31/2021,623,42321,398,31784,224,10420,76.0,2639,353.0,16364,5.0,427,198,9320,15.0,477,6.0,196,1,8
49,2/1/2021,1605,43926,901,32685,703,11123,468.0,3107,654.0,17018,17.0,444,649,9969,27.0,504,10.0,206,1,9
50,2/2/2021,1863,45789,729,33414,1129,12252,733.0,3840,582.0,17600,43.0,487,1041,11010,34.0,538,11.0,217,0,9
51,2/3/2021,1263,47052,583,33997,677,12929,320.0,4160,225.0,17825,48.0,535,577,11587,41.0,579,11.0,228,0,9
52,2/4/2021,2535,49587,1794,35791,732,13661,489.0,4649,1551.0,19376,29.0,564,656,12243,37.0,616,10.0,238,1,10
53,2/5/2021,2580,52167,1533,37324,1034,14695,681.0,5330,1305.0,20681,38.0,602,948,13191,30.0,646,18.0,256,2,12
54,2/6/2021,2220,54387,1597,38921,614,15309,441.0,5771,1241.0,21922,6.0,608,584,13775,22.0,668,2.0,258,0,12
55,2/7/2021,232,54619,89,39010,141,15450,94.0,5865,26.0,21948,7.0,615,125,13900,4.0,672,5.0,263,1,13
56,2/8/2021,2485,57104,1597,40607,882,16332,597.0,6462,1139.0,23087,26.0,641,811,14711,28.0,700,17.0,280,0,13
57,2/9/2021,2390,59494,1545,42152,840,17172,511.0,6973,997.0,24084,25.0,666,755,15466,32.0,732,28.0,308,0,13
58,2/10/2021,1587,61081,966,43118,617,17789,321.0,7294,288.0,24372,26.0,692,549,16015,26.0,758,16.0,324,4,17
59,2/11/2021,3535,64616,2001,45119,1526,19315,1054.0,8348,809.0,25181,55.0,747,1395,17410,50.0,808,26.0,350,2,19
60,2/12/2021,3263,67879,1811,46930,1442,20757,954.0,9302,800.0,25981,61.0,808,1326,18736,42.0,850,13.0,363,0,19
61,2/13/2021,2996,70875,2363,49293,627,21384,309.0,9611,672.0,26653,13.0,821,580,19316,23.0,873,11.0,374,1,20
62,2/14/2021,421,71296,350,49643,71,21455,49.0,9660,46.0,26699,2.0,823,64,19380,3.0,876,2.0,376,0,20
63,2/15/2021,2624,73920,2130,51773,491,21946,324.0,9984,256.0,26955,17.0,840,460,19840,12.0,888,2.0,378,0,20
64,2/16/2021,2751,76671,1918,53691,826,22772,497.0,10481,230.0,27185,35.0,875,751,20591,24.0,912,16.0,394,0,20
65,2/17/2021,1633,78304,656,54347,971,23743,478.0,10959,155.0,27340,29.0,904,886,21477,36.0,948,20.0,414,0,20
66,2/18/2021,2640,80944,1674,56021,955,24698,733.0,11692,275.0,27615,37.0,941,881,22358,30.0,978,7.0,421,1,21
67,2/19/2021,2423,83367,1031,57052,1376,26074,1018.0,12710,155.0,27770,44.0,985,1274,23632,43.0,1021,15.0,436,3,24
68,2/20/2021,1651,85018,688,57740,958,27032,783.0,13493,134.0,27904,22.0,1007,898,24530,28.0,1049,10.0,446,1,25
69,2/21/2021,108,85126,40,57780,67,27099,37.0,13530,8.0,27912,1.0,1008,64,24594,2.0,1051,0.0,446,0,25
70,2/22/2021,2024,87150,763,58543,1248,28347,923.0,14453,147.0,28059,37.0,1045,1164,25758,37.0,1088,10.0,456,1,26
71,2/23/2021,1221,88371,517,59060,703,29050,470.0,14923,161.0,28220,20.0,1065,635,26393,35.0,1123,13.0,469,0,26
72,2/24/2021,1409,89780,754,59814,648,29698,276.0,15199,137.0,28357,31.0,1096,593,26986,19.0,1142,5.0,474,1,27
73,2/25/2021,3866,93646,2071,61885,1789,31487,1508.0,16707,351.0,28708,47.0,1143,1689,28675,36.0,1178,17.0,491,0,27
74,2/26/2021,3272,96918,1157,63042,2109,33596,1745.0,18452,201.0,28909,33.0,1176,1988,30663,59.0,1237,29.0,520,2,29
75,2/27/2021,3495,100413,1662,64704,1824,35420,1561.0,20013,544.0,29453,36.0,1212,1709,32372,52.0,1289,27.0,547,1,30
76,2/28/2021,427,100840,357,65061,69,35489,43.0,20056,114.0,29567,2.0,1214,63,32435,2.0,1291,2.0,549,0,30
77,3/1/2021,2819,103659,1344,66405,1469,36958,1078.0,21134,300.0,29867,53.0,1267,1358,33793,46.0,1337,12.0,561,5,35
78,3/2/2021,3256,106915,1728,68133,1520,38478,1050.0,22184,383.0,30250,38.0,1305,1411,35204,44.0,1381,27.0,588,1,36
79,3/3/2021,1657,108572,1092,69225,562,39040,174.0,22358,203.0,30453,32.0,1337,502,35706,24.0,1405,4.0,592,0,36
80,3/4/2021,3004,111576,1582,70807,1423,40463,816.0,23174,170.0,30623,43.0,1380,1306,37012,54.0,1459,20.0,612,25,61
81,3/5/2021,3484,115060,2055,72862,1436,41899,813.0,23987,426.0,31049,39.0,1419,1331,38343,43.0,1502,23.0,635,26,87
82,3/6/2021,4107,119167,2324,75186,1989,43888,754.0,24741,268.0,31317,95.0,1514,1782,40125,77.0,1579,35.0,670,585,672
83,3/7/2021,417,119584,301,75487,125,44013,37.0,24778,20.0,31337,1.0,1515,119,40244,3.0,1582,2.0,672,23,695
84,3/8/2021,2823,122407,1056,76543,1773,45786,260.0,25038,74.0,31411,49.0,1564,1639,41883,62.0,1644,23.0,695,125,820
85,3/9/2021,3183,125590,1651,78194,1547,47333,263.0,25301,96.0,31507,51.0,1615,1407,43290,64.0,1708,25.0,720,73,893
86,3/10/2021,2381,127971,1366,79560,1021,48354,300.0,25601,83.0,31590,54.0,1669,919,44209,32.0,1740,16.0,736,63,956
87,3/11/2021,4176,132147,2379,81939,1803,50157,400.0,26001,135.0,31725,63.0,1732,1653,45862,67.0,1807,20.0,756,76,1032
88,3/12/2021,3948,136095,2575,84514,1395,51552,198.0,26199,67.0,31792,67.0,1799,1242,47104,53.0,1860,33.0,789,69,1101
89,3/13/2021,214,136309,131,84645,99,51651,20.0,26219,7.0,31799,1.0,1800,92,47196,4.0,1864,2.0,791,30,1131
90,3/14/2021,100,136409,60,84705,39,51690,9.0,26228,0.0,31799,1.0,1801,36,47232,1.0,1865,1.0,792,2,1133
91,3/15/2021,898,137307,361,85066,537,52227,85.0,26313,15.0,31814,19.0,1820,494,47726,17.0,1882,7.0,799,19,1152
92,3/16/2021,3286,140593,2115,87181,1173,53400,227.0,26540,45.0,31859,64.0,1884,1046,48772,41.0,1923,22.0,821,30,1182
93,3/17/2021,2907,143500,1786,88967,1124,54524,238.0,26778,88.0,31947,40.0,1924,1029,49801,35.0,1958,20.0,841,32,1214
94,3/18/2021,4003,147503,2090,91057,1924,56448,338.0,27116,91.0,32038,97.0,2021,1742,51543,64.0,2022,21.0,862,21,1235
95,3/19/2021,3002,150505,1753,92810,1250,57698,221.0,27337,42.0,32080,60.0,2081,1125,52668,46.0,2068,19.0,881,16,1251
96,3/20/2021,3081,153586,1965,94775,1118,58816,313.0,27650,54.0,32134,37.0,2118,1006,53674,54.0,2122,21.0,902,36,1287
97,3/21/2021,659,154245,396,95171,265,59081,26.0,27676,5.0,32139,11.0,2129,236,53910,16.0,2138,2.0,904,18,1305
98,3/22/2021,3109,157354,2243,97414,865,59946,188.0,27864,56.0,32195,19.0,2148,796,54706,37.0,2175,13.0,917,26,1331
99,3/23/2021,4442,161796,3567,100981,1175,61121,194.0,28058,75.0,32270,40.0,2188,1047,55753,50.0,2225,38.0,955,489,1820
100,3/24/2021,3162,164958,2427,103408,748,61869,118.0,28176,37.0,32307,40.0,2228,668,56421,26.0,2251,14.0,969,33,1853
101,3/25/2021,5070,170028,3054,106462,2016,63885,312.0,28488,71.0,32378,68.0,2296,1848,58269,69.0,2320,31.0,1000,15,1868
102,3/26/2021,4580,174608,2731,109193,1847,65732,328.0,28816,65.0,32443,119.0,2415,1585,59854,112.0,2432,31.0,1031,30,1898
103,3/27/2021,3342,177950,1914,111107,1423,67155,325.0,29141,21.0,32464,49.0,2464,1308,61162,46.0,2478,20.0,1051,5,1903
104,3/28/2021,1169,179119,809,111916,361,67516,92.0,29233,16.0,32480,12.0,2476,331,61493,16.0,2494,2.0,1053,4,1907
105,3/29/2021,3983,183102,2688,114604,1294,68810,229.0,29462,52.0,32532,39.0,2515,1214,62707,28.0,2522,13.0,1066,8,1915
106,3/30/2021,4373,187475,2756,117360,1644,70454,237.0,29699,74.0,32606,55.0,2570,1503,64210,68.0,2590,18.0,1084,46,1961
107,3/31/2021,3567,191042,2554,119914,1045,71499,166.0,29865,47.0,32653,41.0,2611,934,65144,50.0,2640,20.0,1104,30,1991
108,4/1/2021,5111,196153,3332,123246,1790,73289,148.0,30013,76.0,32729,73.0,2684,1638,66782,60.0,2700,19.0,1123,32,2023
109,4/2/2021,4704,200857,2521,125767,2182,75471,245.0,30258,49.0,32778,82.0,2766,1984,68766,91.0,2791,25.0,1148,27,2050
110,4/3/2021,4258,205115,3527,129294,763,76234,94.0,30352,41.0,32819,37.0,2803,677,69443,29.0,2820,20.0,1168,69,2119
111,4/4/2021,371,205486,257,129551,132,76366,6.0,30358,7.0,32826,3.0,2806,116,69559,11.0,2831,2.0,1170,33,2152
112,4/5/2021,4688,210174,3759,133310,953,77319,75.0,30433,47.0,32873,70.0,2876,815,70374,49.0,2880,19.0,1189,91,2243
113,4/6/2021,5164,215338,3032,136342,2317,79636,85.0,30518,58.0,32931,80.0,2956,2055,72429,126.0,3006,56.0,1245,271,2514
114,4/7/2021,4967,220305,3688,140030,2170,81806,59.0,30577,109.0,33040,118.0,3074,1845,74274,134.0,3140,73.0,1318,1165,3679
115,4/8/2021,6685,226990,4508,144538,2868,84674,137.0,30714,123.0,33163,136.0,3210,2516,76790,141.0,3281,75.0,1393,926,4605
116,4/9/2021,5724,232714,3265,147803,3231,87905,77.0,30791,71.0,33234,163.0,3373,2800,79590,181.0,3462,87.0,1480,809,5414
117,4/10/2021,4433,237147,3165,150968,1746,89651,51.0,30842,71.0,33305,99.0,3472,1475,81065,119.0,3581,53.0,1533,514,5928
118,4/11/2021,1035,238182,794,151762,286,89937,5.0,30847,11.0,33316,12.0,3484,239,81304,24.0,3605,11.0,1544,57,5985
119,4/12/2021,5038,243220,3638,155400,2017,91954,76.0,30923,96.0,33412,77.0,3561,1747,83051,133.0,3738,60.0,1604,507,6492
120,4/13/2021,5035,248255,3563,158963,1487,93441,55.0,30978,77.0,33489,70.0,3631,1297,84348,96.0,3834,24.0,1628,21,6513
121,4/14/2021,2954,251209,1437,160400,1511,94952,86.0,31064,26.0,33515,93.0,3724,1315,85663,70.0,3904,33.0,1661,2,6515
122,4/15/2021,4952,256161,2327,162727,2608,97560,102.0,31166,58.0,33573,217.0,3941,2169,87832,161.0,4065,61.0,1722,3,6518
123,4/16/2021,3908,260069,2077,164804,1817,99377,44.0,31210,34.0,33607,67.0,4008,1590,89422,126.0,4191,34.0,1756,4,6522
124,4/17/2021,4587,264656,2402,167206,2169,101546,39.0,31249,57.0,33664,99.0,4107,1886,91308,132.0,4323,52.0,1808,4,6526
125,4/18/2021,1038,265694,408,167614,623,102169,13.0,31262,11.0,33675,42.0,4149,518,91826,33.0,4356,30.0,1838,4,6530
126,4/19/2021,3860,269554,1411,169025,2425,104594,44.0,31306,40.0,33715,164.0,4313,2040,93866,161.0,4517,60.0,1898,5,6535
127,4/20/2021,4695,274249,1866,170891,2816,107410,47.0,31353,69.0,33784,160.0,4473,2399,96265,193.0,4710,64.0,1962,5,6540
128,4/21/2021,3166,277415,708,171599,2449,109859,35.0,31388,31.0,33815,146.0,4619,2061,98326,163.0,4873,79.0,2041,4,6544
129,4/22/2021,4655,282070,1770,173369,2873,112732,46.0,31434,62.0,33877,143.0,4762,2463,100789,193.0,5066,74.0,2115,2,6546
130,4/23/2021,3588,285658,1176,174545,2396,115128,41.0,31475,30.0,33907,73.0,4835,2113,102902,128.0,5194,82.0,2197,5,6551
131,4/24/2021,3358,289016,1116,175661,2237,117365,14.0,31489,20.0,33927,104.0,4939,1896,104798,196.0,5390,41.0,2238,5,6556
132,4/25/2021,795,289811,344,176005,450,117815,6.0,31495,6.0,33933,105.0,5044,267,105065,38.0,5428,40.0,2278,1,6557
133,4/26/2021,4359,294170,1114,177119,3238,121053,35.0,31530,31.0,33964,147.0,5191,2784,107849,214.0,5642,93.0,2371,4,6561
134,4/27/2021,3345,297515,1192,178311,2146,123199,36.0,31566,37.0,34001,79.0,5270,1890,109739,134.0,5776,43.0,2414,10,6571
135,4/28/2021,2989,300504,718,179029,2271,125470,45.0,31611,20.0,34021,167.0,5437,1843,111582,196.0,5972,65.0,2479,14,6585
136,4/29/2021,3967,304471,820,179849,3141,128611,67.0,31678,33.0,34054,227.0,5664,2581,114163,225.0,6197,108.0,2587,8,6593
137,4/30/2021,2868,307339,640,180489,2228,130839,44.0,31722,24.0,34078,73.0,5737,1894,116057,198.0,6395,63.0,2650,11,6604
138,5/1/2021,3641,310980,817,181306,2806,133645,35.0,31757,18.0,34096,282.0,6019,2185,118242,200.0,6595,139.0,2789,16,6620
139,5/2/2021,528,311508,232,181538,307,133952,7.0,31764,2.0,34098,12.0,6031,247,118489,38.0,6633,10.0,2799,10,6630
140,5/3/2021,3426,314934,637,182175,2788,136740,47.0,31811,34.0,34132,107.0,6138,2392,120881,212.0,6845,77.0,2876,12,6642
141,5/4/2021,4345,319279,697,182872,3666,140406,67.0,31878,27.0,34159,148.0,6286,3149,124030,258.0,7103,111.0,2987,28,6670
142,5/5/2021,2226,321505,476,183348,1786,142192,63.0,31941,24.0,34183,86.0,6372,1480,125510,141.0,7244,79.0,3066,13,6683
143,5/6/2021,3688,325193,823,184171,2983,145175,100.0,32041,40.0,34223,179.0,6551,2473,127983,195.0,7439,136.0,3202,45,6728
144,5/7/2021,2940,328133,542,184713,2489,147664,44.0,32085,11.0,34234,135.0,6686,2045,130028,212.0,7651,97.0,3299,38,6766
145,5/8/2021,2985,331118,555,185268,2534,150198,45.0,32130,16.0,34250,167.0,6853,2043,132071,194.0,7845,130.0,3429,47,6813
146,5/9/2021,367,331485,141,185409,239,150437,4.0,32134,2.0,34252,10.0,6863,199,132270,20.0,7865,10.0,3439,3,6816
147,5/10/2021,2425,333910,380,185789,2079,152516,60.0,32194,16.0,34268,87.0,6950,1691,133961,205.0,8070,96.0,3535,25,6841
148,5/11/2021,2717,336627,542,186331,2218,154734,92.0,32286,24.0,34292,190.0,7140,1729,135690,203.0,8273,96.0,3631,17,6858
149,5/12/2021,1226,337853,459,186790,819,155553,23.0,32309,14.0,34306,49.0,7189,649,136339,86.0,8359,35.0,3666,23,6881
150,5/13/2021,3250,341103,1033,187823,2232,157785,82.0,32391,25.0,34331,151.0,7340,1820,138159,156.0,8515,105.0,3771,16,6897
151,5/14/2021,2473,343576,1280,189103,1291,159076,51.0,32442,30.0,34361,64.0,7404,1072,139231,100.0,8615,55.0,3826,34,6931
152,5/15/2021,3020,346596,1509,190612,1596,160672,40.0,32482,15.0,34376,114.0,7518,1267,140498,141.0,8756,74.0,3900,26,6957
153,5/16/2021,945,347541,573,191185,405,161077,8.0,32490,8.0,34384,83.0,7601,252,140750,30.0,8786,40.0,3940,10,6967
154,5/17/2021,2450,349991,1211,192396,1311,162388,38.0,32528,27.0,34411,48.0,7649,1102,141852,101.0,8887,60.0,4000,21,6988
155,5/18/2021,2587,352578,1178,193574,1443,163831,44.0,32572,22.0,34433,72.0,7721,1212,143064,84.0,8971,75.0,4075,19,7007
156,5/19/2021,1876,354454,1153,194727,787,164618,24.0,32596,19.0,34452,42.0,7763,637,143701,69.0,9040,39.0,4114,16,7023
157,5/20/2021,1979,356433,923,195650,1099,165717,45.0,32641,27.0,34479,94.0,7857,875,144576,81.0,9121,49.0,4163,17,7040
158,5/21/2021,1627,358060,924,196574,782,166499,18.0,32659,16.0,34495,43.0,7900,622,145198,60.0,9181,57.0,4220,27,7067
159,5/22/2021,1686,359746,794,197368,922,167421,9.0,32668,13.0,34508,122.0,8022,640,145838,74.0,9255,86.0,4306,15,7082
160,5/23/2021,680,360426,342,197710,368,167789,2.0,32670,5.0,34513,68.0,8090,227,146065,18.0,9273,55.0,4361,3,7085
161,5/24/2021,1336,361762,537,198247,851,168640,36.0,32706,20.0,34533,43.0,8133,685,146750,82.0,9355,41.0,4402,19,7104
162,5/25/2021,1233,362995,509,198756,755,169395,22.0,32728,20.0,34553,57.0,8190,568,147318,65.0,9420,65.0,4467,19,7123
163,5/26/2021,966,363961,553,199309,526,169921,17.0,32745,25.0,34578,38.0,8228,415,147733,44.0,9464,29.0,4496,25,7148
164,5/27/2021,1272,365233,657,199966,679,170600,32.0,32777,19.0,34597,54.0,8282,548,148281,50.0,9514,27.0,4523,20,7168
165,5/28/2021,1031,366264,597,200563,479,171079,18.0,32795,22.0,34619,29.0,8311,374,148655,48.0,9562,28.0,4551,16,7184
166,5/29/2021,1017,367281,492,201055,562,171641,18.0,32813,8.0,34627,32.0,8343,443,149098,42.0,9604,45.0,4596,12,7196
167,5/30/2021,332,367613,220,201275,143,171784,5.0,32818,3.0,34630,12.0,8355,104,149202,17.0,9621,10.0,4606,10,7206
168,5/31/2021,339,367952,192,201467,174,171958,8.0,32826,6.0,34636,8.0,8363,139,149341,13.0,9634,14.0,4620,10,7216
169,6/1/2021,968,368920,397,201864,602,172560,26.0,32852,17.0,34653,49.0,8412,460,149801,46.0,9680,47.0,4667,24,7240
170,6/2/2021,720,369640,369,202233,407,172967,16.0,32868,8.0,34661,34.0,8446,322,150123,23.0,9703,28.0,4695,8,7248
171,6/3/2021,1308,370948,522,202755,836,173803,22.0,32890,12.0,34673,48.0,8494,688,150811,58.0,9761,42.0,4737,15,7263
172,6/4/2021,1504,372452,404,203159,1141,174944,16.0,32906,9.0,34682,71.0,8565,952,151763,70.0,9831,48.0,4785,4,7267
173,6/5/2021,1414,373866,358,203517,1083,176027,12.0,32918,6.0,34688,64.0,8629,887,152650,92.0,9923,40.0,4825,9,7276
174,6/6/2021,530,374396,141,203658,398,176425,5.0,32923,3.0,34691,43.0,8672,318,152968,25.0,9948,12.0,4837,10,7286
175,6/7/2021,1194,375590,335,203993,902,177327,14.0,32937,12.0,34703,68.0,8740,719,153687,83.0,10031,32.0,4869,19,7305
176,6/8/2021,1087,376677,253,204246,858,178185,18.0,32955,5.0,34708,57.0,8797,697,154384,69.0,10100,35.0,4904,4,7309
177,6/9/2021,1080,377757,283,204529,843,179028,15.0,32970,12.0,34720,78.0,8875,646,155030,72.0,10172,47.0,4951,12,7321
178,6/10/2021,1310,379067,334,204863,1013,180041,20.0,32990,4.0,34724,93.0,8968,799,155829,67.0,10239,54.0,5005,10,7331
179,6/11/2021,1114,380181,325,205188,831,180872,19.0,33009,13.0,34737,57.0,9025,652,156481,78.0,10317,44.0,5049,9,7340
180,6/12/2021,1045,381226,289,205477,798,181670,15.0,33024,9.0,34746,73.0,9098,619,157100,63.0,10380,43.0,5092,9,7349
181,6/13/2021,371,381597,98,205575,284,181954,4.0,33028,1.0,34747,37.0,9135,203,157303,25.0,10405,19.0,5111,6,7355
182,6/14/2021,830,382427,282,205857,592,182546,15.0,33043,4.0,34751,44.0,9179,449,157752,42.0,10447,57.0,5168,6,7361
183,6/15/2021,695,383122,238,206095,479,183025,20.0,33063,10.0,34761,40.0,9219,389,158141,34.0,10481,16.0,5184,2,7363
184,6/16/2021,624,383746,204,206299,446,183471,12.0,33075,4.0,34765,38.0,9257,340,158481,33.0,10514,35.0,5219,9,7372
185,6/17/2021,694,384440,251,206550,468,183939,13.0,33088,10.0,34775,41.0,9298,349,158830,49.0,10563,29.0,5248,4,7376
186,6/18/2021,1036,385476,379,206929,687,184626,23.0,33111,11.0,34786,52.0,9350,555,159385,51.0,10614,29.0,5277,7,7383
187,6/19/2021,635,386111,154,207083,496,185122,10.0,33121,6.0,34792,51.0,9401,365,159750,54.0,10668,26.0,5303,9,7392
188,6/20/2021,300,386411,114,207197,192,185314,3.0,33124,2.0,34794,36.0,9437,119,159869,15.0,10683,22.0,5325,5,7397
189,6/21/2021,516,386927,214,207411,328,185642,5.0,33129,8.0,34802,29.0,9466,243,160112,35.0,10718,21.0,5346,8,7405
190,6/22/2021,610,387537,250,207661,390,186032,12.0,33141,7.0,34809,31.0,9497,306,160418,25.0,10743,28.0,5374,5,7410
191,6/23/2021,510,388047,186,207847,351,186383,7.0,33148,10.0,34819,38.0,9535,254,160672,37.0,10780,22.0,5396,11,7421
192,6/24/2021,517,388564,209,208056,331,186714,12.0,33160,9.0,34828,30.0,9565,257,160929,23.0,10803,21.0,5417,1,7422
193,6/25/2021,689,389253,273,208329,438,187152,12.0,33172,8.0,34836,42.0,9607,325,161254,43.0,10846,28.0,5445,5,7427
194,6/26/2021,598,389851,166,208495,441,187593,9.0,33181,9.0,34845,77.0,9684,290,161544,43.0,10889,31.0,5476,4,7431
195,6/27/2021,183,390034,71,208566,113,187706,2.0,33183,3.0,34848,9.0,9693,82,161626,12.0,10901,10.0,5486,2,7433
196,6/28/2021,487,390521,209,208775,285,187991,7.0,33190,6.0,34854,39.0,9732,206,161832,24.0,10925,16.0,5502,2,7435
197,6/29/2021,560,391081,252,209027,329,188320,16.0,33206,11.0,34865,42.0,9774,239,162071,22.0,10947,26.0,5528,11,7446
198,6/30/2021,410,391491,205,209232,219,188539,8.0,33214,11.0,34876,19.0,9793,164,162235,16.0,10963,20.0,5548,12,7458
199,7/1/2021,486,391977,208,209440,296,188835,8.0,33222,7.0,34883,21.0,9814,222,162457,33.0,10996,20.0,5568,4,7462
200,7/2/2021,569,392546,273,209713,307,189142,5.0,33227,7.0,34890,26.0,9840,242,162699,23.0,11019,16.0,5584,3,7465
201,7/3/2021,307,392853,120,209833,194,189336,4.0,33231,3.0,34893,29.0,9869,126,162825,20.0,11039,19.0,5603,5,7470
202,7/4/2021,53,392906,18,209851,35,189371,1.0,33232,0.0,34893,4.0,9873,22,162847,1.0,11040,8.0,5611,0,7470
203,7/5/2021,316,393222,139,209990,175,189546,3.0,33235,1.0,34894,18.0,9891,121,162968,26.0,11066,10.0,5621,4,7474
204,7/6/2021,453,393675,190,210180,272,189818,4.0,33239,5.0,34899,45.0,9936,193,163161,19.0,11085,15.0,5636,1,7475
205,7/7/2021,372,394047,210,210390,176,189994,7.0,33246,6.0,34905,19.0,9955,130,163291,12.0,11097,15.0,5651,4,7479
206,7/8/2021,424,394471,199,210589,246,190240,10.0,33256,8.0,34913,23.0,9978,177,163468,23.0,11120,23.0,5674,3,7482
207,7/9/2021,482,394953,195,210784,293,190533,9.0,33265,2.0,34915,36.0,10014,215,163683,24.0,11144,18.0,5692,6,7488
208,7/10/2021,259,395212,147,210931,127,190660,5.0,33270,2.0,34917,5.0,10019,105,163788,10.0,11154,7.0,5699,2,7490
209,7/11/2021,223,395435,119,211050,122,190782,6.0,33276,6.0,34923,11.0,10030,88,163876,10.0,11164,13.0,5712,7,7497
210,7/12/2021,385,395820,202,211252,196,190978,7.0,33283,4.0,34927,25.0,10055,130,164006,24.0,11188,17.0,5729,4,7501
211,7/13/2021,437,396257,225,211477,224,191202,16.0,33299,10.0,34937,26.0,10081,175,164181,12.0,11200,11.0,5740,5,7506
212,7/14/2021,282,396539,149,211626,156,191358,8.0,33307,5.0,34942,20.0,10101,112,164293,9.0,11209,15.0,5755,7,7513
213,7/15/2021,360,396899,189,211815,182,191540,1.0,33308,4.0,34946,15.0,10116,137,164430,13.0,11222,17.0,5772,3,7516
214,7/16/2021,510,397409,244,212059,276,191816,8.0,33316,9.0,34955,24.0,10140,210,164640,22.0,11244,20.0,5792,5,7521
215,7/17/2021,276,397685,158,212217,128,191944,11.0,33327,5.0,34960,11.0,10151,97,164737,9.0,11253,11.0,5803,6,7527
216,7/18/2021,195,397880,118,212335,89,192033,4.0,33331,3.0,34963,13.0,10164,63,164800,6.0,11259,7.0,5810,4,7531
217,7/19/2021,406,398286,206,212541,206,192239,8.0,33339,8.0,34971,26.0,10190,150,164950,17.0,11276,13.0,5823,4,7535
218,7/20/2021,416,398702,209,212750,215,192454,6.0,33345,8.0,34979,12.0,10202,166,165116,23.0,11299,14.0,5837,5,7540
219,7/21/2021,333,399035,183,212933,170,192624,13.0,33358,14.0,34993,12.0,10214,127,165243,14.0,11313,17.0,5854,3,7543
220,7/22/2021,394,399429,234,213167,168,192792,7.0,33365,19.0,35012,18.0,10232,124,165367,18.0,11331,8.0,5862,6,7549
221,7/23/2021,550,399979,317,213484,236,193028,6.0,33371,10.0,35022,36.0,10268,161,165528,20.0,11351,19.0,5881,3,7552
222,7/24/2021,352,400331,215,213699,156,193184,8.0,33379,10.0,35032,19.0,10287,114,165642,9.0,11360,14.0,5895,5,7557
223,7/25/2021,199,400530,145,213844,62,193246,0.0,33379,4.0,35036,7.0,10294,44,165686,5.0,11365,6.0,5901,4,7561
224,7/26/2021,345,400875,199,214043,144,193390,1.0,33380,7.0,35043,11.0,10305,98,165784,18.0,11383,17.0,5918,4,7565
225,7/27/2021,423,401298,237,214280,174,193564,5.0,33385,16.0,35059,21.0,10326,122,165906,18.0,11401,13.0,5931,15,7580
226,7/28/2021,468,401766,284,214564,222,193786,3.0,33388,10.0,35069,28.0,10354,144,166050,17.0,11418,33.0,5964,5,7585
227,7/29/2021,510,402276,306,214870,233,194019,8.0,33396,6.0,35075,24.0,10378,177,166227,13.0,11431,19.0,5983,9,7594
228,7/30/2021,684,402960,475,215345,247,194266,10.0,33406,14.0,35089,25.0,10403,187,166414,16.0,11447,19.0,6002,5,7599
229,7/31/2021,334,403294,202,215547,136,194402,4.0,33410,1.0,35090,15.0,10418,107,166521,9.0,11456,5.0,6007,5,7604
230,8/1/2021,267,403561,170,215717,105,194507,0.0,33410,2.0,35092,15.0,10433,66,166587,8.0,11464,16.0,6023,8,7612
231,8/2/2021,446,404007,297,216014,173,194680,4.0,33414,13.0,35105,21.0,10454,119,166706,20.0,11484,13.0,6036,6,7618
232,8/3/2021,560,404567,346,216360,240,194920,6.0,33420,13.0,35118,37.0,10491,162,166868,15.0,11499,26.0,6062,4,7622
233,8/4/2021,390,404957,273,216633,138,195058,3.0,33423,14.0,35132,10.0,10501,105,166973,5.0,11504,18.0,6080,10,7632
234,8/5/2021,445,405402,287,216920,169,195227,5.0,33428,11.0,35143,19.0,10520,122,167095,17.0,11521,11.0,6091,4,7636
235,8/6/2021,678,406080,459,217379,265,195492,12.0,33440,16.0,35159,22.0,10542,201,167296,22.0,11543,20.0,6111,4,7640
236,8/7/2021,439,406519,305,217684,157,195649,4.0,33444,10.0,35169,12.0,10554,124,167420,5.0,11548,16.0,6127,5,7645
237,8/8/2021,217,406736,126,217810,98,195747,3.0,33447,5.0,35174,8.0,10562,71,167491,7.0,11555,12.0,6139,5,7650
238,8/9/2021,465,407201,281,218091,214,195961,4.0,33451,6.0,35180,22.0,10584,159,167650,11.0,11566,22.0,6161,8,7658
239,8/10/2021,503,407704,300,218391,228,196189,6.0,33457,14.0,35194,25.0,10609,179,167829,11.0,11577,13.0,6174,8,7666
240,8/11/2021,418,408122,265,218656,176,196365,11.0,33468,5.0,35199,16.0,10625,134,167963,14.0,11591,12.0,6186,3,7669
241,8/12/2021,541,408663,319,218975,258,196623,7.0,33475,13.0,35212,31.0,10656,181,168144,23.0,11614,23.0,6209,7,7676
242,8/13/2021,658,409321,379,219354,297,196920,11.0,33486,9.0,35221,31.0,10687,216,168360,19.0,11633,31.0,6240,6,7682
243,8/14/2021,504,409825,257,219611,250,197170,7.0,33493,9.0,35230,11.0,10698,213,168573,9.0,11642,17.0,6257,45,7727
244,8/15/2021,264,410089,128,219739,125,197295,2.0,33495,3.0,35233,11.0,10709,91,168664,6.0,11648,17.0,6274,17,7744
245,8/16/2021,539,410628,310,220049,169,197464,5.0,33500,11.0,35244,15.0,10724,129,168793,13.0,11661,12.0,6286,75,7819
246,8/17/2021,483,411111,228,220277,194,197658,19.0,33519,10.0,35254,17.0,10741,146,168939,10.0,11671,21.0,6307,78,7897
247,8/18/2021,592,411703,324,220601,255,197913,5.0,33524,15.0,35269,30.0,10771,172,169111,13.0,11684,40.0,6347,72,7969
248,8/19/2021,567,412270,278,220879,256,198169,7.0,33531,9.0,35278,21.0,10792,206,169317,17.0,11701,12.0,6359,74,8043
249,8/20/2021,841,413111,340,221219,451,198620,15.0,33546,11.0,35289,44.0,10836,358,169675,29.0,11730,20.0,6379,84,8127
250,8/21/2021,646,413757,211,221430,209,198829,4.0,33550,7.0,35296,14.0,10850,171,169846,13.0,11743,11.0,6390,190,8317
251,8/22/2021,316,414073,150,221580,142,198971,1.0,33551,2.0,35298,19.0,10869,100,169946,9.0,11752,14.0,6404,31,8348
252,8/23/2021,528,414601,263,221843,222,199193,10.0,33561,9.0,35307,19.0,10888,168,170114,12.0,11764,23.0,6427,61,8409
253,8/24/2021,569,415170,272,222115,276,199469,10.0,33571,8.0,35315,27.0,10915,216,170330,15.0,11779,18.0,6445,53,8462
254,8/25/2021,592,415762,319,222434,256,199725,12.0,33583,13.0,35328,19.0,10934,195,170525,9.0,11788,33.0,6478,47,8509
255,8/26/2021,533,416295,261,222695,251,199976,9.0,33592,14.0,35342,18.0,10952,193,170718,23.0,11811,17.0,6495,43,8552
256,8/27/2021,887,417182,351,223046,403,200379,15.0,33607,11.0,35353,38.0,10990,298,171016,22.0,11833,45.0,6540,151,8703
257,8/28/2021,1465,418647,202,223248,249,200628,7.0,33614,5.0,35358,23.0,11013,184,171200,14.0,11847,28.0,6568,984,9687
258,8/29/2021,1080,419727,160,223408,136,200764,4.0,33618,4.0,35362,8.0,11021,111,171311,12.0,11859,5.0,6573,770,10457
259,8/30/2021,616,420343,271,223679,281,201045,9.0,33627,13.0,35375,24.0,11045,216,171527,9.0,11868,32.0,6605,90,10547
260,8/31/2021,810,421153,234,223913,237,201282,7.0,33634,12.0,35387,18.0,11063,188,171715,18.0,11886,13.0,6618,340,10887
261,9/1/2021,949,422102,248,224161,221,201503,12.0,33646,15.0,35402,21.0,11084,168,171883,13.0,11899,19.0,6637,481,11368
262,9/2/2021,828,422930,184,224345,204,201707,13.0,33659,14.0,35416,18.0,11102,152,172035,16.0,11915,18.0,6655,457,11825
263,9/3/2021,854,423784,340,224685,371,202078,13.0,33672,12.0,35428,44.0,11146,271,172306,21.0,11936,35.0,6690,163,11988
264,9/4/2021,375,424159,163,224848,164,202242,6.0,33678,8.0,35436,13.0,11159,127,172433,11.0,11947,13.0,6703,57,12045
265,9/5/2021,251,424410,131,224979,108,202350,2.0,33680,4.0,35440,12.0,11171,77,172510,9.0,11956,10.0,6713,21,12066
266,9/6/2021,113,424523,47,225026,59,202409,1.0,33681,0.0,35440,4.0,11175,43,172553,8.0,11964,4.0,6717,12,12078
267,9/7/2021,952,425475,199,225225,272,202681,19.0,33700,12.0,35452,22.0,11197,208,172761,17.0,11981,25.0,6742,484,12562
268,9/8/2021,790,426265,219,225444,225,202906,11.0,33711,12.0,35464,24.0,11221,167,172928,10.0,11991,24.0,6766,368,12930
269,9/9/2021,401,426666,175,225619,193,203099,9.0,33720,8.0,35472,21.0,11242,141,173069,14.0,12005,17.0,6783,54,12984
270,9/10/2021,753,427419,340,225959,307,203406,9.0,33729,23.0,35495,28.0,11270,231,173300,20.0,12025,28.0,6811,146,13130
271,9/11/2021,1634,429053,162,226121,210,203616,10.0,33739,19.0,35514,18.0,11288,160,173460,15.0,12040,17.0,6828,1266,14396
272,9/12/2021,232,429285,100,226221,114,203730,1.0,33740,2.0,35516,11.0,11299,74,173534,10.0,12050,19.0,6847,16,14412
273,9/13/2021,492,429777,220,226441,245,203975,9.0,33749,8.0,35524,24.0,11323,184,173718,12.0,12062,25.0,6872,44,14456
274,9/14/2021,845,430622,204,226645,274,204249,14.0,33763,16.0,35540,17.0,11340,220,173938,14.0,12076,23.0,6895,400,14856
275,9/15/2021,829,431451,190,226835,265,204514,15.0,33778,15.0,35555,21.0,11361,195,174133,17.0,12093,32.0,6927,398,15254
276,9/16/2021,355,431806,134,226969,193,204707,9.0,33787,8.0,35563,32.0,11393,138,174271,11.0,12104,12.0,6939,43,15297
277,9/17/2021,746,432552,284,227253,387,205094,13.0,33800,13.0,35576,29.0,11422,289,174560,38.0,12142,31.0,6970,123,15420
278,9/18/2021,1838,434390,128,227381,171,205265,5.0,33805,20.0,35596,10.0,11432,126,174686,15.0,12157,20.0,6990,1539,16959
279,9/19/2021,180,434570,74,227455,105,205370,3.0,33808,2.0,35598,6.0,11438,81,174767,5.0,12162,13.0,7003,11,16970
280,9/20/2021,385,434955,144,227599,216,205586,8.0,33816,9.0,35607,27.0,11465,160,174927,10.0,12172,19.0,7022,55,17025
281,9/21/2021,771,435726,166,227765,199,205785,9.0,33825,14.0,35621,21.0,11486,153,175080,8.0,12180,17.0,7039,420,17445
282,9/22/2021,718,436444,164,227929,230,206015,6.0,33831,12.0,35633,15.0,11501,181,175261,16.0,12196,18.0,7057,362,17807
283,9/23/2021,348,436792,144,228073,179,206194,8.0,33839,3.0,35636,9.0,11510,132,175393,13.0,12209,25.0,7082,47,17854
284,9/24/2021,696,437488,208,228281,275,206469,16.0,33855,16.0,35652,20.0,11530,218,175611,11.0,12220,26.0,7108,232,18086
285,9/25/2021,1734,439222,136,228417,176,206645,11.0,33866,21.0,35673,15.0,11545,137,175748,12.0,12232,12.0,7120,1428,19514
286,9/26/2021,263,439485,65,228482,87,206732,3.0,33869,3.0,35676,11.0,11556,65,175813,4.0,12236,7.0,7127,110,19624
287,9/27/2021,566,440051,156,228638,124,206856,7.0,33876,11.0,35687,7.0,11563,96,175909,8.0,12244,13.0,7140,302,19926
288,9/28/2021,1130,441181,157,228795,202,207058,19.0,33895,23.0,35710,15.0,11578,153,176062,9.0,12253,25.0,7165,792,20718
289,9/29/2021,1141,442322,174,228969,171,207229,12.0,33907,19.0,35729,15.0,11593,127,176189,7.0,12260,22.0,7187,810,21528
290,9/30/2021,706,443028,161,229130,166,207395,15.0,33922,7.0,35736,11.0,11604,127,176316,10.0,12270,18.0,7205,409,21937
291,10/1/2021,1064,444092,175,229305,301,207696,20.0,33942,15.0,35751,20.0,11624,238,176554,21.0,12291,22.0,7227,603,22540
292,10/2/2021,1815,445907,118,229423,115,207811,12.0,33954,14.0,35765,9.0,11633,96,176650,5.0,12296,5.0,7232,1588,24128
293,10/3/2021,392,446299,64,229487,113,207924,1.0,33955,2.0,35767,18.0,11651,77,176727,7.0,12303,11.0,7243,227,24355
294,10/4/2021,794,447093,113,229600,156,208080,7.0,33962,12.0,35779,27.0,11678,102,176829,14.0,12317,13.0,7256,532,24887
295,10/5/2021,1119,448212,137,229737,135,208215,12.0,33974,17.0,35796,13.0,11691,103,176932,5.0,12322,14.0,7270,858,25745
296,10/6/2021,997,449209,106,229843,155,208370,8.0,33982,14.0,35810,11.0,11702,122,177054,5.0,12327,17.0,7287,753,26498
297,10/7/2021,784,449993,132,229975,107,208477,8.0,33990,14.0,35824,8.0,11710,83,177137,5.0,12332,11.0,7298,565,27063
298,10/8/2021,1037,451030,157,230132,239,208716,19.0,34009,11.0,35835,20.0,11730,186,177323,11.0,12343,22.0,7320,652,27715
299,10/9/2021,1676,452706,108,230240,131,208847,11.0,34020,8.0,35843,22.0,11752,98,177421,3.0,12346,8.0,7328,1439,29154
300,10/10/2021,243,452949,50,230290,63,208910,2.0,34022,2.0,35845,4.0,11756,49,177470,5.0,12351,5.0,7333,131,29285
301,10/11/2021,821,453770,123,230413,136,209046,17.0,34039,18.0,35863,3.0,11759,112,177582,10.0,12361,11.0,7344,573,29858
302,10/12/2021,1024,454794,117,230530,133,209179,8.0,34047,19.0,35882,16.0,11775,104,177686,4.0,12365,9.0,7353,784,30642
303,10/13/2021,972,455766,117,230647,151,209330,17.0,34064,9.0,35891,16.0,11791,114,177800,12.0,12377,9.0,7362,723,31365
304,10/14/2021,710,456476,99,230746,127,209457,14.0,34078,9.0,35900,20.0,11811,94,177894,8.0,12385,5.0,7367,491,31856
305,10/15/2021,1028,457504,177,230923,215,209672,11.0,34089,7.0,35907,15.0,11826,169,178063,13.0,12398,18.0,7385,671,32527
306,10/16/2021,803,458307,66,230989,80,209752,4.0,34093,3.0,35910,6.0,11832,69,178132,2.0,12400,3.0,7388,657,33184
307,10/17/2021,196,458503,48,231037,63,209815,1.0,34094,2.0,35912,4.0,11836,47,178179,3.0,12403,9.0,7397,83,33267
308,10/18/2021,652,459155,119,231156,135,209950,10.0,34104,4.0,35916,13.0,11849,106,178285,6.0,12409,10.0,7407,413,33680
309,10/19/2021,1049,460204,120,231276,134,210084,4.0,34108,11.0,35927,8.0,11857,108,178393,8.0,12417,10.0,7417,805,34485
310,10/20/2021,893,461097,122,231398,121,210205,6.0,34114,12.0,35939,9.0,11866,91,178484,7.0,12424,14.0,7431,664,35149
311,10/21/2021,534,461631,107,231505,127,210332,9.0,34123,8.0,35947,14.0,11880,85,178569,11.0,12435,17.0,7448,321,35470
312,10/22/2021,1477,463108,195,231700,229,210561,9.0,34132,13.0,35960,20.0,11900,170,178739,14.0,12449,25.0,7473,1073,36543
313,10/23/2021,1880,464988,88,231788,195,210756,14.0,34146,15.0,35975,4.0,11904,170,178909,11.0,12460,10.0,7483,1600,38143
314,10/24/2021,571,465559,81,231869,152,210908,8.0,34154,11.0,35986,12.0,11916,128,179037,7.0,12467,5.0,7488,351,38494
315,10/25/2021,1386,466945,136,232005,297,211205,27.0,34181,17.0,36003,12.0,11928,252,179289,21.0,12488,12.0,7500,966,39460
316,10/26/2021,2144,469089,177,232182,300,211505,15.0,34196,17.0,36020,19.0,11947,249,179538,18.0,12506,14.0,7514,1677,41137
317,10/27/2021,1972,471061,153,232335,274,211779,19.0,34215,19.0,36039,9.0,11956,242,179780,14.0,12520,9.0,7523,1553,42690
318,10/28/2021,1712,472773,138,232473,260,212039,11.0,34226,20.0,36059,11.0,11967,219,179999,17.0,12537,13.0,7536,1325,44015
319,10/29/2021,1659,474432,179,232652,279,212318,12.0,34238,15.0,36074,10.0,11977,244,180243,12.0,12549,13.0,7549,1212,45227
320,10/30/2021,1587,476019,79,232731,150,212468,13.0,34251,8.0,36082,6.0,11983,129,180372,9.0,12558,6.0,7555,1367,46594
321,10/31/2021,462,476481,48,232779,74,212542,2.0,34253,6.0,36088,6.0,11989,62,180434,4.0,12562,2.0,7557,339,46933
322,11/1/2021,1240,477721,137,232916,215,212757,10.0,34263,10.0,36098,8.0,11997,177,180611,12.0,12574,18.0,7575,894,47827
323,11/2/2021,1820,479541,129,233045,201,212958,8.0,34271,17.0,36115,14.0,12011,162,180773,14.0,12588,11.0,7586,1505,49332
324,11/3/2021,1744,481285,159,233204,229,213187,12.0,34283,17.0,36132,15.0,12026,181,180954,16.0,12604,17.0,7603,1371,50703
325,11/4/2021,1410,482695,145,233349,183,213370,4.0,34287,13.0,36145,1.0,12027,159,181113,12.0,12616,11.0,7614,1106,51809
326,11/5/2021,2015,484710,226,233575,299,213669,14.0,34301,12.0,36157,17.0,12044,250,181363,14.0,12630,18.0,7632,1522,53331
327,11/6/2021,1578,486288,215,233790,142,213811,4.0,34305,7.0,36164,6.0,12050,115,181478,15.0,12645,6.0,7638,1229,54560
328,11/7/2021,524,486812,119,233909,77,213888,1.0,34306,8.0,36172,5.0,12055,63,181541,3.0,12648,6.0,7644,328,54888
329,11/8/2021,1526,488338,385,234294,198,214086,7.0,34313,9.0,36181,11.0,12066,164,181705,9.0,12657,14.0,7658,964,55852
330,11/9/2021,2631,490969,942,235236,221,214307,10.0,34323,21.0,36202,15.0,12081,163,181868,16.0,12673,27.0,7685,1488,57340
331,11/10/2021,2485,493454,822,236058,223,214530,11.0,34334,17.0,36219,12.0,12093,176,182044,22.0,12695,13.0,7698,1464,58804
332,11/11/2021,2348,495802,965,237023,187,214717,17.0,34351,8.0,36227,13.0,12106,153,182197,13.0,12708,8.0,7706,1215,60019
333,11/12/2021,2553,498355,754,237777,240,214957,12.0,34363,19.0,36246,23.0,12129,191,182388,13.0,12721,13.0,7719,1570,61589
334,11/13/2021,1926,500281,405,238182,140,215097,4.0,34367,12.0,36258,7.0,12136,104,182492,15.0,12736,14.0,7733,1391,62980
335,11/14/2021,1480,501761,910,239092,107,215204,1.0,34368,2.0,36260,11.0,12147,72,182564,14.0,12750,10.0,7743,472,63452
336,11/15/2021,1954,503715,452,239544,200,215404,7.0,34375,11.0,36271,12.0,12159,160,182724,12.0,12762,16.0,7759,1323,64775
337,11/16/2021,2398,506113,454,239998,212,215616,5.0,34380,21.0,36292,26.0,12185,155,182879,17.0,12779,14.0,7773,1744,66519
338,11/17/2021,2722,508835,633,240631,269,215885,12.0,34392,16.0,36308,16.0,12201,222,183101,17.0,12796,14.0,7787,1851,68370
339,11/18/2021,1886,510721,377,241008,177,216062,7.0,34399,11.0,36319,15.0,12216,142,183243,15.0,12811,5.0,7792,1347,69717
340,11/19/2021,2560,513281,714,241722,280,216342,13.0,34412,14.0,36333,9.0,12225,234,183477,20.0,12831,17.0,7809,1586,71303
341,11/20/2021,1876,515157,531,242253,112,216454,6.0,34418,5.0,36338,8.0,12233,95,183572,4.0,12835,5.0,7814,1236,72539
342,11/21/2021,639,515796,124,242377,85,216539,0.0,34418,1.0,36339,3.0,12236,69,183641,8.0,12843,5.0,7819,433,72972
343,11/22/2021,1972,517768,427,242804,208,216747,11.0,34429,21.0,36360,10.0,12246,169,183810,11.0,12854,18.0,7837,1357,74329
344,11/23/2021,1837,519605,289,243093,184,216931,8.0,34437,15.0,36375,15.0,12261,148,183958,14.0,12868,7.0,7844,1372,75701
345,11/24/2021,1509,521114,215,243308,163,217094,6.0,34443,11.0,36386,14.0,12275,131,184089,12.0,12880,6.0,7850,1145,76846
346,11/25/2021,46,521160,9,243317,2,217096,0.0,34443,0.0,36386,0.0,12275,1,184090,1.0,12881,,7850,35,76881
347,11/26/2021,1257,522417,191,243508,202,217298,3.0,34446,4.0,36390,17.0,12292,163,184253,12.0,12893,10.0,7860,883,77764
348,11/27/2021,949,523366,137,243645,152,217450,2.0,34448,2.0,36392,7.0,12299,130,184383,8.0,12901,7.0,7867,662,78426
349,11/28/2021,539,523905,95,243740,105,217555,2.0,34450,2.0,36394,9.0,12308,84,184467,5.0,12906,7.0,7874,345,78771
350,11/29/2021,1841,525746,274,244014,408,217963,8.0,34458,13.0,36407,29.0,12337,339,184806,25.0,12931,15.0,7889,1180,79951
351,11/30/2021,2657,528403,338,244352,787,218750,8.0,34466,11.0,36418,51.0,12388,663,185469,61.0,12992,12.0,7901,1552,81503
352,12/1/2021,2432,530835,263,244615,746,219496,13.0,34479,11.0,36429,30.0,12418,656,186125,56.0,13048,4.0,7905,1434,82937
353,12/2/2021,2804,533639,351,244966,911,220407,9.0,34488,15.0,36444,69.0,12487,740,186865,73.0,13121,29.0,7934,1569,84506
354,12/3/2021,2586,536225,287,245253,754,221161,11.0,34499,4.0,36448,61.0,12548,595,187460,69.0,13190,29.0,7963,1565,86071
355,12/4/2021,2182,538407,161,245414,420,221581,4.0,34503,1.0,36449,24.0,12572,329,187789,36.0,13226,31.0,7994,1608,87679
356,12/5/2021,1375,539782,103,245517,839,222420,1.0,34504,0.0,36449,67.0,12639,666,188455,69.0,13295,37.0,8031,442,88121
357,12/6/2021,1917,541699,233,245750,466,222886,7.0,34511,5.0,36454,54.0,12693,363,188818,33.0,13328,16.0,8047,1230,89351
358,12/7/2021,2447,544146,307,246057,467,223353,10.0,34521,9.0,36463,48.0,12741,372,189190,31.0,13359,16.0,8063,1692,91043
359,12/8/2021,2229,546375,271,246328,512,223865,9.0,34530,12.0,36475,29.0,12770,429,189619,40.0,13399,14.0,8077,1468,92511
360,12/9/2021,2144,548519,303,246631,459,224324,6.0,34536,8.0,36483,27.0,12797,356,189975,43.0,13442,33.0,8110,1396,93907
361,12/10/2021,2087,550606,241,246872,403,224727,10.0,34546,9.0,36492,38.0,12835,313,190288,32.0,13474,20.0,8130,1453,95360
362,12/11/2021,1781,552387,137,247009,492,225219,6.0,34552,1.0,36493,59.0,12894,366,190654,41.0,13515,26.0,8156,1154,96514
363,12/12/2021,415,552802,55,247064,88,225307,1.0,34553,3.0,36496,4.0,12898,71,190725,7.0,13522,6.0,8162,275,96789
364,12/13/2021,1750,554552,297,247361,393,225700,9.0,34562,8.0,36504,26.0,12924,319,191044,35.0,13557,13.0,8175,1078,97867
365,12/14/2021,2179,556731,276,247637,365,226065,7.0,34569,5.0,36509,33.0,12957,299,191343,16.0,13573,17.0,8192,1563,99430
366,12/15/2021,1739,558470,201,247838,229,226294,6.0,34575,4.0,36513,9.0,12966,185,191528,20.0,13593,15.0,8207,1323,100753
367,12/16/2021,1767,560237,313,248151,246,226540,7.0,34582,8.0,36521,15.0,12981,207,191735,15.0,13608,9.0,8216,1226,101979
368,12/17/2021,2113,562350,307,248458,441,226981,6.0,34588,10.0,36531,28.0,13009,363,192098,39.0,13647,11.0,8227,1376,103355
369,12/18/2021,1802,564152,179,248637,241,227222,4.0,34592,4.0,36535,17.0,13026,206,192304,10.0,13657,8.0,8235,1383,104738
370,12/19/2021,438,564590,44,248681,80,227302,1.0,34593,3.0,36538,5.0,13031,66,192370,4.0,13661,5.0,8240,314,105052
371,12/20/2021,1550,566140,197,248878,243,227545,10.0,34603,9.0,36547,27.0,13058,192,192562,16.0,13677,8.0,8248,1115,106167
372,12/21/2021,2187,568327,310,249188,295,227840,10.0,34613,8.0,36555,28.0,13086,228,192790,25.0,13702,14.0,8262,1590,107757
373,12/22/2021,1872,570199,219,249407,285,228125,4.0,34617,9.0,36564,28.0,13114,227,193017,22.0,13724,8.0,8270,1371,109128
374,12/23/2021,1235,571434,217,249624,206,228331,5.0,34622,4.0,36568,23.0,13137,156,193173,16.0,13740,11.0,8281,825,109953
375,12/24/2021,320,571754,45,249669,63,228394,3.0,34625,2.0,36570,4.0,13141,54,193227,4.0,13744,1.0,8282,214,110167
376,12/25/2021,14,571768,3,249672,2,228396,0.0,34625,0.0,36570,,13141,1,193228,1.0,13745,,8282,9,110176
377,12/26/2021,356,572124,60,249732,68,228464,1.0,34626,0.0,36570,7.0,13148,53,193281,5.0,13750,3.0,8285,230,110406
378,12/27/2021,1250,573374,175,249907,221,228685,4.0,34630,5.0,36575,18.0,13166,175,193456,20.0,13770,8.0,8293,861,111267
379,12/28/2021,1890,575264,267,250174,295,228980,12.0,34642,11.0,36586,35.0,13201,230,193686,16.0,13786,14.0,8307,1332,112599
380,12/29/2021,1696,576960,212,250386,251,229231,5.0,34647,6.0,36592,27.0,13228,191,193877,22.0,13808,11.0,8318,1244,113843
381,12/30/2021,1365,578325,222,250608,240,229471,7.0,34654,9.0,36601,26.0,13254,187,194064,15.0,13823,12.0,8330,913,114756
382,12/31/2021,504,578829,97,250705,92,229563,0.0,34654,2.0,36603,7.0,13261,75,194139,5.0,13828,5.0,8335,318,115074
383,1/1/2022,93,578922,12,250717,16,229579,1.0,34655,1.0,36604,0.0,13261,13,194152,2.0,13830,1.0,8336,65,115139
384,1/2/2022,315,579237,45,250762,59,229638,1.0,34656,1.0,36605,7.0,13268,41,194193,8.0,13838,3.0,8339,212,115351
385,1/3/2022,1594,580831,330,251092,345,229983,4.0,34660,5.0,36610,34.0,13302,281,194474,20.0,13858,10.0,8349,929,116280
386,1/4/2022,1673,582504,264,251356,275,230258,10.0,34670,7.0,36617,30.0,13332,217,194691,17.0,13875,11.0,8360,1147,117427
387,1/5/2022,1333,583837,205,251561,200,230458,7.0,34677,8.0,36625,13.0,13345,163,194854,9.0,13884,15.0,8375,941,118368
388,1/6/2022,1227,585064,254,251815,232,230690,4.0,34681,4.0,36629,24.0,13369,173,195027,13.0,13897,22.0,8397,750,119118
389,1/7/2022,2054,587118,253,252068,341,231031,6.0,34687,9.0,36638,35.0,13404,263,195290,30.0,13927,13.0,8410,1472,120590
390,1/8/2022,1573,588691,124,252192,130,231161,0.0,34687,3.0,36641,7.0,13411,109,195399,7.0,13934,7.0,8417,1323,121913
391,1/9/2022,499,589190,92,252284,72,231233,0.0,34687,2.0,36643,14.0,13425,49,195448,3.0,13937,6.0,8423,336,122249
392,1/10/2022,1552,590742,287,252571,250,231483,3.0,34690,6.0,36649,19.0,13444,193,195641,27.0,13964,11.0,8434,1026,123275
393,1/11/2022,1560,592302,220,252791,274,231757,3.0,34693,4.0,36653,31.0,13475,209,195850,15.0,13979,19.0,8453,1078,124353
394,1/12/2022,1402,593704,178,252969,185,231942,6.0,34699,5.0,36658,29.0,13504,127,195977,20.0,13999,9.0,8462,1051,125404
395,1/13/2022,1097,594801,191,253160,177,232119,3.0,34702,2.0,36660,14.0,13518,131,196108,18.0,14017,14.0,8476,738,126142
396,1/14/2022,1618,596419,279,253439,213,232332,2.0,34704,9.0,36669,25.0,13543,155,196263,20.0,14037,13.0,8489,1141,127283
397,1/15/2022,1215,597634,136,253575,102,232434,1.0,34705,3.0,36672,11.0,13554,80,196343,9.0,14046,2.0,8491,978,128261
398,1/16/2022,290,597924,47,253622,35,232469,1.0,34706,0.0,36672,1.0,13555,31,196374,3.0,14049,0.0,8491,208,128469
399,1/17/2022,774,598698,160,253782,127,232596,4.0,34710,5.0,36677,12.0,13567,105,196479,8.0,14057,2.0,8493,489,128958
400,1/18/2022,886,599584,164,253946,165,232761,2.0,34712,6.0,36683,25.0,13592,126,196605,6.0,14063,8.0,8501,564,129522
401,1/19/2022,719,600303,121,254067,117,232878,4.0,34716,7.0,36690,9.0,13601,86,196691,10.0,14073,12.0,8513,493,130015
402,1/20/2022,780,601083,146,254213,147,233025,0.0,34716,10.0,36700,17.0,13618,111,196802,10.0,14083,9.0,8522,494,130509
403,1/21/2022,1174,602257,167,254380,171,233196,7.0,34723,2.0,36702,15.0,13633,132,196934,12.0,14095,12.0,8534,845,131354
404,1/22/2022,781,603038,87,254467,102,233298,0.0,34723,1.0,36703,14.0,13647,73,197007,6.0,14101,9.0,8543,593,131947
405,1/23/2022,210,603248,24,254491,53,233351,1.0,34724,0.0,36703,5.0,13652,41,197048,7.0,14108,0.0,8543,134,132081
406,1/24/2022,488,603736,75,254566,107,233458,1.0,34725,1.0,36704,14.0,13666,78,197126,8.0,14116,7.0,8550,309,132390
407,1/25/2022,661,604397,116,254682,142,233600,3.0,34728,2.0,36706,15.0,13681,100,197226,20.0,14136,7.0,8557,404,132794
408,1/26/2022,643,605040,100,254782,140,233740,8.0,34736,2.0,36708,13.0,13694,106,197332,13.0,14149,8.0,8565,412,133206
409,1/27/2022,616,605656,114,254896,171,233911,5.0,34741,1.0,36709,29.0,13723,126,197458,10.0,14159,6.0,8571,337,133543
410,1/28/2022,968,606624,163,255059,169,234080,6.0,34747,6.0,36715,20.0,13743,119,197577,14.0,14173,16.0,8587,641,134184
411,1/29/2022,558,607182,68,255127,85,234165,1.0,34748,4.0,36719,10.0,13753,62,197639,8.0,14181,5.0,8592,405,134589
412,1/30/2022,191,607373,33,255160,43,234208,1.0,34749,1.0,36720,13.0,13766,26,197665,1.0,14182,3.0,8595,117,134706
413,1/31/2022,558,607931,138,255298,120,234328,2.0,34751,2.0,36722,17.0,13783,79,197744,13.0,14195,11.0,8606,304,135010
414,2/1/2022,548,608479,99,255397,137,234465,0.0,34751,4.0,36726,19.0,13802,102,197846,11.0,14206,5.0,8611,314,135324
415,2/2/2022,127,608606,18,255415,45,234510,0.0,34751,1.0,36727,2.0,13804,41,197887,1.0,14207,1.0,8612,67,135391
416,2/3/2022,367,608973,75,255490,115,234625,1.0,34752,3.0,36730,24.0,13828,79,197966,6.0,14213,6.0,8618,182,135573
417,2/4/2022,642,609615,108,255598,146,234771,6.0,34758,3.0,36733,17.0,13845,114,198080,9.0,14222,6.0,8624,390,135963
418,2/5/2022,456,610071,57,255655,112,234883,2.0,34760,0.0,36733,7.0,13852,90,198170,6.0,14228,9.0,8633,289,136252
419,2/6/2022,123,610194,20,255675,34,234917,0.0,34760,1.0,36734,1.0,13853,23,198193,6.0,14234,4.0,8637,70,136322
420,2/7/2022,363,610557,61,255736,110,235027,0.0,34760,0.0,36734,12.0,13865,85,198278,5.0,14239,8.0,8645,194,136516
421,2/8/2022,441,610998,85,255821,115,235142,0.0,34760,3.0,36737,19.0,13884,84,198362,5.0,14244,7.0,8652,251,136767
422,2/9/2022,352,611350,63,255884,97,235239,3.0,34763,1.0,36738,18.0,13902,64,198426,3.0,14247,12.0,8664,195,136962
423,2/10/2022,371,611721,83,255967,89,235328,1.0,34764,3.0,36741,16.0,13918,60,198486,8.0,14255,5.0,8669,200,137162
424,2/11/2022,540,612261,95,256062,155,235483,3.0,34767,0.0,36741,28.0,13946,106,198592,9.0,14264,12.0,8681,295,137457
425,2/12/2022,249,612510,41,256103,51,235534,0.0,34767,0.0,36741,5.0,13951,39,198631,5.0,14269,2.0,8683,160,137617
426,2/13/2022,75,612585,18,256121,16,235550,0.0,34767,1.0,36742,0.0,13951,10,198641,4.0,14273,2.0,8685,43,137660
427,2/14/2022,235,612820,42,256163,51,235601,4.0,34771,2.0,36744,8.0,13959,37,198678,2.0,14275,4.0,8689,144,137804
428,2/15/2022,175,612995,26,256189,43,235644,0.0,34771,0.0,36744,10.0,13969,28,198706,4.0,14279,1.0,8690,110,137914
