,Date,daily number of doses received by Larimer County residents,total number of doses recevied by residents,daily number of residents receiving first dose,total number of residents receiving first dose,daily number of residents vaccinated,total number of residents vaccinated,daily number of 70+ vaccinated,total number of 70+ vaccinated,daily number of 70+ at least one dose,total number of 70+ at least one dose,daily number of Latinx residents vaccinated,total of Latinx residents vaccinated,daily number of White non-Latinx residents vaccinated,total of White non-Latinx residents vaccinated,daily number of non-White non-Latinx residents vaccinated,total of non-White non-Latinx residents vaccinated,dailyUnknown,totalUnknown,mysteryColumn,Unnamed: 20,Unnamed: 21,Unnamed: 22,Unnamed: 23
0,12/14/2020,32,32,24,24,8,8,1.0,1,0.0,0,0.0,0,8.0,8,0.0,0,0.0,0,2.0,0.0,8.0,0.0,0.0
1,12/15/2020,16,48,6,30,10,18,0.0,1,1.0,1,0.0,0,9.0,17,1.0,1,,0,2.0,0.0,17.0,0.0,0.0
2,12/16/2020,305,353,294,324,11,29,0.0,1,1.0,2,1.0,1,9.0,26,1.0,2,0.0,0,13.0,0.0,25.0,1.0,0.0
3,12/17/2020,990,1343,973,1297,17,46,1.0,2,10.0,12,0.0,1,17.0,43,0.0,2,0.0,0,44.0,0.0,37.0,1.0,0.0
4,12/18/2020,1050,2393,1040,2337,10,56,2.0,4,14.0,26,0.0,1,10.0,53,0.0,2,0.0,0,91.0,0.0,43.0,1.0,1.0
5,12/19/2020,715,3108,712,3049,3,59,0.0,4,14.0,40,0.0,1,3.0,56,0.0,2,0.0,0,106.0,0.0,44.0,1.0,1.0
6,12/20/2020,259,3367,259,3308,0,59,0.0,4,4.0,44,0.0,1,0.0,56,0.0,2,0.0,0,117.0,0.0,44.0,1.0,1.0
7,12/21/2020,355,3722,338,3646,17,76,2.0,6,1.0,45,0.0,1,16.0,72,1.0,3,0.0,0,128.0,0.0,58.0,2.0,1.0
8,12/22/2020,366,4088,357,4003,9,85,1.0,7,6.0,51,0.0,1,9.0,81,0.0,3,0.0,0,154.0,0.0,66.0,2.0,1.0
9,12/23/2020,437,4525,430,4433,7,92,0.0,7,6.0,57,1.0,2,6.0,87,0.0,3,0.0,0,198.0,0.0,71.0,2.0,1.0
10,12/24/2020,104,4629,103,4536,1,93,0.0,7,3.0,60,0.0,2,1.0,88,0.0,3,0.0,0,204.0,0.0,71.0,2.0,1.0
11,12/25/2020,1,4630,1,4537,0,93,,7,,60,0.0,2,,88,,3,,0,205.0,0.0,71.0,2.0,1.0
12,12/26/2020,229,4859,228,4765,1,94,0.0,7,3.0,63,0.0,2,1.0,89,0.0,3,0.0,0,211.0,0.0,71.0,2.0,1.0
13,12/27/2020,279,5138,278,5043,1,95,1.0,8,198.0,261,0.0,2,1.0,90,0.0,3,0.0,0,219.0,0.0,72.0,2.0,1.0
14,12/28/2020,708,5846,698,5741,10,105,0.0,8,392.0,653,0.0,2,9.0,99,1.0,4,0.0,0,236.0,0.0,80.0,3.0,1.0
15,12/29/2020,928,6774,922,6663,6,111,1.0,9,471.0,1124,0.0,2,6.0,105,0.0,4,0.0,0,262.0,0.0,86.0,3.0,1.0
16,12/30/2020,872,7646,866,7529,6,117,1.0,10,276.0,1400,0.0,2,5.0,110,1.0,5,0.0,0,291.0,0.0,91.0,3.0,1.0
17,12/31/2020,923,8569,914,8443,10,127,3.0,13,351.0,1751,0.0,2,10.0,120,0.0,5,0.0,0,311.0,0.0,100.0,3.0,1.0
18,1/1/2021,4,8573,4,8447,0,127,,13,,1751,,2,0.0,120,,5,,0,311.0,0.0,100.0,3.0,1.0
19,1/2/2021,400,8973,395,8842,5,132,1.0,14,150.0,1901,0.0,2,5.0,125,0.0,5,0.0,0,323.0,0.0,104.0,3.0,1.0
20,1/3/2021,118,9091,117,8959,1,133,0.0,14,56.0,1957,0.0,2,1.0,126,0.0,5,0.0,0,326.0,0.0,105.0,3.0,1.0
21,1/4/2021,583,9674,560,9519,23,156,2.0,16,320.0,2277,0.0,2,19.0,145,3.0,8,1.0,1,340.0,0.0,122.0,4.0,2.0
22,1/5/2021,637,10311,622,10141,15,171,2.0,18,410.0,2687,0.0,2,14.0,159,1.0,9,0.0,1,362.0,0.0,133.0,5.0,2.0
23,1/6/2021,1226,11537,908,11049,318,489,3.0,21,527.0,3214,15.0,17,283.0,442,17.0,26,3.0,4,403.0,15.0,405.0,21.0,5.0
24,1/7/2021,1651,13188,698,11747,953,1442,12.0,33,407.0,3621,35.0,52,863.0,1305,40.0,66,15.0,19,428.0,48.0,1230.0,60.0,25.0
25,1/8/2021,1976,15164,975,12722,1001,2443,12.0,45,489.0,4110,43.0,95,898.0,2203,40.0,106,20.0,39,462.0,91.0,2087.0,96.0,48.0
26,1/9/2021,1217,16381,527,13249,690,3133,19.0,64,299.0,4409,19.0,114,627.0,2830,32.0,138,12.0,51,484.0,108.0,2694.0,125.0,66.0
27,1/10/2021,686,17067,413,13662,273,3406,4.0,68,255.0,4664,10.0,124,245.0,3075,13.0,151,5.0,56,499.0,118.0,2932.0,137.0,71.0
28,1/11/2021,1136,18203,798,14460,338,3744,1.0,69,535.0,5199,10.0,134,307.0,3382,16.0,167,5.0,61,515.0,128.0,3227.0,150.0,78.0
29,1/12/2021,1149,19352,858,15318,291,4035,7.0,76,513.0,5712,14.0,148,253.0,3635,17.0,184,7.0,68,543.0,140.0,3467.0,167.0,86.0
30,1/13/2021,1072,20424,825,16143,247,4282,1.0,77,376.0,6088,23.0,171,200.0,3835,15.0,199,9.0,77,580.0,162.0,3654.0,181.0,95.0
31,1/14/2021,853,21277,819,16962,34,4316,2.0,79,491.0,6579,2.0,173,30.0,3865,1.0,200,1.0,78,609.0,164.0,3683.0,182.0,96.0
32,1/15/2021,1219,22496,1206,18168,13,4329,1.0,80,763.0,7342,1.0,174,11.0,3876,0.0,200,1.0,79,655.0,164.0,3694.0,182.0,97.0
33,1/16/2021,983,23479,969,19137,14,4343,2.0,82,595.0,7937,0.0,174,13.0,3889,1.0,201,0.0,79,676.0,164.0,3706.0,182.0,98.0
34,1/17/2021,49,23528,45,19182,4,4347,0.0,82,19.0,7956,1.0,175,3.0,3892,0.0,201,0.0,79,679.0,164.0,3708.0,183.0,98.0
35,1/18/2021,1026,24554,827,20009,199,4546,55.0,137,623.0,8579,8.0,183,178.0,4070,8.0,209,5.0,84,701.0,172.0,3880.0,188.0,108.0
36,1/19/2021,1233,25787,1099,21108,134,4680,9.0,146,719.0,9298,9.0,192,116.0,4186,4.0,213,5.0,89,730.0,178.0,3992.0,192.0,116.0
37,1/20/2021,1426,27213,1202,22310,224,4904,23.0,169,567.0,9865,14.0,206,176.0,4362,10.0,223,24.0,113,764.0,191.0,4155.0,202.0,140.0
38,1/21/2021,2240,29453,2036,24346,204,5108,12.0,181,1596.0,11461,11.0,217,168.0,4530,12.0,235,13.0,126,831.0,202.0,4305.0,210.0,162.0
39,1/22/2021,1677,31130,1408,25754,268,5376,88.0,269,1076.0,12537,35.0,252,212.0,4742,10.0,245,11.0,137,870.0,237.0,4512.0,219.0,174.0
40,1/23/2021,899,32029,559,26313,340,5716,60.0,329,414.0,12951,7.0,259,308.0,5050,14.0,259,11.0,148,886.0,244.0,4806.0,227.0,195.0
41,1/24/2021,387,32416,99,26412,288,6004,209.0,538,56.0,13007,8.0,267,269.0,5319,9.0,268,2.0,150,888.0,252.0,5072.0,235.0,198.0
42,1/25/2021,1404,33820,776,27188,628,6632,379.0,917,551.0,13558,15.0,282,585.0,5904,15.0,283,13.0,163,915.0,265.0,5628.0,247.0,215.0
43,1/26/2021,1635,35455,697,27885,938,7570,471.0,1388,449.0,14007,31.0,313,860.0,6764,31.0,314,16.0,179,940.0,292.0,6451.0,270.0,237.0
44,1/27/2021,1848,37303,775,28660,1073,8643,546.0,1934,328.0,14335,39.0,352,978.0,7742,39.0,353,17.0,196,964.0,323.0,7401.0,295.0,274.0
45,1/28/2021,1355,38658,540,29200,815,9458,369.0,2303,299.0,14634,25.0,377,741.0,8483,22.0,375,27.0,223,977.0,343.0,8121.0,314.0,306.0
46,1/29/2021,1603,40261,1128,30328,475,9933,166.0,2469,824.0,15458,23.0,400,401.0,8884,31.0,406,20.0,243,1003.0,360.0,8504.0,336.0,345.0
47,1/30/2021,1217,41478,720,31048,497,10430,219.0,2688,595.0,16053,23.0,423,444.0,9328,18.0,424,12.0,255,1015.0,381.0,8928.0,353.0,363.0
48,1/31/2021,621,42099,400,31448,221,10651,82.0,2770,360.0,16413,6.0,429,192.0,9520,10.0,434,13.0,268,1021.0,384.0,9114.0,361.0,382.0
49,2/1/2021,1597,43696,887,32335,712,11363,475.0,3245,651.0,17064,18.0,447,654.0,10174,25.0,459,15.0,283,1050.0,400.0,9741.0,379.0,405.0
50,2/2/2021,1838,45534,729,33064,1109,12472,726.0,3971,584.0,17648,42.0,489,1020.0,11194,27.0,486,20.0,303,1070.0,440.0,10715.0,400.0,441.0
51,2/3/2021,1247,46781,578,33642,670,13142,333.0,4304,226.0,17874,47.0,536,562.0,11756,40.0,526,21.0,324,1106.0,482.0,11233.0,429.0,486.0
52,2/4/2021,2523,49304,1787,35429,736,13878,502.0,4806,1550.0,19424,28.0,564,653.0,12409,35.0,561,20.0,344,1148.0,508.0,11850.0,457.0,518.0
53,2/5/2021,2552,51856,1523,36952,1029,14907,692.0,5498,1308.0,20732,42.0,606,929.0,13338,22.0,583,36.0,380,1164.0,540.0,12735.0,475.0,568.0
54,2/6/2021,2172,54028,1557,38509,615,15522,444.0,5942,1207.0,21939,13.0,619,571.0,13909,22.0,605,9.0,389,1198.0,550.0,13280.0,490.0,586.0
55,2/7/2021,228,54256,87,38596,141,15663,95.0,6037,26.0,21965,7.0,626,124.0,14033,3.0,608,7.0,396,1205.0,555.0,13401.0,492.0,596.0
56,2/8/2021,2488,56744,1592,40188,896,16559,609.0,6646,1137.0,23102,28.0,654,816.0,14849,24.0,632,28.0,424,1255.0,579.0,14175.0,513.0,631.0
57,2/9/2021,2376,59120,1570,41758,808,17367,494.0,7140,1014.0,24116,30.0,684,710.0,15559,31.0,663,37.0,461,1294.0,602.0,14840.0,542.0,683.0
58,2/10/2021,1605,60725,1020,42778,585,17952,318.0,7458,304.0,24420,25.0,709,517.0,16076,21.0,684,22.0,483,1346.0,624.0,15318.0,561.0,717.0
59,2/11/2021,3534,64259,2018,44796,1517,19469,1059.0,8517,818.0,25238,56.0,765,1383.0,17459,41.0,725,37.0,520,1424.0,671.0,16643.0,594.0,780.0
60,2/12/2021,3249,67508,1792,46588,1456,20925,963.0,9480,795.0,26033,59.0,824,1330.0,18789,38.0,763,29.0,549,1475.0,724.0,17928.0,628.0,823.0
61,2/13/2021,2999,70507,2386,48974,613,21538,322.0,9802,666.0,26699,14.0,838,563.0,19352,20.0,783,16.0,565,1559.0,737.0,18458.0,646.0,848.0
62,2/14/2021,413,70920,340,49314,73,21611,51.0,9853,40.0,26739,2.0,840,65.0,19417,2.0,785,4.0,569,1571.0,739.0,18519.0,647.0,855.0
63,2/15/2021,2623,73543,2129,51443,494,22105,336.0,10189,254.0,26993,17.0,857,458.0,19875,11.0,796,8.0,577,1629.0,753.0,18952.0,656.0,871.0
64,2/16/2021,2765,76308,1934,53377,831,22936,502.0,10691,227.0,27220,35.0,892,751.0,20626,23.0,819,22.0,599,1720.0,785.0,19671.0,673.0,911.0
65,2/17/2021,1599,77907,633,54010,966,23902,472.0,11163,153.0,27373,31.0,923,881.0,21507,36.0,855,18.0,617,1747.0,806.0,20462.0,705.0,966.0
66,2/18/2021,2647,80554,1678,55688,970,24872,752.0,11915,273.0,27646,37.0,960,882.0,22389,29.0,884,22.0,639,1826.0,841.0,21307.0,729.0,992.0
67,2/19/2021,2416,82970,1046,56734,1370,26242,1032.0,12947,159.0,27805,49.0,1009,1265.0,23654,36.0,920,20.0,659,1870.0,883.0,22528.0,761.0,1029.0
68,2/20/2021,1647,84617,684,57418,963,27205,785.0,13732,129.0,27934,26.0,1035,893.0,24547,28.0,948,16.0,675,1895.0,903.0,23392.0,784.0,1055.0
69,2/21/2021,94,84711,34,57452,60,27265,32.0,13764,7.0,27941,1.0,1036,57.0,24604,1.0,949,1.0,676,1895.0,903.0,23440.0,784.0,1056.0
70,2/22/2021,2027,86738,764,58216,1263,28528,935.0,14699,149.0,28090,40.0,1076,1172.0,25776,35.0,984,16.0,692,1912.0,941.0,24544.0,810.0,1095.0
71,2/23/2021,1213,87951,513,58729,700,29228,471.0,15170,157.0,28247,20.0,1096,629.0,26405,29.0,1013,22.0,714,1921.0,961.0,25142.0,833.0,1132.0
72,2/24/2021,1408,89359,764,59493,644,29872,271.0,15441,134.0,28381,27.0,1123,594.0,26999,14.0,1027,9.0,723,1963.0,984.0,25694.0,844.0,1146.0
73,2/25/2021,3871,93230,2072,61565,1799,31671,1516.0,16957,344.0,28725,48.0,1171,1695.0,28694,34.0,1061,22.0,745,2045.0,1022.0,27324.0,874.0,1192.0
74,2/26/2021,3266,96496,1166,62731,2100,33771,1752.0,18709,210.0,28935,38.0,1209,1981.0,30675,51.0,1112,30.0,775,2077.0,1055.0,29224.0,917.0,1241.0
75,2/27/2021,3483,99979,1664,64395,1818,35589,1562.0,20271,553.0,29488,40.0,1249,1688.0,32363,49.0,1161,41.0,816,2135.0,1087.0,30858.0,955.0,1304.0
76,2/28/2021,422,100401,363,64758,59,35648,37.0,20308,117.0,29605,2.0,1251,52.0,32415,2.0,1163,3.0,819,2147.0,1089.0,30902.0,956.0,1309.0
77,3/1/2021,2795,103196,1335,66093,1468,37116,1081.0,21389,299.0,29904,50.0,1301,1361.0,33776,39.0,1202,18.0,837,2188.0,1136.0,32211.0,986.0,1336.0
78,3/2/2021,3269,106465,1746,67839,1523,38639,1055.0,22444,382.0,30286,38.0,1339,1408.0,35184,38.0,1240,39.0,876,2236.0,1172.0,33559.0,1020.0,1386.0
79,3/3/2021,1640,108105,1065,68904,578,39217,178.0,22622,197.0,30483,32.0,1371,520.0,35704,20.0,1260,6.0,882,2275.0,1206.0,34040.0,1038.0,1396.0
80,3/4/2021,2990,111095,1565,70469,1461,40678,830.0,23452,165.0,30648,48.0,1419,1340.0,37044,48.0,1308,25.0,907,2324.0,1250.0,35329.0,1081.0,1437.0
81,3/5/2021,3467,114562,2058,72527,1460,42138,820.0,24272,427.0,31075,39.0,1458,1347.0,38391,38.0,1346,36.0,943,2438.0,1286.0,36622.0,1111.0,1488.0
82,3/6/2021,4069,118631,2303,74830,2693,44831,858.0,25130,266.0,31341,186.0,1644,2356.0,40747,104.0,1450,47.0,990,2628.0,1458.0,38886.0,1213.0,1560.0
83,3/7/2021,406,119037,293,75123,146,44977,35.0,25165,20.0,31361,4.0,1648,132.0,40879,3.0,1453,7.0,997,2638.0,1460.0,39009.0,1216.0,1568.0
84,3/8/2021,2814,121851,1038,76161,1928,46905,271.0,25436,73.0,31434,54.0,1702,1775.0,42654,65.0,1518,34.0,1031,2679.0,1510.0,40735.0,1268.0,1623.0
85,3/9/2021,3153,125004,1623,77784,1643,48548,255.0,25691,93.0,31527,56.0,1758,1494.0,44148,59.0,1577,34.0,1065,2741.0,1557.0,42185.0,1320.0,1673.0
86,3/10/2021,2360,127364,1347,79131,1096,49644,306.0,25997,84.0,31611,53.0,1811,981.0,45129,31.0,1608,31.0,1096,2826.0,1612.0,43108.0,1349.0,1716.0
87,3/11/2021,4175,131539,2377,81508,1900,51544,398.0,26395,136.0,31747,68.0,1879,1727.0,46856,63.0,1671,42.0,1138,2930.0,1677.0,44756.0,1403.0,1782.0
88,3/12/2021,3909,135448,2567,84075,1452,52996,196.0,26591,64.0,31811,89.0,1968,1268.0,48124,52.0,1723,43.0,1181,3098.0,1754.0,45973.0,1451.0,1842.0
89,3/13/2021,207,135655,132,84207,126,53122,21.0,26612,6.0,31817,2.0,1970,116.0,48240,5.0,1728,3.0,1184,3102.0,1756.0,46080.0,1455.0,1845.0
90,3/14/2021,92,135747,59,84266,34,53156,8.0,26620,1.0,31818,1.0,1971,32.0,48272,1.0,1729,,1184,3104.0,1757.0,46108.0,1456.0,1845.0
91,3/15/2021,889,136636,359,84625,552,53708,83.0,26703,13.0,31831,22.0,1993,509.0,48781,14.0,1743,7.0,1191,3110.0,1776.0,46599.0,1472.0,1854.0
92,3/16/2021,3295,139931,2127,86752,1214,54922,223.0,26926,43.0,31874,71.0,2064,1072.0,49853,39.0,1782,32.0,1223,3177.0,1841.0,47634.0,1507.0,1896.0
93,3/17/2021,2876,142807,1768,88520,1162,56084,232.0,27158,87.0,31961,39.0,2103,1053.0,50906,38.0,1820,32.0,1255,3363.0,1876.0,48628.0,1542.0,1947.0
94,3/18/2021,4013,146820,2100,90620,1951,58035,338.0,27496,96.0,32057,100.0,2203,1747.0,52653,57.0,1877,47.0,1302,3458.0,1969.0,50296.0,1593.0,2024.0
95,3/19/2021,2986,149806,1729,92349,1282,59317,224.0,27720,41.0,32098,69.0,2272,1149.0,53802,42.0,1919,22.0,1324,3519.0,2031.0,51406.0,1627.0,2074.0
96,3/20/2021,3057,152863,1949,94298,1154,60471,312.0,28032,51.0,32149,39.0,2311,1038.0,54840,49.0,1968,28.0,1352,3620.0,2063.0,52392.0,1670.0,2123.0
97,3/21/2021,649,153512,389,94687,283,60754,28.0,28060,5.0,32154,13.0,2324,249.0,55089,18.0,1986,3.0,1355,3636.0,2074.0,52628.0,1687.0,2129.0
98,3/22/2021,3122,156634,2251,96938,905,61659,189.0,28249,59.0,32213,20.0,2344,829.0,55918,36.0,2022,20.0,1375,3777.0,2091.0,53425.0,1717.0,2159.0
99,3/23/2021,4460,161094,3591,100529,1712,63371,194.0,28443,77.0,32290,70.0,2414,1482.0,57400,99.0,2121,61.0,1436,3972.0,2152.0,54828.0,1807.0,2235.0
100,3/24/2021,3110,164204,2392,102921,777,64148,117.0,28560,35.0,32325,50.0,2464,686.0,58086,26.0,2147,15.0,1451,4089.0,2199.0,55471.0,1830.0,2264.0
101,3/25/2021,5045,169249,3050,105971,2024,66172,306.0,28866,68.0,32393,71.0,2535,1833.0,59919,65.0,2212,55.0,1506,4229.0,2262.0,57224.0,1887.0,2357.0
102,3/26/2021,4577,173826,2780,108751,1840,68012,300.0,29166,94.0,32487,115.0,2650,1582.0,61501,106.0,2318,37.0,1543,4317.0,2362.0,58702.0,1990.0,2427.0
103,3/27/2021,3322,177148,1903,110654,1424,69436,328.0,29494,23.0,32510,49.0,2699,1307.0,62808,42.0,2360,26.0,1569,4395.0,2407.0,59937.0,2030.0,2461.0
104,3/28/2021,1146,178294,794,111448,355,69791,91.0,29585,14.0,32524,13.0,2712,323.0,63131,14.0,2374,5.0,1574,4510.0,2419.0,60247.0,2044.0,2466.0
105,3/29/2021,3988,182282,2677,114125,1334,71125,236.0,29821,50.0,32574,44.0,2756,1244.0,64375,25.0,2399,21.0,1595,4598.0,2461.0,61425.0,2069.0,2496.0
106,3/30/2021,4352,186634,2738,116863,1700,72825,241.0,30062,75.0,32649,60.0,2816,1539.0,65914,65.0,2464,36.0,1631,4697.0,2516.0,62905.0,2129.0,2553.0
107,3/31/2021,3484,190118,2493,119356,1057,73882,166.0,30228,47.0,32696,40.0,2856,944.0,66858,46.0,2510,27.0,1658,4838.0,2551.0,63802.0,2171.0,2598.0
108,4/1/2021,5000,195118,3248,122604,1812,75694,146.0,30374,72.0,32768,74.0,2930,1649.0,68507,55.0,2565,34.0,1692,5052.0,2613.0,65382.0,2220.0,2654.0
109,4/2/2021,4658,199776,2481,125085,2213,77907,247.0,30621,48.0,32816,87.0,3017,2002.0,70509,83.0,2648,41.0,1733,5115.0,2695.0,67320.0,2296.0,2710.0
110,4/3/2021,4266,204042,3547,128632,836,78743,91.0,30712,39.0,32855,40.0,3057,736.0,71245,25.0,2673,35.0,1768,5227.0,2730.0,68011.0,2319.0,2760.0
111,4/4/2021,352,204394,243,128875,162,78905,7.0,30719,7.0,32862,4.0,3061,142.0,71387,11.0,2684,5.0,1773,5235.0,2734.0,68145.0,2330.0,2765.0
112,4/5/2021,4658,209052,3747,132622,1039,79944,81.0,30800,47.0,32909,70.0,3131,902.0,72289,44.0,2728,23.0,1796,5367.0,2795.0,69003.0,2367.0,2809.0
113,4/6/2021,5127,214179,3008,135630,2635,82579,89.0,30889,56.0,32965,97.0,3228,2301.0,74590,153.0,2881,84.0,1880,5484.0,2877.0,71197.0,2506.0,2936.0
114,4/7/2021,4908,219087,3672,139302,3466,86045,84.0,30973,107.0,33072,143.0,3371,2976.0,77566,212.0,3093,135.0,2015,5599.0,3002.0,73942.0,2694.0,3115.0
115,4/8/2021,6671,225758,4492,143794,4004,90049,168.0,31141,121.0,33193,175.0,3546,3494.0,81060,204.0,3297,131.0,2146,5805.0,3154.0,77315.0,2871.0,3313.0
116,4/9/2021,5690,231448,3250,147044,4167,94216,90.0,31231,68.0,33261,195.0,3741,3623.0,84683,218.0,3515,131.0,2277,5922.0,3328.0,80815.0,3062.0,3511.0
117,4/10/2021,4380,235828,3105,150149,2380,96596,70.0,31301,68.0,33329,134.0,3875,1998.0,86681,171.0,3686,77.0,2354,6259.0,3448.0,82759.0,3216.0,3613.0
118,4/11/2021,1010,236838,780,150929,341,96937,6.0,31307,10.0,33339,11.0,3886,283.0,86964,37.0,3723,10.0,2364,6302.0,3458.0,83031.0,3252.0,3626.0
119,4/12/2021,5032,241870,3640,154569,2656,99593,97.0,31404,96.0,33435,100.0,3986,2308.0,89272,162.0,3885,86.0,2450,6441.0,3540.0,85236.0,3397.0,3760.0
120,4/13/2021,5061,246931,3591,158160,1516,101109,58.0,31462,76.0,33511,76.0,4062,1321.0,90593,89.0,3974,30.0,2480,6660.0,3604.0,86502.0,3475.0,3812.0
121,4/14/2021,2874,249805,1393,159553,1481,102590,86.0,31548,26.0,33537,88.0,4150,1280.0,91873,63.0,4037,50.0,2530,6718.0,3687.0,87721.0,3530.0,3883.0
122,4/15/2021,4934,254739,2314,161867,2621,105211,98.0,31646,54.0,33591,230.0,4380,2159.0,94032,156.0,4193,76.0,2606,6843.0,3898.0,89809.0,3666.0,4008.0
123,4/16/2021,3880,258619,2066,163933,1814,107025,45.0,31691,32.0,33623,73.0,4453,1570.0,95602,116.0,4309,55.0,2661,6932.0,3960.0,91324.0,3768.0,4096.0
124,4/17/2021,4540,263159,2376,166309,2164,109189,36.0,31727,57.0,33680,111.0,4564,1865.0,97467,127.0,4436,61.0,2722,7033.0,4049.0,93114.0,3882.0,4201.0
125,4/18/2021,1001,264160,410,166719,591,109780,11.0,31738,11.0,33691,37.0,4601,504.0,97971,27.0,4463,23.0,2745,7106.0,4084.0,93588.0,3908.0,4245.0
126,4/19/2021,3853,268013,1410,168129,2443,112223,44.0,31782,42.0,33733,176.0,4777,2041.0,100012,150.0,4613,76.0,2821,7142.0,4239.0,95563.0,4047.0,4355.0
127,4/20/2021,4700,272713,1871,170000,2829,115052,47.0,31829,68.0,33801,153.0,4930,2396.0,102408,175.0,4788,105.0,2926,7211.0,4371.0,97857.0,4208.0,4510.0
128,4/21/2021,3113,275826,706,170706,2406,117458,32.0,31861,32.0,33833,145.0,5075,2022.0,104430,151.0,4939,88.0,3014,7274.0,4494.0,99767.0,4350.0,4622.0
129,4/22/2021,4621,280447,1756,172462,2865,120323,47.0,31908,63.0,33896,151.0,5226,2442.0,106872,182.0,5121,90.0,3104,7367.0,4619.0,102136.0,4519.0,4746.0
130,4/23/2021,3541,283988,1172,173634,2369,122692,39.0,31947,32.0,33928,81.0,5307,2078.0,108950,117.0,5238,93.0,3197,7430.0,4681.0,104157.0,4622.0,4875.0
131,4/24/2021,3342,287330,1100,174734,2242,124934,12.0,31959,21.0,33949,114.0,5421,1871.0,110821,180.0,5418,77.0,3274,7497.0,4775.0,105979.0,4787.0,4981.0
132,4/25/2021,766,288096,340,175074,427,125361,6.0,31965,6.0,33955,105.0,5526,247.0,111068,31.0,5449,44.0,3318,7551.0,4863.0,106199.0,4816.0,5040.0
133,4/26/2021,4306,292402,1103,176177,3203,128564,32.0,31997,30.0,33985,149.0,5675,2764.0,113832,196.0,5645,94.0,3412,7639.0,4984.0,108782.0,4995.0,5178.0
134,4/27/2021,3334,295736,1204,177381,2149,130713,38.0,32035,36.0,34021,81.0,5756,1881.0,115713,125.0,5770,62.0,3474,7710.0,5055.0,110511.0,5105.0,5272.0
135,4/28/2021,2906,298642,712,178093,2219,132932,44.0,32079,22.0,34043,166.0,5922,1777.0,117490,181.0,5951,95.0,3569,7747.0,5199.0,112212.0,5276.0,5404.0
136,4/29/2021,3894,302536,819,178912,3088,136020,63.0,32142,35.0,34078,231.0,6153,2528.0,120018,223.0,6174,106.0,3675,7790.0,5389.0,114638.0,5490.0,5568.0
137,4/30/2021,2800,305336,630,179542,2193,138213,47.0,32189,24.0,34102,67.0,6220,1859.0,121877,183.0,6357,84.0,3759,7824.0,5451.0,116436.0,5655.0,5670.0
138,5/1/2021,3551,308887,801,180343,2760,140973,34.0,32223,16.0,34118,309.0,6529,2137.0,124014,186.0,6543,128.0,3887,7943.0,5676.0,118035.0,5785.0,5872.0
139,5/2/2021,497,309384,230,180573,293,141266,8.0,32231,3.0,34121,9.0,6538,234.0,124248,36.0,6579,14.0,3901,7968.0,5685.0,118244.0,5818.0,5891.0
140,5/3/2021,3420,312804,657,181230,2793,144059,44.0,32275,35.0,34156,116.0,6654,2384.0,126632,196.0,6775,97.0,3998,8004.0,5776.0,120527.0,5998.0,6025.0
141,5/4/2021,4363,317167,709,181939,3718,147777,68.0,32343,30.0,34186,150.0,6804,3177.0,129809,242.0,7017,149.0,4147,8051.0,5893.0,123585.0,6227.0,6233.0
142,5/5/2021,2173,319340,474,182413,1762,149539,65.0,32408,25.0,34211,83.0,6887,1451.0,131260,136.0,7153,92.0,4239,8077.0,5955.0,124972.0,6353.0,6367.0
143,5/6/2021,3654,322994,823,183236,3028,152567,102.0,32510,40.0,34251,195.0,7082,2484.0,133744,190.0,7343,159.0,4398,8122.0,6122.0,127365.0,6533.0,6575.0
144,5/7/2021,2912,325906,543,183779,2517,155084,46.0,32556,11.0,34262,147.0,7229,2053.0,135797,200.0,7543,117.0,4515,8146.0,6242.0,129348.0,6719.0,6731.0
145,5/8/2021,2993,328899,558,184337,2619,157703,49.0,32605,16.0,34278,193.0,7422,2094.0,137891,184.0,7727,148.0,4663,8176.0,6393.0,131329.0,6884.0,6942.0
146,5/9/2021,345,329244,134,184471,229,157932,4.0,32609,2.0,34280,9.0,7431,191.0,138082,19.0,7746,10.0,4673,8184.0,6400.0,131502.0,6902.0,6955.0
147,5/10/2021,2407,331651,366,184837,2108,160040,64.0,32673,15.0,34295,96.0,7527,1696.0,139778,202.0,7948,114.0,4787,8206.0,6475.0,133080.0,7087.0,7097.0
148,5/11/2021,2702,334353,536,185373,2233,162273,89.0,32762,24.0,34319,207.0,7734,1719.0,141497,197.0,8145,110.0,4897,8236.0,6657.0,134707.0,7258.0,7259.0
149,5/12/2021,1166,335519,450,185823,799,163072,24.0,32786,13.0,34332,54.0,7788,629.0,142126,81.0,8226,35.0,4932,8257.0,6697.0,135274.0,7334.0,7317.0
150,5/13/2021,3211,338730,1021,186844,2235,165307,82.0,32868,24.0,34356,166.0,7954,1800.0,143926,153.0,8379,116.0,5048,8329.0,6825.0,136991.0,7469.0,7492.0
151,5/14/2021,2426,341156,1282,188126,1286,166593,52.0,32920,28.0,34384,68.0,8022,1070.0,144996,93.0,8472,55.0,5103,8391.0,6875.0,138006.0,7553.0,7571.0
152,5/15/2021,2952,344108,1491,189617,1597,168190,41.0,32961,15.0,34399,116.0,8138,1267.0,146263,140.0,8612,74.0,5177,8472.0,6966.0,139243.0,7683.0,7669.0
153,5/16/2021,925,345033,563,190180,407,168597,5.0,32966,7.0,34406,88.0,8226,250.0,146513,28.0,8640,41.0,5218,8542.0,7037.0,139468.0,7709.0,7722.0
154,5/17/2021,2404,347437,1210,191390,1299,169896,36.0,33002,27.0,34433,53.0,8279,1081.0,147594,99.0,8739,66.0,5284,8608.0,7077.0,140492.0,7804.0,7806.0
155,5/18/2021,2530,349967,1149,192539,1440,171336,44.0,33046,21.0,34454,76.0,8355,1201.0,148795,83.0,8822,80.0,5364,8695.0,7135.0,141660.0,7876.0,7917.0
156,5/19/2021,1859,351826,1147,193686,796,172132,26.0,33072,19.0,34473,42.0,8397,650.0,149445,62.0,8884,42.0,5406,8777.0,7172.0,142269.0,7933.0,7971.0
157,5/20/2021,1916,353742,911,194597,1075,173207,48.0,33120,28.0,34501,95.0,8492,854.0,150299,77.0,8961,49.0,5455,8854.0,7256.0,143078.0,8008.0,8043.0
158,5/21/2021,1593,355335,910,195507,795,174002,21.0,33141,16.0,34517,51.0,8543,634.0,150933,53.0,9014,57.0,5512,8918.0,7295.0,143674.0,8052.0,8117.0
159,5/22/2021,1645,356980,783,196290,907,174909,8.0,33149,14.0,34531,137.0,8680,630.0,151563,72.0,9086,68.0,5580,8985.0,7402.0,144289.0,8118.0,8223.0
160,5/23/2021,664,357644,337,196627,360,175269,2.0,33151,5.0,34536,68.0,8748,224.0,151787,19.0,9105,49.0,5629,9026.0,7464.0,144496.0,8137.0,8281.0
161,5/24/2021,1309,358953,529,197156,871,176140,40.0,33191,17.0,34553,50.0,8798,702.0,152489,81.0,9186,38.0,5667,9066.0,7499.0,145172.0,8208.0,8341.0
162,5/25/2021,1200,360153,488,197644,764,176904,27.0,33218,19.0,34572,57.0,8855,592.0,153081,63.0,9249,52.0,5719,9098.0,7554.0,145733.0,8264.0,8401.0
163,5/26/2021,923,361076,534,198178,534,177438,20.0,33238,25.0,34597,36.0,8891,429.0,153510,43.0,9292,26.0,5745,9146.0,7582.0,146123.0,8304.0,8440.0
164,5/27/2021,1227,362303,643,198821,676,178114,30.0,33268,20.0,34617,59.0,8950,542.0,154052,46.0,9338,29.0,5774,9194.0,7630.0,146634.0,8345.0,8484.0
165,5/28/2021,1016,363319,590,199411,496,178610,19.0,33287,22.0,34639,37.0,8987,384.0,154436,45.0,9383,30.0,5804,9237.0,7658.0,146996.0,8389.0,8528.0
166,5/29/2021,1014,364333,497,199908,569,179179,16.0,33303,9.0,34648,37.0,9024,444.0,154880,44.0,9427,44.0,5848,9286.0,7689.0,147412.0,8425.0,8583.0
167,5/30/2021,311,364644,208,200116,145,179324,5.0,33308,3.0,34651,14.0,9038,105.0,154985,16.0,9443,10.0,5858,9303.0,7699.0,147512.0,8440.0,8595.0
168,5/31/2021,320,364964,187,200303,172,179496,8.0,33316,6.0,34657,8.0,9046,140.0,155125,12.0,9455,12.0,5870,9320.0,7706.0,147649.0,8452.0,8609.0
169,6/1/2021,931,365895,381,200684,610,180106,29.0,33345,17.0,34674,54.0,9100,474.0,155599,39.0,9494,43.0,5913,9352.0,7746.0,148078.0,8485.0,8664.0
170,6/2/2021,692,366587,351,201035,408,180514,14.0,33359,9.0,34683,34.0,9134,332.0,155931,18.0,9512,24.0,5937,9395.0,7776.0,148371.0,8500.0,8700.0
171,6/3/2021,1288,367875,520,201555,837,181351,24.0,33383,12.0,34695,53.0,9187,695.0,156626,51.0,9563,38.0,5975,9471.0,7819.0,149011.0,8544.0,8756.0
172,6/4/2021,1490,369365,409,201964,1136,182487,14.0,33397,9.0,34704,67.0,9254,951.0,157577,70.0,9633,48.0,6023,9520.0,7880.0,149911.0,8603.0,8818.0
173,6/5/2021,1395,370760,363,202327,1074,183561,12.0,33409,6.0,34710,69.0,9323,875.0,158452,86.0,9719,44.0,6067,9569.0,7937.0,150716.0,8684.0,8882.0
174,6/6/2021,510,371270,137,202464,391,183952,5.0,33414,3.0,34713,36.0,9359,317.0,158769,24.0,9743,14.0,6081,9587.0,7971.0,151008.0,8706.0,8895.0
175,6/7/2021,1176,372446,331,202795,907,184859,14.0,33428,12.0,34725,70.0,9429,727.0,159496,80.0,9823,30.0,6111,9623.0,8033.0,151688.0,8781.0,8931.0
176,6/8/2021,1056,373502,246,203041,849,185708,16.0,33444,5.0,34730,60.0,9489,690.0,160186,62.0,9885,37.0,6148,9637.0,8082.0,152335.0,8840.0,8985.0
177,6/9/2021,1054,374556,280,203321,837,186545,14.0,33458,13.0,34743,76.0,9565,652.0,160838,61.0,9946,48.0,6196,9654.0,8139.0,152872.0,8891.0,9036.0
178,6/10/2021,1276,375832,333,203654,999,187544,19.0,33477,5.0,34748,96.0,9661,789.0,161627,63.0,10009,51.0,6247,9680.0,8216.0,153542.0,8947.0,9085.0
179,6/11/2021,1094,376926,324,203978,826,188370,18.0,33495,13.0,34761,58.0,9719,647.0,162274,73.0,10082,48.0,6295,9703.0,8263.0,153943.0,8992.0,9128.0
180,6/12/2021,1023,377949,292,204270,785,189155,17.0,33512,10.0,34771,78.0,9797,611.0,162885,57.0,10139,39.0,6334,9724.0,8327.0,154437.0,9039.0,9181.0
181,6/13/2021,365,378314,96,204366,285,189440,4.0,33516,1.0,34772,35.0,9832,205.0,163090,23.0,10162,22.0,6356,9728.0,8346.0,154480.0,9046.0,9200.0
182,6/14/2021,797,379111,271,204637,575,190015,14.0,33530,4.0,34776,44.0,9876,446.0,163536,44.0,10206,41.0,6397,,,,,
183,6/15/2021,666,379777,240,204877,456,190471,20.0,33550,10.0,34786,39.0,9915,375.0,163911,28.0,10234,14.0,6411,,,,,
184,6/16/2021,606,380383,207,205084,436,190907,12.0,33562,5.0,34791,35.0,9950,332.0,164243,28.0,10262,41.0,6452,,,,,
185,6/17/2021,664,381047,242,205326,455,191362,14.0,33576,10.0,34801,45.0,9995,341.0,164584,48.0,10310,21.0,6473,,,,,
186,6/18/2021,994,382041,368,205694,671,192033,22.0,33598,11.0,34812,53.0,10048,538.0,165122,54.0,10364,26.0,6499,,,,,
187,6/19/2021,629,382670,153,205847,500,192533,10.0,33608,7.0,34819,51.0,10099,371.0,165493,49.0,10413,29.0,6528,,,,,
188,6/20/2021,285,382955,110,205957,188,192721,3.0,33611,2.0,34821,38.0,10137,112.0,165605,14.0,10427,24.0,6552,,,,,
189,6/21/2021,497,383452,211,206168,324,193045,5.0,33616,8.0,34829,29.0,10166,240.0,165845,35.0,10462,20.0,6572,,,,,
190,6/22/2021,589,384041,244,206412,384,193429,13.0,33629,7.0,34836,31.0,10197,303.0,166148,21.0,10483,29.0,6601,,,,,
191,6/23/2021,504,384545,195,206607,348,193777,8.0,33637,9.0,34845,39.0,10236,252.0,166400,34.0,10517,23.0,6624,,,,,
192,6/24/2021,515,385060,213,206820,331,194108,12.0,33649,9.0,34854,28.0,10264,259.0,166659,21.0,10538,23.0,6647,,,,,
193,6/25/2021,680,385740,267,207087,441,194549,13.0,33662,8.0,34862,50.0,10314,325.0,166984,37.0,10575,29.0,6676,,,,,
194,6/26/2021,593,386333,168,207255,442,194991,10.0,33672,8.0,34870,78.0,10392,290.0,167274,40.0,10615,34.0,6710,,,,,
195,6/27/2021,175,386508,73,207328,106,195097,2.0,33674,3.0,34873,10.0,10402,76.0,167350,10.0,10625,10.0,6720,,,,,
196,6/28/2021,479,386987,211,207539,282,195379,6.0,33680,7.0,34880,40.0,10442,202.0,167552,24.0,10649,16.0,6736,,,,,
197,6/29/2021,536,387523,256,207795,320,195699,17.0,33697,11.0,34891,44.0,10486,233.0,167785,20.0,10669,23.0,6759,,,,,
198,6/30/2021,388,387911,196,207991,215,195914,8.0,33705,11.0,34902,17.0,10503,163.0,167948,16.0,10685,19.0,6778,,,,,
199,7/1/2021,466,388377,202,208193,292,196206,10.0,33715,8.0,34910,20.0,10523,224.0,168172,29.0,10714,19.0,6797,,,,,
200,7/2/2021,551,388928,268,208461,302,196508,5.0,33720,7.0,34917,26.0,10549,238.0,168410,21.0,10735,17.0,6814,,,,,
201,7/3/2021,296,389224,116,208577,193,196701,4.0,33724,4.0,34921,34.0,10583,128.0,168538,19.0,10754,12.0,6826,,,,,
202,7/4/2021,53,389277,19,208596,34,196735,1.0,33725,0.0,34921,5.0,10588,21.0,168559,1.0,10755,7.0,6833,,,,,
203,7/5/2021,293,389570,134,208730,163,196898,3.0,33728,1.0,34922,17.0,10605,113.0,168672,22.0,10777,11.0,6844,,,,,
204,7/6/2021,433,390003,184,208914,264,197162,4.0,33732,5.0,34927,44.0,10649,189.0,168861,15.0,10792,16.0,6860,,,,,
205,7/7/2021,365,390368,211,209125,177,197339,9.0,33741,6.0,34933,19.0,10668,136.0,168997,9.0,10801,13.0,6873,,,,,
206,7/8/2021,417,390785,198,209323,247,197586,11.0,33752,8.0,34941,27.0,10695,174.0,169171,22.0,10823,24.0,6897,,,,,
207,7/9/2021,475,391260,190,209513,298,197884,10.0,33762,3.0,34944,35.0,10730,219.0,169390,24.0,10847,20.0,6917,,,,,
208,7/10/2021,251,391511,141,209654,128,198012,5.0,33767,2.0,34946,6.0,10736,106.0,169496,11.0,10858,5.0,6922,,,,,
209,7/11/2021,220,391731,124,209778,128,198140,6.0,33773,6.0,34952,10.0,10746,94.0,169590,10.0,10868,14.0,6936,,,,,
210,7/12/2021,370,392101,201,209979,186,198326,6.0,33779,4.0,34956,26.0,10772,123.0,169713,20.0,10888,17.0,6953,,,,,
211,7/13/2021,417,392518,219,210198,221,198547,15.0,33794,10.0,34966,26.0,10798,172.0,169885,12.0,10900,11.0,6964,,,,,
212,7/14/2021,281,392799,145,210343,168,198715,8.0,33802,4.0,34970,19.0,10817,121.0,170006,10.0,10910,18.0,6982,,,,,
213,7/15/2021,350,393149,183,210526,180,198895,1.0,33803,4.0,34974,16.0,10833,136.0,170142,13.0,10923,15.0,6997,,,,,
214,7/16/2021,504,393653,242,210768,278,199173,8.0,33811,8.0,34982,21.0,10854,219.0,170361,18.0,10941,20.0,7017,,,,,
215,7/17/2021,278,393931,161,210929,137,199310,12.0,33823,5.0,34987,12.0,10866,102.0,170463,11.0,10952,12.0,7029,,,,,
216,7/18/2021,189,394120,119,211048,89,199399,3.0,33826,3.0,34990,14.0,10880,63.0,170526,7.0,10959,5.0,7034,,,,,
217,7/19/2021,401,394521,205,211253,211,199610,9.0,33835,8.0,34998,27.0,10907,156.0,170682,16.0,10975,12.0,7046,,,,,
218,7/20/2021,403,394924,207,211460,212,199822,6.0,33841,8.0,35006,16.0,10923,161.0,170843,20.0,10995,15.0,7061,,,,,
219,7/21/2021,311,395235,175,211635,161,199983,13.0,33854,14.0,35020,12.0,10935,121.0,170964,12.0,11007,16.0,7077,,,,,
220,7/22/2021,383,395618,234,211869,168,200151,8.0,33862,18.0,35038,19.0,10954,121.0,171085,17.0,11024,11.0,7088,,,,,
221,7/23/2021,534,396152,314,212183,230,200381,6.0,33868,10.0,35048,33.0,10987,162.0,171247,17.0,11041,18.0,7106,,,,,
222,7/24/2021,349,396501,218,212401,159,200540,10.0,33878,10.0,35058,19.0,11006,117.0,171364,9.0,11050,14.0,7120,,,,,
223,7/25/2021,197,396698,148,212549,65,200605,1.0,33879,4.0,35062,7.0,11013,47.0,171411,5.0,11055,6.0,7126,,,,,
224,7/26/2021,336,397034,206,212755,140,200745,1.0,33880,7.0,35069,7.0,11020,100.0,171511,15.0,11070,18.0,7144,,,,,
225,7/27/2021,386,397420,237,212992,163,200908,5.0,33885,16.0,35085,19.0,11039,117.0,171628,16.0,11086,11.0,7155,,,,,
226,7/28/2021,454,397874,280,213272,220,201128,4.0,33889,9.0,35094,28.0,11067,141.0,171769,15.0,11101,36.0,7191,,,,,
227,7/29/2021,487,398361,308,213580,225,201353,7.0,33896,6.0,35100,25.0,11092,168.0,171937,12.0,11113,20.0,7211,,,,,
228,7/30/2021,663,399024,468,214048,240,201593,10.0,33906,15.0,35115,27.0,11119,181.0,172118,15.0,11128,17.0,7228,,,,,
229,7/31/2021,312,399336,195,214243,128,201721,4.0,33910,1.0,35116,11.0,11130,102.0,172220,8.0,11136,7.0,7235,,,,,
230,8/1/2021,244,399580,159,214402,98,201819,0.0,33910,2.0,35118,12.0,11142,63.0,172283,6.0,11142,17.0,7252,,,,,
231,8/2/2021,434,400014,297,214699,172,201991,4.0,33914,13.0,35131,20.0,11162,116.0,172399,20.0,11162,16.0,7268,,,,,
232,8/3/2021,549,400563,344,215043,238,202229,6.0,33920,13.0,35144,37.0,11199,163.0,172562,14.0,11176,24.0,7292,,,,,
233,8/4/2021,370,400933,266,215309,140,202369,5.0,33925,14.0,35158,10.0,11209,103.0,172665,5.0,11181,22.0,7314,,,,,
234,8/5/2021,431,401364,286,215595,163,202532,5.0,33930,10.0,35168,20.0,11229,113.0,172778,17.0,11198,13.0,7327,,,,,
235,8/6/2021,663,402027,461,216056,262,202794,12.0,33942,16.0,35184,22.0,11251,195.0,172973,23.0,11221,22.0,7349,,,,,
236,8/7/2021,428,402455,299,216355,157,202951,3.0,33945,10.0,35194,13.0,11264,124.0,173097,4.0,11225,16.0,7365,,,,,
237,8/8/2021,216,402671,129,216484,102,203053,3.0,33948,4.0,35198,8.0,11272,75.0,173172,6.0,11231,13.0,7378,,,,,
238,8/9/2021,449,403120,278,216762,214,203267,4.0,33952,6.0,35204,20.0,11292,163.0,173335,13.0,11244,18.0,7396,,,,,
239,8/10/2021,486,403606,294,217056,222,203489,5.0,33957,13.0,35217,25.0,11317,171.0,173506,12.0,11256,14.0,7410,,,,,
240,8/11/2021,396,404002,257,217313,167,203656,11.0,33968,5.0,35222,13.0,11330,128.0,173634,14.0,11270,12.0,7422,,,,,
241,8/12/2021,517,404519,310,217623,255,203911,6.0,33974,15.0,35237,31.0,11361,181.0,173815,22.0,11292,21.0,7443,,,,,
242,8/13/2021,644,405163,375,217998,297,204208,12.0,33986,10.0,35247,29.0,11390,221.0,174036,17.0,11309,30.0,7473,,,,,
243,8/14/2021,451,405614,259,218257,253,204461,7.0,33993,8.0,35255,9.0,11399,218.0,174254,9.0,11318,17.0,7490,,,,,
244,8/15/2021,250,405864,132,218389,126,204587,2.0,33995,5.0,35260,10.0,11409,93.0,174347,7.0,11325,16.0,7506,,,,,
245,8/16/2021,438,406302,296,218685,170,204757,6.0,34001,14.0,35274,13.0,11422,131.0,174478,13.0,11338,13.0,7519,,,,,
246,8/17/2021,386,406688,225,218910,183,204940,16.0,34017,10.0,35284,17.0,11439,138.0,174616,8.0,11346,20.0,7539,,,,,
247,8/18/2021,508,407196,325,219235,258,205198,6.0,34023,15.0,35299,32.0,11471,171.0,174787,12.0,11358,43.0,7582,,,,,
248,8/19/2021,467,407663,274,219509,253,205451,7.0,34030,8.0,35307,21.0,11492,199.0,174986,15.0,11373,18.0,7600,,,,,
249,8/20/2021,730,408393,334,219843,447,205898,18.0,34048,13.0,35320,49.0,11541,350.0,175336,28.0,11401,20.0,7620,,,,,
250,8/21/2021,381,408774,190,220033,199,206097,5.0,34053,9.0,35329,14.0,11555,163.0,175499,11.0,11412,11.0,7631,,,,,
251,8/22/2021,267,409041,142,220175,135,206232,1.0,34054,1.0,35330,17.0,11572,95.0,175594,9.0,11421,14.0,7645,,,,,
252,8/23/2021,405,409446,227,220402,199,206431,11.0,34065,8.0,35338,17.0,11589,149.0,175743,11.0,11432,22.0,7667,,,,,
253,8/24/2021,487,409933,266,220668,261,206692,12.0,34077,13.0,35351,22.0,11611,206.0,175949,12.0,11444,21.0,7688,,,,,
254,8/25/2021,532,410465,315,220983,252,206944,11.0,34088,14.0,35365,19.0,11630,189.0,176138,9.0,11453,35.0,7723,,,,,
255,8/26/2021,456,410921,244,221227,239,207183,10.0,34098,12.0,35377,18.0,11648,182.0,176320,22.0,11475,17.0,7740,,,,,
256,8/27/2021,682,411603,336,221563,384,207567,16.0,34114,12.0,35389,34.0,11682,281.0,176601,22.0,11497,47.0,7787,,,,,
257,8/28/2021,415,412018,192,221755,229,207796,8.0,34122,16.0,35405,22.0,11704,171.0,176772,12.0,11509,24.0,7811,,,,,
258,8/29/2021,154,412172,87,221842,67,207863,2.0,34124,13.0,35418,1.0,11705,53.0,176825,7.0,11516,6.0,7817,,,,,
