,Date,daily number of doses received by Larimer County residents,total number of doses recevied by residents,daily number of residents receiving first dose,total number of residents receiving first dose,daily number of residents vaccinated,total number of residents vaccinated,daily number of 70+ vaccinated,total number of 70+ vaccinated,daily number of 70+ at least one dose,total number of 70+ at least one dose,daily number of Latinx residents vaccinated,total of Latinx residents vaccinated,daily number of White non-Latinx residents vaccinated,total of White non-Latinx residents vaccinated,daily number of non-White non-Latinx residents vaccinated,total of non-White non-Latinx residents vaccinated,dailyUnknown,totalUnknown,daily_additional_doses,total_additional_doses
0,12/14/2020,32,32,32,32,1,1,0.0,0,1.0,1,0.0,0,1,1,0.0,0,,0,0,0
1,12/15/2020,14,46,14,46,0,1,,0,,1,,0,0,1,0.0,0,,0,0,0
2,12/16/2020,304,350,304,350,0,1,0.0,0,2.0,3,0.0,0,0,1,0.0,0,0.0,0,0,0
3,12/17/2020,989,1339,989,1339,0,1,0.0,0,11.0,14,0.0,0,0,1,0.0,0,0.0,0,0,0
4,12/18/2020,1053,2392,1053,2392,2,3,0.0,0,15.0,29,0.0,0,2,3,0.0,0,0.0,0,0,0
5,12/19/2020,722,3114,722,3114,0,3,0.0,0,14.0,43,0.0,0,0,3,0.0,0,0.0,0,0,0
6,12/20/2020,267,3381,267,3381,0,3,0.0,0,4.0,47,0.0,0,0,3,0.0,0,0.0,0,0,0
7,12/21/2020,358,3739,358,3739,3,6,0.0,0,3.0,50,0.0,0,3,6,0.0,0,0.0,0,0,0
8,12/22/2020,363,4102,363,4102,0,6,0.0,0,7.0,57,0.0,0,0,6,0.0,0,0.0,0,0,0
9,12/23/2020,441,4543,441,4543,0,6,0.0,0,6.0,63,0.0,0,0,6,0.0,0,0.0,0,0,0
10,12/24/2020,104,4647,104,4647,0,6,0.0,0,3.0,66,0.0,0,0,6,0.0,0,0.0,0,0,0
11,12/25/2020,1,4648,1,4648,0,6,,0,,66,,0,0,6,,0,,0,0,0
12,12/26/2020,227,4875,227,4875,1,7,0.0,0,3.0,69,0.0,0,1,7,0.0,0,0.0,0,0,0
13,12/27/2020,278,5153,278,5153,0,7,0.0,0,197.0,266,0.0,0,0,7,0.0,0,,0,0,0
14,12/28/2020,708,5861,708,5861,0,7,0.0,0,385.0,651,0.0,0,0,7,0.0,0,0.0,0,0,0
15,12/29/2020,915,6776,914,6775,1,8,0.0,0,462.0,1113,0.0,0,1,8,0.0,0,0.0,0,0,0
16,12/30/2020,883,7659,883,7658,0,8,0.0,0,273.0,1386,0.0,0,0,8,0.0,0,0.0,0,0,0
17,12/31/2020,894,8553,894,8552,0,8,0.0,0,343.0,1729,0.0,0,0,8,0.0,0,0.0,0,0,0
18,1/1/2021,4,8557,3,8555,1,9,,0,,1729,,0,1,9,,0,,0,0,0
19,1/2/2021,390,8947,390,8945,1,10,0.0,0,141.0,1870,0.0,0,1,10,0.0,0,0.0,0,0,0
20,1/3/2021,122,9069,122,9067,0,10,0.0,0,52.0,1922,0.0,0,0,10,0.0,0,0.0,0,0,0
21,1/4/2021,588,9657,575,9642,13,23,0.0,0,320.0,2242,0.0,0,11,21,2.0,2,0.0,0,0,0
22,1/5/2021,647,10304,638,10280,10,33,0.0,0,409.0,2651,0.0,0,9,30,1.0,3,0.0,0,0,0
23,1/6/2021,1231,11535,913,11193,317,350,4.0,4,516.0,3167,17.0,17,279,309,17.0,20,4.0,4,0,0
24,1/7/2021,1655,13190,701,11894,951,1301,12.0,16,405.0,3572,34.0,51,860,1169,42.0,62,15.0,19,0,0
25,1/8/2021,1990,15180,982,12876,1003,2304,12.0,28,478.0,4050,46.0,97,894,2063,43.0,105,20.0,39,1,1
26,1/9/2021,1226,16406,526,13402,691,2995,14.0,42,302.0,4352,16.0,113,626,2689,37.0,142,12.0,51,0,1
27,1/10/2021,701,17107,426,13828,274,3269,4.0,46,260.0,4612,10.0,123,247,2936,14.0,156,3.0,54,0,1
28,1/11/2021,1149,18256,798,14626,351,3620,1.0,47,535.0,5147,10.0,133,319,3255,19.0,175,3.0,57,0,1
29,1/12/2021,1175,19431,878,15504,296,3916,8.0,55,517.0,5664,14.0,147,256,3511,18.0,193,8.0,65,1,2
30,1/13/2021,1077,20508,831,16335,246,4162,1.0,56,376.0,6040,23.0,170,200,3711,15.0,208,8.0,73,0,2
31,1/14/2021,868,21376,833,17168,35,4197,1.0,57,494.0,6534,2.0,172,31,3742,1.0,209,1.0,74,0,2
32,1/15/2021,1219,22595,1206,18374,13,4210,0.0,57,760.0,7294,0.0,172,13,3755,0.0,209,0.0,74,0,2
33,1/16/2021,985,23580,971,19345,14,4224,1.0,58,585.0,7879,0.0,172,13,3768,1.0,210,0.0,74,0,2
34,1/17/2021,51,23631,46,19391,5,4229,0.0,58,18.0,7897,0.0,172,3,3771,2.0,212,0.0,74,0,2
35,1/18/2021,1017,24648,813,20204,202,4431,48.0,106,600.0,8497,8.0,180,176,3947,13.0,225,5.0,79,2,4
36,1/19/2021,1257,25905,1115,21319,142,4573,9.0,115,737.0,9234,7.0,187,122,4069,6.0,231,7.0,86,0,4
37,1/20/2021,1421,27326,1203,22522,216,4789,17.0,132,571.0,9805,15.0,202,175,4244,9.0,240,17.0,103,1,5
38,1/21/2021,2255,29581,2045,24567,210,4999,7.0,139,1589.0,11394,13.0,215,175,4419,15.0,255,7.0,110,0,5
39,1/22/2021,1733,31314,1461,26028,272,5271,89.0,228,1092.0,12486,35.0,250,218,4637,13.0,268,6.0,116,0,5
40,1/23/2021,895,32209,559,26587,335,5606,58.0,286,416.0,12902,8.0,258,306,4943,13.0,281,8.0,124,0,5
41,1/24/2021,393,32602,104,26691,288,5894,208.0,494,61.0,12963,8.0,266,271,5214,9.0,290,,124,0,5
42,1/25/2021,1404,34006,784,27475,615,6509,365.0,859,555.0,13518,14.0,280,574,5788,15.0,305,12.0,136,0,5
43,1/26/2021,1618,35624,687,28162,927,7436,463.0,1322,440.0,13958,30.0,310,851,6639,33.0,338,13.0,149,0,5
44,1/27/2021,1838,37462,772,28934,1063,8499,538.0,1860,335.0,14293,39.0,349,969,7608,45.0,383,10.0,159,0,5
45,1/28/2021,1341,38803,536,29470,802,9301,355.0,2215,295.0,14588,25.0,374,733,8341,27.0,410,17.0,176,2,7
46,1/29/2021,1626,40429,1150,30620,474,9775,158.0,2373,824.0,15412,21.0,395,411,8752,32.0,442,10.0,186,0,7
47,1/30/2021,1226,41655,734,31354,489,10264,213.0,2586,598.0,16010,23.0,418,441,9193,20.0,462,5.0,191,0,7
48,1/31/2021,622,42277,399,31753,222,10486,76.0,2662,354.0,16364,5.0,423,196,9389,15.0,477,6.0,197,1,8
49,2/1/2021,1600,43877,896,32649,704,11190,469.0,3131,654.0,17018,17.0,440,650,10039,26.0,503,11.0,208,1,9
50,2/2/2021,1862,45739,730,33379,1131,12321,737.0,3868,582.0,17600,42.0,482,1045,11084,34.0,537,10.0,218,0,9
51,2/3/2021,1268,47007,584,33963,683,13004,324.0,4192,226.0,17826,48.0,530,581,11665,42.0,579,12.0,230,0,9
52,2/4/2021,2533,49540,1791,35754,737,13741,493.0,4685,1550.0,19376,29.0,559,661,12326,37.0,616,10.0,240,1,10
53,2/5/2021,2577,52117,1531,37285,1037,14778,684.0,5369,1305.0,20681,38.0,597,951,13277,30.0,646,18.0,258,2,12
54,2/6/2021,2220,54337,1600,38885,614,15392,442.0,5811,1244.0,21925,7.0,604,583,13860,22.0,668,2.0,260,0,12
55,2/7/2021,230,54567,88,38973,140,15532,94.0,5905,26.0,21951,7.0,611,125,13985,4.0,672,4.0,264,1,13
56,2/8/2021,2483,57050,1593,40566,890,16422,605.0,6510,1137.0,23088,26.0,637,819,14804,28.0,700,17.0,281,0,13
57,2/9/2021,2384,59434,1540,42106,842,17264,514.0,7024,991.0,24079,25.0,662,756,15560,32.0,732,29.0,310,0,13
58,2/10/2021,1584,61018,969,43075,612,17876,322.0,7346,288.0,24367,26.0,688,545,16105,25.0,757,16.0,326,4,17
59,2/11/2021,3532,64550,1998,45073,1529,19405,1061.0,8407,809.0,25176,56.0,744,1396,17501,49.0,806,28.0,354,1,18
60,2/12/2021,3264,67814,1812,46885,1446,20851,954.0,9361,799.0,25975,61.0,805,1330,18831,42.0,848,13.0,367,0,18
61,2/13/2021,2997,70811,2364,49249,628,21479,310.0,9671,672.0,26647,15.0,820,579,19410,23.0,871,11.0,378,2,20
62,2/14/2021,421,71232,350,49599,71,21550,49.0,9720,45.0,26692,2.0,822,64,19474,3.0,874,2.0,380,0,20
63,2/15/2021,2619,73851,2129,51728,488,22038,324.0,10044,256.0,26948,16.0,838,458,19932,12.0,886,2.0,382,0,20
64,2/16/2021,2748,76599,1918,53646,830,22868,503.0,10547,231.0,27179,34.0,872,756,20688,24.0,910,16.0,398,0,20
65,2/17/2021,1632,78231,654,54300,974,23842,480.0,11027,155.0,27334,28.0,900,889,21577,37.0,947,20.0,418,0,20
66,2/18/2021,2643,80874,1675,55975,962,24804,738.0,11765,275.0,27609,37.0,937,886,22463,30.0,977,9.0,427,1,21
67,2/19/2021,2419,83293,1028,57003,1380,26184,1022.0,12787,154.0,27763,45.0,982,1278,23741,43.0,1020,14.0,441,3,24
68,2/20/2021,1649,84942,688,57691,958,27142,784.0,13571,133.0,27896,22.0,1004,899,24640,27.0,1047,10.0,451,1,25
69,2/21/2021,109,85051,40,57731,68,27210,38.0,13609,8.0,27904,1.0,1005,65,24705,2.0,1049,0.0,451,0,25
70,2/22/2021,2021,87072,761,58492,1253,28463,929.0,14538,146.0,28050,37.0,1042,1168,25873,38.0,1087,10.0,461,1,26
71,2/23/2021,1221,88293,517,59009,704,29167,471.0,15009,160.0,28210,21.0,1063,636,26509,34.0,1121,13.0,474,0,26
72,2/24/2021,1407,89700,751,59760,650,29817,277.0,15286,135.0,28345,31.0,1094,596,27105,18.0,1139,5.0,479,1,27
73,2/25/2021,3861,93561,2067,61827,1792,31609,1511.0,16797,350.0,28695,47.0,1141,1692,28797,36.0,1175,17.0,496,0,27
74,2/26/2021,3264,96825,1153,62980,2107,33716,1747.0,18544,200.0,28895,33.0,1174,1985,30782,59.0,1234,30.0,526,2,29
75,2/27/2021,3499,100324,1665,64645,1831,35547,1569.0,20113,546.0,29441,36.0,1210,1717,32499,52.0,1286,26.0,552,1,30
76,2/28/2021,424,100748,355,65000,68,35615,42.0,20155,114.0,29555,2.0,1212,62,32561,2.0,1288,2.0,554,0,30
77,3/1/2021,2815,103563,1345,66345,1463,37078,1076.0,21231,301.0,29856,53.0,1265,1352,33913,46.0,1334,12.0,566,7,37
78,3/2/2021,3252,106815,1725,68070,1524,38602,1050.0,22281,384.0,30240,38.0,1303,1415,35328,44.0,1378,27.0,593,0,37
79,3/3/2021,1655,108470,1090,69160,563,39165,176.0,22457,203.0,30443,32.0,1335,503,35831,24.0,1402,4.0,597,0,37
80,3/4/2021,3006,111476,1581,70741,1427,40592,817.0,23274,171.0,30614,43.0,1378,1311,37142,53.0,1455,20.0,617,25,62
81,3/5/2021,3481,114957,2054,72795,1439,42031,815.0,24089,426.0,31040,38.0,1416,1334,38476,44.0,1499,23.0,640,24,86
82,3/6/2021,4103,119060,2319,75114,2015,44046,760.0,24849,268.0,31308,97.0,1513,1805,40281,79.0,1578,34.0,674,569,655
83,3/7/2021,415,119475,298,75412,126,44172,37.0,24886,20.0,31328,1.0,1514,120,40401,3.0,1581,2.0,676,23,678
84,3/8/2021,2816,122291,1050,76462,1777,45949,261.0,25147,74.0,31402,49.0,1563,1642,42043,62.0,1643,24.0,700,122,800
85,3/9/2021,3176,125467,1651,78113,1542,47491,258.0,25405,95.0,31497,50.0,1613,1404,43447,63.0,1706,25.0,725,74,874
86,3/10/2021,2379,127846,1363,79476,1026,48517,301.0,25706,83.0,31580,54.0,1667,923,44370,32.0,1738,17.0,742,64,938
87,3/11/2021,4185,132031,2387,81863,1807,50324,400.0,26106,135.0,31715,63.0,1730,1658,46028,65.0,1803,21.0,763,75,1013
88,3/12/2021,3941,135972,2571,84434,1395,51719,198.0,26304,67.0,31782,68.0,1798,1239,47267,53.0,1856,35.0,798,65,1078
89,3/13/2021,214,136186,131,84565,100,51819,20.0,26324,7.0,31789,1.0,1799,93,47360,4.0,1860,2.0,800,29,1107
90,3/14/2021,99,136285,60,84625,38,51857,9.0,26333,0.0,31789,1.0,1800,35,47395,1.0,1861,1.0,801,2,1109
91,3/15/2021,891,137176,357,84982,536,52393,85.0,26418,14.0,31803,19.0,1819,493,47888,17.0,1878,7.0,808,18,1127
92,3/16/2021,3293,140469,2121,87103,1178,53571,227.0,26645,45.0,31848,64.0,1883,1051,48939,41.0,1919,22.0,830,30,1157
93,3/17/2021,2908,143377,1791,88894,1127,54698,238.0,26883,88.0,31936,40.0,1923,1033,49972,35.0,1954,19.0,849,30,1187
94,3/18/2021,4000,147377,2087,90981,1926,56624,338.0,27221,91.0,32027,97.0,2020,1743,51715,64.0,2018,22.0,871,21,1208
95,3/19/2021,3002,150379,1749,92730,1256,57880,220.0,27441,42.0,32069,60.0,2080,1132,52847,45.0,2063,19.0,890,16,1224
96,3/20/2021,3080,153459,1965,94695,1117,58997,312.0,27753,54.0,32123,37.0,2117,1005,53852,54.0,2117,21.0,911,36,1260
97,3/21/2021,654,154113,392,95087,264,59261,26.0,27779,5.0,32128,11.0,2128,236,54088,15.0,2132,2.0,913,16,1276
98,3/22/2021,3109,157222,2243,97330,865,60126,188.0,27967,56.0,32184,19.0,2147,796,54884,37.0,2169,13.0,926,26,1302
99,3/23/2021,4437,161659,3566,100896,1198,61324,193.0,28160,75.0,32259,42.0,2189,1064,55948,53.0,2222,39.0,965,466,1768
100,3/24/2021,3163,164822,2430,103326,749,62073,117.0,28277,38.0,32297,40.0,2229,669,56617,26.0,2248,14.0,979,32,1800
101,3/25/2021,5069,169891,3055,106381,2016,64089,312.0,28589,71.0,32368,68.0,2297,1847,58464,69.0,2317,32.0,1011,15,1815
102,3/26/2021,4578,174469,2728,109109,1849,65938,327.0,28916,67.0,32435,119.0,2416,1586,60050,113.0,2430,31.0,1042,30,1845
103,3/27/2021,3339,177808,1910,111019,1423,67361,327.0,29243,21.0,32456,49.0,2465,1308,61358,46.0,2476,20.0,1062,5,1850
104,3/28/2021,1169,178977,810,111829,360,67721,92.0,29335,15.0,32471,12.0,2477,330,61688,16.0,2492,2.0,1064,4,1854
105,3/29/2021,3986,182963,2689,114518,1298,69019,230.0,29565,52.0,32523,40.0,2517,1217,62905,27.0,2519,14.0,1078,8,1862
106,3/30/2021,4372,187335,2757,117275,1649,70668,236.0,29801,74.0,32597,55.0,2572,1509,64414,66.0,2585,19.0,1097,46,1908
107,3/31/2021,3564,190899,2553,119828,1047,71715,168.0,29969,47.0,32644,40.0,2612,936,65350,49.0,2634,22.0,1119,26,1934
108,4/1/2021,5105,196004,3331,123159,1789,73504,146.0,30115,75.0,32719,73.0,2685,1637,66987,60.0,2694,19.0,1138,29,1963
109,4/2/2021,4710,200714,2526,125685,2190,75694,245.0,30360,49.0,32768,82.0,2767,1993,68980,90.0,2784,25.0,1163,26,1989
110,4/3/2021,4264,204978,3536,129221,764,76458,94.0,30454,40.0,32808,37.0,2804,679,69659,28.0,2812,20.0,1183,64,2053
111,4/4/2021,368,205346,254,129475,133,76591,6.0,30460,7.0,32815,3.0,2807,117,69776,11.0,2823,2.0,1185,32,2085
112,4/5/2021,4684,210030,3753,133228,956,77547,75.0,30535,46.0,32861,70.0,2877,818,70594,48.0,2871,20.0,1205,88,2173
113,4/6/2021,5160,215190,3028,136256,2335,79882,83.0,30618,59.0,32920,80.0,2957,2068,72662,127.0,2998,60.0,1265,258,2431
114,4/7/2021,4957,220147,3679,139935,2220,82102,59.0,30677,109.0,33029,118.0,3075,1889,74551,139.0,3137,74.0,1339,1114,3545
115,4/8/2021,6684,226831,4507,144442,2918,85020,142.0,30819,124.0,33153,134.0,3209,2560,77111,143.0,3280,81.0,1420,889,4434
116,4/9/2021,5720,232551,3264,147706,3274,88294,79.0,30898,71.0,33224,161.0,3370,2840,79951,183.0,3463,90.0,1510,772,5206
117,4/10/2021,4427,236978,3161,150867,1773,90067,51.0,30949,71.0,33295,101.0,3471,1496,81447,120.0,3583,56.0,1566,485,5691
118,4/11/2021,1038,238016,796,151663,289,90356,5.0,30954,11.0,33306,12.0,3483,242,81689,24.0,3607,11.0,1577,56,5747
119,4/12/2021,5037,243053,3638,155301,2050,92406,77.0,31031,96.0,33402,77.0,3560,1773,83462,137.0,3744,63.0,1640,476,6223
120,4/13/2021,5036,248089,3563,158864,1489,93895,55.0,31086,76.0,33478,70.0,3630,1300,84762,95.0,3839,24.0,1664,21,6244
121,4/14/2021,2952,251041,1430,160294,1517,95412,87.0,31173,26.0,33504,93.0,3723,1320,86082,71.0,3910,33.0,1697,2,6246
122,4/15/2021,4949,255990,2328,162622,2605,98017,102.0,31275,58.0,33562,219.0,3942,2162,88244,162.0,4072,62.0,1759,3,6249
123,4/16/2021,3903,259893,2074,164696,1820,99837,44.0,31319,33.0,33595,65.0,4007,1592,89836,127.0,4199,36.0,1795,3,6252
124,4/17/2021,4584,264477,2405,167101,2166,102003,39.0,31358,57.0,33652,97.0,4104,1885,91721,132.0,4331,52.0,1847,2,6254
125,4/18/2021,1036,265513,407,167508,622,102625,13.0,31371,11.0,33663,42.0,4146,518,92239,32.0,4363,30.0,1877,4,6258
126,4/19/2021,3864,269377,1413,168921,2428,105053,43.0,31414,41.0,33704,165.0,4311,2038,94277,162.0,4525,63.0,1940,5,6263
127,4/20/2021,4697,274074,1865,170786,2819,107872,47.0,31461,69.0,33773,159.0,4470,2401,96678,192.0,4717,67.0,2007,5,6268
128,4/21/2021,3161,277235,709,171495,2443,110315,34.0,31495,32.0,33805,145.0,4615,2054,98732,163.0,4880,81.0,2088,5,6273
129,4/22/2021,4658,281893,1771,173266,2874,113189,46.0,31541,62.0,33867,142.0,4757,2463,101195,195.0,5075,74.0,2162,3,6276
130,4/23/2021,3588,285481,1181,174447,2392,115581,41.0,31582,30.0,33897,73.0,4830,2111,103306,127.0,5202,81.0,2243,5,6281
131,4/24/2021,3370,288851,1119,175566,2245,117826,14.0,31596,21.0,33918,102.0,4932,1905,105211,195.0,5397,43.0,2286,7,6288
132,4/25/2021,791,289642,342,175908,448,118274,6.0,31602,6.0,33924,103.0,5035,267,105478,37.0,5434,41.0,2327,1,6289
133,4/26/2021,4357,293999,1115,177023,3237,121511,35.0,31637,30.0,33954,147.0,5182,2784,108262,211.0,5645,95.0,2422,4,6293
134,4/27/2021,3338,297337,1185,178208,2145,123656,37.0,31674,37.0,33991,80.0,5262,1888,110150,134.0,5779,43.0,2465,11,6304
135,4/28/2021,2984,300321,710,178918,2276,125932,45.0,31719,20.0,34011,166.0,5428,1845,111995,196.0,5975,69.0,2534,12,6316
136,4/29/2021,3968,304289,820,179738,3145,129077,67.0,31786,32.0,34043,227.0,5655,2583,114578,225.0,6200,110.0,2644,6,6322
137,4/30/2021,2868,307157,637,180375,2233,131310,44.0,31830,24.0,34067,73.0,5728,1898,116476,198.0,6398,64.0,2708,11,6333
138,5/1/2021,3638,310795,813,181188,2809,134119,34.0,31864,18.0,34085,280.0,6008,2189,118665,199.0,6597,141.0,2849,14,6347
139,5/2/2021,530,311325,235,181423,307,134426,7.0,31871,2.0,34087,11.0,6019,247,118912,38.0,6635,11.0,2860,9,6356
140,5/3/2021,3420,314745,633,182056,2787,137213,46.0,31917,34.0,34121,107.0,6126,2389,121301,212.0,6847,79.0,2939,12,6368
141,5/4/2021,4339,319084,693,182749,3668,140881,67.0,31984,26.0,34147,147.0,6273,3151,124452,259.0,7106,111.0,3050,26,6394
142,5/5/2021,2223,321307,478,183227,1784,142665,64.0,32048,24.0,34171,85.0,6358,1474,125926,142.0,7248,83.0,3133,14,6408
143,5/6/2021,3681,324988,819,184046,2985,145650,100.0,32148,40.0,34211,178.0,6536,2475,128401,197.0,7445,135.0,3268,40,6448
144,5/7/2021,2935,327923,545,184591,2488,148138,44.0,32192,11.0,34222,135.0,6671,2041,130442,210.0,7655,102.0,3370,34,6482
145,5/8/2021,2991,330914,553,185144,2546,150684,45.0,32237,16.0,34238,167.0,6838,2052,132494,195.0,7850,132.0,3502,44,6526
146,5/9/2021,367,331281,141,185285,239,150923,4.0,32241,2.0,34240,11.0,6849,197,132691,21.0,7871,10.0,3512,3,6529
147,5/10/2021,2423,333704,378,185663,2084,153007,60.0,32301,16.0,34256,87.0,6936,1694,134385,206.0,8077,97.0,3609,20,6549
148,5/11/2021,2715,336419,538,186201,2220,155227,92.0,32393,24.0,34280,190.0,7126,1724,136109,203.0,8280,103.0,3712,16,6565
149,5/12/2021,1218,337637,456,186657,815,156042,22.0,32415,14.0,34294,48.0,7174,645,136754,88.0,8368,34.0,3746,22,6587
150,5/13/2021,3250,340887,1028,187685,2238,158280,82.0,32497,24.0,34318,150.0,7324,1821,138575,159.0,8527,108.0,3854,16,6603
151,5/14/2021,2472,343359,1279,188964,1294,159574,50.0,32547,30.0,34348,62.0,7386,1075,139650,101.0,8628,56.0,3910,31,6634
152,5/15/2021,3008,346367,1502,190466,1596,161170,40.0,32587,15.0,34363,113.0,7499,1269,140919,140.0,8768,74.0,3984,22,6656
153,5/16/2021,944,347311,572,191038,405,161575,8.0,32595,8.0,34371,83.0,7582,251,141170,29.0,8797,42.0,4026,10,6666
154,5/17/2021,2446,349757,1212,192250,1309,162884,37.0,32632,27.0,34398,48.0,7630,1098,142268,101.0,8898,62.0,4088,18,6684
155,5/18/2021,2571,352328,1165,193415,1440,164324,44.0,32676,22.0,34420,71.0,7701,1206,143474,82.0,8980,81.0,4169,19,6703
156,5/19/2021,1870,354198,1153,194568,784,165108,24.0,32700,19.0,34439,42.0,7743,635,144109,67.0,9047,40.0,4209,14,6717
157,5/20/2021,1969,356167,919,195487,1094,166202,46.0,32746,27.0,34466,92.0,7835,871,144980,81.0,9128,50.0,4259,16,6733
158,5/21/2021,1626,357793,919,196406,787,166989,18.0,32764,16.0,34482,45.0,7880,625,145605,60.0,9188,57.0,4316,26,6759
159,5/22/2021,1678,359471,788,197194,919,167908,9.0,32773,13.0,34495,121.0,8001,637,146242,74.0,9262,87.0,4403,14,6773
160,5/23/2021,681,360152,342,197536,370,168278,2.0,32775,5.0,34500,69.0,8070,227,146469,19.0,9281,55.0,4458,2,6775
161,5/24/2021,1334,361486,537,198073,852,169130,36.0,32811,20.0,34520,44.0,8114,686,147155,81.0,9362,41.0,4499,19,6794
162,5/25/2021,1226,362712,508,198581,752,169882,21.0,32832,20.0,34540,56.0,8170,567,147722,64.0,9426,65.0,4564,16,6810
163,5/26/2021,965,363677,551,199132,534,170416,17.0,32849,25.0,34565,37.0,8207,422,148144,44.0,9470,31.0,4595,20,6830
164,5/27/2021,1270,364947,656,199788,680,171096,32.0,32881,19.0,34584,53.0,8260,550,148694,50.0,9520,27.0,4622,19,6849
165,5/28/2021,1036,365983,601,200389,480,171576,18.0,32899,22.0,34606,32.0,8292,373,149067,47.0,9567,28.0,4650,17,6866
166,5/29/2021,1025,367008,497,200886,566,172142,18.0,32917,8.0,34614,32.0,8324,446,149513,43.0,9610,45.0,4695,11,6877
167,5/30/2021,328,367336,217,201103,144,172286,5.0,32922,3.0,34617,12.0,8336,105,149618,17.0,9627,10.0,4705,8,6885
168,5/31/2021,337,367673,188,201291,176,172462,8.0,32930,6.0,34623,8.0,8344,141,149759,13.0,9640,14.0,4719,11,6896
169,6/1/2021,963,368636,395,201686,599,173061,27.0,32957,18.0,34641,48.0,8392,459,150218,45.0,9685,47.0,4766,24,6920
170,6/2/2021,712,369348,365,202051,402,173463,16.0,32973,8.0,34649,34.0,8426,321,150539,22.0,9707,25.0,4791,6,6926
171,6/3/2021,1300,370648,522,202573,830,174293,22.0,32995,12.0,34661,46.0,8472,687,151226,56.0,9763,41.0,4832,14,6940
172,6/4/2021,1500,372148,404,202977,1140,175433,16.0,33011,8.0,34669,68.0,8540,954,152180,70.0,9833,48.0,4880,4,6944
173,6/5/2021,1413,373561,358,203335,1082,176515,12.0,33023,6.0,34675,63.0,8603,886,153066,92.0,9925,41.0,4921,10,6954
174,6/6/2021,527,374088,138,203473,401,176916,5.0,33028,3.0,34678,44.0,8647,320,153386,25.0,9950,12.0,4933,6,6960
175,6/7/2021,1191,375279,333,203806,903,177819,14.0,33042,12.0,34690,67.0,8714,721,154107,83.0,10033,32.0,4965,17,6977
176,6/8/2021,1077,376356,252,204058,849,178668,17.0,33059,5.0,34695,56.0,8770,694,154801,64.0,10097,35.0,5000,4,6981
177,6/9/2021,1081,377437,283,204341,846,179514,15.0,33074,12.0,34707,78.0,8848,650,155451,71.0,10168,47.0,5047,10,6991
178,6/10/2021,1309,378746,333,204674,1013,180527,20.0,33094,4.0,34711,93.0,8941,799,156250,66.0,10234,55.0,5102,12,7003
179,6/11/2021,1112,379858,325,204999,831,181358,19.0,33113,13.0,34724,58.0,8999,651,156901,78.0,10312,44.0,5146,9,7012
180,6/12/2021,1036,380894,288,205287,791,182149,15.0,33128,9.0,34733,72.0,9071,613,157514,60.0,10372,46.0,5192,8,7020
181,6/13/2021,370,381264,96,205383,287,182436,4.0,33132,1.0,34734,37.0,9108,205,157719,24.0,10396,21.0,5213,3,7023
182,6/14/2021,825,382089,280,205663,592,183028,15.0,33147,4.0,34738,44.0,9152,449,158168,42.0,10438,57.0,5270,4,7027
183,6/15/2021,693,382782,239,205902,477,183505,20.0,33167,10.0,34748,40.0,9192,388,158556,33.0,10471,16.0,5286,1,7028
184,6/16/2021,619,383401,203,206105,442,183947,12.0,33179,4.0,34752,38.0,9230,334,158890,33.0,10504,37.0,5323,8,7036
185,6/17/2021,692,384093,250,206355,468,184415,14.0,33193,9.0,34761,41.0,9271,348,159238,49.0,10553,30.0,5353,3,7039
186,6/18/2021,1035,385128,379,206734,686,185101,23.0,33216,11.0,34772,51.0,9322,554,159792,51.0,10604,30.0,5383,7,7046
187,6/19/2021,635,385763,154,206888,497,185598,10.0,33226,6.0,34778,48.0,9370,369,160161,52.0,10656,28.0,5411,8,7054
188,6/20/2021,299,386062,114,207002,192,185790,3.0,33229,2.0,34780,37.0,9407,119,160280,14.0,10670,22.0,5433,4,7058
189,6/21/2021,512,386574,213,207215,326,186116,5.0,33234,8.0,34788,28.0,9435,242,160522,34.0,10704,22.0,5455,7,7065
190,6/22/2021,604,387178,249,207464,387,186503,12.0,33246,7.0,34795,31.0,9466,303,160825,24.0,10728,29.0,5484,4,7069
191,6/23/2021,511,387689,188,207652,351,186854,7.0,33253,10.0,34805,36.0,9502,254,161079,37.0,10765,24.0,5508,10,7079
192,6/24/2021,519,388208,209,207861,334,187188,12.0,33265,9.0,34814,30.0,9532,258,161337,23.0,10788,23.0,5531,1,7080
193,6/25/2021,686,388894,272,208133,436,187624,12.0,33277,8.0,34822,41.0,9573,323,161660,42.0,10830,30.0,5561,5,7085
194,6/26/2021,594,389488,164,208297,440,188064,9.0,33286,9.0,34831,77.0,9650,289,161949,42.0,10872,32.0,5593,4,7089
195,6/27/2021,183,389671,71,208368,113,188177,2.0,33288,3.0,34834,9.0,9659,82,162031,12.0,10884,10.0,5603,2,7091
196,6/28/2021,484,390155,208,208576,283,188460,7.0,33295,5.0,34839,39.0,9698,204,162235,24.0,10908,16.0,5619,2,7093
197,6/29/2021,555,390710,253,208829,324,188784,16.0,33311,11.0,34850,43.0,9741,235,162470,20.0,10928,26.0,5645,10,7103
198,6/30/2021,414,391124,207,209036,221,189005,8.0,33319,11.0,34861,19.0,9760,165,162635,16.0,10944,21.0,5666,14,7117
199,7/1/2021,487,391611,208,209244,298,189303,8.0,33327,7.0,34868,21.0,9781,225,162860,31.0,10975,21.0,5687,3,7120
200,7/2/2021,564,392175,271,209515,304,189607,4.0,33331,7.0,34875,26.0,9807,239,163099,23.0,10998,16.0,5703,3,7123
201,7/3/2021,305,392480,119,209634,193,189800,4.0,33335,3.0,34878,29.0,9836,124,163223,21.0,11019,19.0,5722,5,7128
202,7/4/2021,52,392532,17,209651,35,189835,1.0,33336,0.0,34878,4.0,9840,22,163245,1.0,11020,8.0,5730,0,7128
203,7/5/2021,311,392843,138,209789,170,190005,3.0,33339,1.0,34879,17.0,9857,118,163363,26.0,11046,9.0,5739,4,7132
204,7/6/2021,448,393291,189,209978,268,190273,4.0,33343,5.0,34884,44.0,9901,190,163553,17.0,11063,17.0,5756,1,7133
205,7/7/2021,370,393661,208,210186,176,190449,7.0,33350,6.0,34890,19.0,9920,131,163684,11.0,11074,15.0,5771,4,7137
206,7/8/2021,426,394087,201,210387,246,190695,9.0,33359,8.0,34898,24.0,9944,175,163859,24.0,11098,23.0,5794,4,7141
207,7/9/2021,481,394568,194,210581,293,190988,9.0,33368,2.0,34900,37.0,9981,214,164073,24.0,11122,18.0,5812,5,7146
208,7/10/2021,257,394825,145,210726,127,191115,5.0,33373,2.0,34902,5.0,9986,105,164178,10.0,11132,7.0,5819,2,7148
209,7/11/2021,224,395049,120,210846,122,191237,6.0,33379,6.0,34908,11.0,9997,88,164266,10.0,11142,13.0,5832,7,7155
210,7/12/2021,384,395433,203,211049,194,191431,7.0,33386,4.0,34912,25.0,10022,128,164394,24.0,11166,17.0,5849,4,7159
211,7/13/2021,435,395868,224,211273,226,191657,16.0,33402,10.0,34922,26.0,10048,176,164570,12.0,11178,12.0,5861,4,7163
212,7/14/2021,283,396151,149,211422,156,191813,8.0,33410,5.0,34927,19.0,10067,112,164682,10.0,11188,15.0,5876,8,7171
213,7/15/2021,360,396511,189,211611,181,191994,1.0,33411,4.0,34931,15.0,10082,136,164818,13.0,11201,17.0,5893,4,7175
214,7/16/2021,511,397022,244,211855,277,192271,8.0,33419,9.0,34940,24.0,10106,211,165029,22.0,11223,20.0,5913,5,7180
215,7/17/2021,279,397301,160,212015,131,192402,11.0,33430,4.0,34944,11.0,10117,99,165128,10.0,11233,11.0,5924,6,7186
216,7/18/2021,195,397496,118,212133,90,192492,4.0,33434,3.0,34947,14.0,10131,62,165190,7.0,11240,7.0,5931,3,7189
217,7/19/2021,403,397899,204,212337,203,192695,8.0,33442,8.0,34955,26.0,10157,147,165337,17.0,11257,13.0,5944,5,7194
218,7/20/2021,416,398315,209,212546,215,192910,6.0,33448,8.0,34963,12.0,10169,165,165502,23.0,11280,15.0,5959,4,7198
219,7/21/2021,333,398648,180,212726,175,193085,13.0,33461,14.0,34977,12.0,10181,131,165633,14.0,11294,18.0,5977,3,7201
220,7/22/2021,396,399044,236,212962,169,193254,8.0,33469,19.0,34996,18.0,10199,123,165756,18.0,11312,10.0,5987,7,7208
221,7/23/2021,547,399591,319,213281,232,193486,6.0,33475,10.0,35006,35.0,10234,161,165917,17.0,11329,19.0,6006,3,7211
222,7/24/2021,351,399942,215,213496,154,193640,8.0,33483,10.0,35016,19.0,10253,112,166029,9.0,11338,14.0,6020,6,7217
223,7/25/2021,200,400142,145,213641,64,193704,0.0,33483,4.0,35020,7.0,10260,46,166075,5.0,11343,6.0,6026,4,7221
224,7/26/2021,345,400487,200,213841,143,193847,1.0,33484,7.0,35027,10.0,10270,100,166175,16.0,11359,17.0,6043,4,7225
225,7/27/2021,420,400907,234,214075,173,194020,5.0,33489,16.0,35043,21.0,10291,122,166297,17.0,11376,13.0,6056,17,7242
226,7/28/2021,463,401370,283,214358,219,194239,3.0,33492,10.0,35053,28.0,10319,141,166438,16.0,11392,34.0,6090,5,7247
227,7/29/2021,510,401880,304,214662,238,194477,8.0,33500,6.0,35059,24.0,10343,182,166620,13.0,11405,19.0,6109,8,7255
228,7/30/2021,678,402558,471,215133,245,194722,10.0,33510,14.0,35073,25.0,10368,185,166805,16.0,11421,19.0,6128,5,7260
229,7/31/2021,330,402888,201,215334,132,194854,4.0,33514,1.0,35074,12.0,10380,106,166911,9.0,11430,5.0,6133,7,7267
230,8/1/2021,266,403154,170,215504,103,194957,0.0,33514,2.0,35076,15.0,10395,64,166975,8.0,11438,16.0,6149,9,7276
231,8/2/2021,446,403600,297,215801,173,195130,4.0,33518,13.0,35089,20.0,10415,120,167095,20.0,11458,13.0,6162,5,7281
232,8/3/2021,565,404165,351,216152,240,195370,6.0,33524,13.0,35102,36.0,10451,163,167258,15.0,11473,26.0,6188,4,7285
233,8/4/2021,389,404554,272,216424,138,195508,3.0,33527,14.0,35116,10.0,10461,104,167362,5.0,11478,19.0,6207,9,7294
234,8/5/2021,444,404998,284,216708,171,195679,5.0,33532,11.0,35127,20.0,10481,121,167483,18.0,11496,12.0,6219,4,7298
235,8/6/2021,679,405677,463,217171,263,195942,12.0,33544,16.0,35143,22.0,10503,199,167682,22.0,11518,20.0,6239,3,7301
236,8/7/2021,439,406116,306,217477,156,196098,3.0,33547,10.0,35153,12.0,10515,124,167806,4.0,11522,16.0,6255,5,7306
237,8/8/2021,216,406332,125,217602,98,196196,3.0,33550,5.0,35158,8.0,10523,71,167877,6.0,11528,13.0,6268,6,7312
238,8/9/2021,463,406795,281,217883,213,196409,4.0,33554,6.0,35164,22.0,10545,157,168034,11.0,11539,23.0,6291,7,7319
239,8/10/2021,500,407295,298,218181,228,196637,6.0,33560,14.0,35178,25.0,10570,180,168214,10.0,11549,13.0,6304,8,7327
240,8/11/2021,415,407710,265,218446,175,196812,11.0,33571,5.0,35183,15.0,10585,135,168349,14.0,11563,11.0,6315,2,7329
241,8/12/2021,544,408254,320,218766,260,197072,7.0,33578,13.0,35196,31.0,10616,182,168531,23.0,11586,24.0,6339,7,7336
242,8/13/2021,659,408913,380,219146,297,197369,11.0,33589,9.0,35205,30.0,10646,217,168748,19.0,11605,31.0,6370,7,7343
243,8/14/2021,503,409416,256,219402,250,197619,7.0,33596,9.0,35214,10.0,10656,214,168962,9.0,11614,17.0,6387,51,7394
244,8/15/2021,266,409682,129,219531,125,197744,2.0,33598,3.0,35217,11.0,10667,91,169053,6.0,11620,17.0,6404,20,7414
245,8/16/2021,539,410221,309,219840,168,197912,3.0,33601,11.0,35228,15.0,10682,128,169181,12.0,11632,13.0,6417,84,7498
246,8/17/2021,481,410702,226,220066,192,198104,20.0,33621,10.0,35238,17.0,10699,145,169326,10.0,11642,20.0,6437,87,7585
247,8/18/2021,588,411290,322,220388,255,198359,5.0,33626,15.0,35253,30.0,10729,173,169499,12.0,11654,40.0,6477,80,7665
248,8/19/2021,562,411852,277,220665,253,198612,7.0,33633,9.0,35262,21.0,10750,203,169702,15.0,11669,14.0,6491,85,7750
249,8/20/2021,841,412693,338,221003,453,199065,16.0,33649,11.0,35273,44.0,10794,360,170062,29.0,11698,20.0,6511,94,7844
250,8/21/2021,645,413338,209,221212,210,199275,4.0,33653,7.0,35280,15.0,10809,171,170233,13.0,11711,11.0,6522,223,8067
251,8/22/2021,316,413654,149,221361,144,199419,1.0,33654,2.0,35282,18.0,10827,103,170336,9.0,11720,14.0,6536,31,8098
252,8/23/2021,526,414180,261,221622,221,199640,10.0,33664,9.0,35291,19.0,10846,167,170503,12.0,11732,23.0,6559,66,8164
253,8/24/2021,570,414750,271,221893,281,199921,10.0,33674,8.0,35299,27.0,10873,221,170724,15.0,11747,18.0,6577,58,8222
254,8/25/2021,593,415343,320,222213,260,200181,12.0,33686,13.0,35312,20.0,10893,197,170921,10.0,11757,33.0,6610,47,8269
255,8/26/2021,533,415876,263,222476,250,200431,9.0,33695,14.0,35326,18.0,10911,191,171112,23.0,11780,18.0,6628,46,8315
256,8/27/2021,891,416767,352,222828,408,200839,15.0,33710,11.0,35337,35.0,10946,304,171416,23.0,11803,46.0,6674,172,8487
257,8/28/2021,1464,418231,201,223029,247,201086,7.0,33717,5.0,35342,23.0,10969,182,171598,14.0,11817,28.0,6702,1018,9505
258,8/29/2021,1080,419311,160,223189,136,201222,4.0,33721,4.0,35346,8.0,10977,110,171708,12.0,11829,6.0,6708,785,10290
259,8/30/2021,614,419925,269,223458,283,201505,9.0,33730,13.0,35359,25.0,11002,215,171923,9.0,11838,34.0,6742,94,10384
260,8/31/2021,808,420733,233,223691,235,201740,7.0,33737,12.0,35371,18.0,11020,186,172109,18.0,11856,13.0,6755,349,10733
261,9/1/2021,946,421679,246,223937,220,201960,12.0,33749,15.0,35386,21.0,11041,167,172276,13.0,11869,19.0,6774,497,11230
262,9/2/2021,830,422509,185,224122,206,202166,13.0,33762,14.0,35400,19.0,11060,153,172429,16.0,11885,18.0,6792,464,11694
263,9/3/2021,856,423365,339,224461,374,202540,13.0,33775,12.0,35412,46.0,11106,272,172701,20.0,11905,36.0,6828,164,11858
264,9/4/2021,376,423741,164,224625,164,202704,6.0,33781,8.0,35420,13.0,11119,127,172828,11.0,11916,13.0,6841,58,11916
265,9/5/2021,251,423992,131,224756,108,202812,2.0,33783,4.0,35424,12.0,11131,77,172905,9.0,11925,10.0,6851,22,11938
266,9/6/2021,112,424104,47,224803,58,202870,1.0,33784,0.0,35424,4.0,11135,43,172948,8.0,11933,3.0,6854,12,11950
267,9/7/2021,951,425055,198,225001,275,203145,19.0,33803,12.0,35436,23.0,11158,208,173156,19.0,11952,25.0,6879,487,12437
268,9/8/2021,787,425842,218,225219,224,203369,11.0,33814,12.0,35448,24.0,11182,166,173322,10.0,11962,24.0,6903,372,12809
269,9/9/2021,404,426246,177,225396,195,203564,9.0,33823,8.0,35456,21.0,11203,143,173465,14.0,11976,17.0,6920,55,12864
270,9/10/2021,750,426996,338,225734,305,203869,9.0,33832,23.0,35479,28.0,11231,229,173694,20.0,11996,28.0,6948,148,13012
271,9/11/2021,1632,428628,162,225896,209,204078,10.0,33842,19.0,35498,18.0,11249,159,173853,15.0,12011,17.0,6965,1275,14287
272,9/12/2021,231,428859,100,225996,113,204191,1.0,33843,2.0,35500,11.0,11260,72,173925,10.0,12021,20.0,6985,16,14303
273,9/13/2021,492,429351,220,226216,246,204437,9.0,33852,8.0,35508,24.0,11284,185,174110,12.0,12033,25.0,7010,44,14347
274,9/14/2021,842,430193,204,226420,272,204709,14.0,33866,16.0,35524,16.0,11300,219,174329,14.0,12047,23.0,7033,403,14750
275,9/15/2021,827,431020,190,226610,265,204974,15.0,33881,15.0,35539,21.0,11321,195,174524,16.0,12063,33.0,7066,397,15147
276,9/16/2021,358,431378,136,226746,195,205169,9.0,33890,8.0,35547,33.0,11354,139,174663,11.0,12074,12.0,7078,42,15189
277,9/17/2021,747,432125,283,227029,388,205557,13.0,33903,13.0,35560,29.0,11383,289,174952,39.0,12113,31.0,7109,124,15313
278,9/18/2021,1840,433965,130,227159,170,205727,5.0,33908,20.0,35580,10.0,11393,125,175077,15.0,12128,20.0,7129,1547,16860
279,9/19/2021,182,434147,75,227234,106,205833,3.0,33911,2.0,35582,6.0,11399,82,175159,5.0,12133,13.0,7142,11,16871
280,9/20/2021,384,434531,143,227377,216,206049,8.0,33919,9.0,35591,26.0,11425,161,175320,10.0,12143,19.0,7161,55,16926
281,9/21/2021,767,435298,167,227544,196,206245,9.0,33928,14.0,35605,21.0,11446,151,175471,8.0,12151,16.0,7177,421,17347
282,9/22/2021,717,436015,163,227707,229,206474,6.0,33934,12.0,35617,15.0,11461,180,175651,16.0,12167,18.0,7195,363,17710
283,9/23/2021,347,436362,143,227850,180,206654,8.0,33942,3.0,35620,9.0,11470,132,175783,13.0,12180,26.0,7221,48,17758
284,9/24/2021,695,437057,208,228058,274,206928,16.0,33958,16.0,35636,20.0,11490,217,176000,11.0,12191,26.0,7247,232,17990
285,9/25/2021,1735,438792,138,228196,176,207104,12.0,33970,21.0,35657,15.0,11505,137,176137,12.0,12203,12.0,7259,1427,19417
286,9/26/2021,264,439056,65,228261,88,207192,3.0,33973,3.0,35660,11.0,11516,66,176203,4.0,12207,7.0,7266,110,19527
287,9/27/2021,566,439622,155,228416,125,207317,7.0,33980,11.0,35671,7.0,11523,96,176299,8.0,12215,14.0,7280,302,19829
288,9/28/2021,1128,440750,158,228574,201,207518,19.0,33999,23.0,35694,15.0,11538,152,176451,9.0,12224,25.0,7305,791,20620
289,9/29/2021,1139,441889,174,228748,171,207689,12.0,34011,19.0,35713,15.0,11553,127,176578,7.0,12231,22.0,7327,809,21429
290,9/30/2021,703,442592,160,228908,167,207856,15.0,34026,7.0,35720,11.0,11564,128,176706,10.0,12241,18.0,7345,406,21835
291,10/1/2021,1056,443648,174,229082,301,208157,19.0,34045,15.0,35735,20.0,11584,238,176944,21.0,12262,22.0,7367,598,22433
292,10/2/2021,1814,445462,118,229200,114,208271,12.0,34057,14.0,35749,8.0,11592,96,177040,5.0,12267,5.0,7372,1588,24021
293,10/3/2021,390,445852,64,229264,112,208383,1.0,34058,2.0,35751,18.0,11610,76,177116,7.0,12274,11.0,7383,226,24247
294,10/4/2021,794,446646,113,229377,155,208538,7.0,34065,12.0,35763,26.0,11636,102,177218,14.0,12288,13.0,7396,533,24780
295,10/5/2021,1114,447760,140,229517,134,208672,12.0,34077,17.0,35780,13.0,11649,102,177320,5.0,12293,14.0,7410,851,25631
296,10/6/2021,995,448755,105,229622,155,208827,8.0,34085,14.0,35794,11.0,11660,122,177442,5.0,12298,17.0,7427,751,26382
297,10/7/2021,784,449539,133,229755,108,208935,8.0,34093,14.0,35808,9.0,11669,83,177525,5.0,12303,11.0,7438,564,26946
298,10/8/2021,1035,450574,159,229914,239,209174,19.0,34112,13.0,35821,20.0,11689,186,177711,11.0,12314,22.0,7460,648,27594
299,10/9/2021,1679,452253,108,230022,133,209307,11.0,34123,8.0,35829,22.0,11711,100,177811,3.0,12317,8.0,7468,1440,29034
300,10/10/2021,243,452496,49,230071,63,209370,2.0,34125,2.0,35831,4.0,11715,49,177860,5.0,12322,5.0,7473,132,29166
301,10/11/2021,817,453313,120,230191,133,209503,16.0,34141,18.0,35849,3.0,11718,109,177969,10.0,12332,11.0,7484,574,29740
302,10/12/2021,1022,454335,118,230309,132,209635,8.0,34149,20.0,35869,16.0,11734,104,178073,4.0,12336,8.0,7492,783,30523
303,10/13/2021,970,455305,118,230427,149,209784,15.0,34164,8.0,35877,16.0,11750,113,178186,12.0,12348,8.0,7500,722,31245
304,10/14/2021,711,456016,102,230529,127,209911,15.0,34179,9.0,35886,20.0,11770,94,178280,8.0,12356,5.0,7505,489,31734
305,10/15/2021,1024,457040,174,230703,215,210126,11.0,34190,7.0,35893,15.0,11785,169,178449,13.0,12369,18.0,7523,669,32403
306,10/16/2021,803,457843,66,230769,80,210206,4.0,34194,3.0,35896,6.0,11791,69,178518,2.0,12371,3.0,7526,657,33060
307,10/17/2021,196,458039,48,230817,63,210269,1.0,34195,2.0,35898,4.0,11795,47,178565,3.0,12374,9.0,7535,83,33143
308,10/18/2021,650,458689,117,230934,136,210405,10.0,34205,4.0,35902,13.0,11808,107,178672,6.0,12380,10.0,7545,412,33555
309,10/19/2021,1047,459736,121,231055,133,210538,4.0,34209,11.0,35913,8.0,11816,106,178778,8.0,12388,11.0,7556,803,34358
310,10/20/2021,891,460627,121,231176,121,210659,6.0,34215,11.0,35924,9.0,11825,91,178869,7.0,12395,14.0,7570,664,35022
311,10/21/2021,533,461160,107,231283,128,210787,9.0,34224,8.0,35932,14.0,11839,86,178955,11.0,12406,17.0,7587,320,35342
312,10/22/2021,1476,462636,196,231479,231,211018,9.0,34233,13.0,35945,21.0,11860,170,179125,14.0,12420,26.0,7613,1070,36412
313,10/23/2021,1880,464516,88,231567,195,211213,14.0,34247,15.0,35960,4.0,11864,170,179295,11.0,12431,10.0,7623,1601,38013
314,10/24/2021,564,465080,82,231649,152,211365,8.0,34255,11.0,35971,12.0,11876,127,179422,7.0,12438,6.0,7629,343,38356
315,10/25/2021,1376,466456,137,231786,297,211662,27.0,34282,17.0,35988,12.0,11888,252,179674,21.0,12459,12.0,7641,957,39313
316,10/26/2021,2140,468596,177,231963,300,211962,15.0,34297,17.0,36005,19.0,11907,249,179923,18.0,12477,14.0,7655,1673,40986
317,10/27/2021,1966,470562,156,232119,270,212232,19.0,34316,19.0,36024,9.0,11916,239,180162,13.0,12490,9.0,7664,1548,42534
318,10/28/2021,1710,472272,140,232259,260,212492,11.0,34327,20.0,36044,11.0,11927,219,180381,17.0,12507,13.0,7677,1321,43855
319,10/29/2021,1651,473923,178,232437,278,212770,12.0,34339,14.0,36058,10.0,11937,243,180624,12.0,12519,13.0,7690,1207,45062
320,10/30/2021,1587,475510,82,232519,150,212920,13.0,34352,8.0,36066,6.0,11943,129,180753,9.0,12528,6.0,7696,1364,46426
321,10/31/2021,463,475973,48,232567,75,212995,3.0,34355,6.0,36072,6.0,11949,63,180816,4.0,12532,2.0,7698,339,46765
322,11/1/2021,1234,477207,140,232707,216,213211,10.0,34365,10.0,36082,10.0,11959,174,180990,12.0,12544,20.0,7718,889,47654
323,11/2/2021,1817,479024,131,232838,201,213412,8.0,34373,17.0,36099,14.0,11973,163,181153,13.0,12557,11.0,7729,1502,49156
324,11/3/2021,1744,480768,159,232997,230,213642,12.0,34385,17.0,36116,15.0,11988,182,181335,16.0,12573,17.0,7746,1372,50528
325,11/4/2021,1405,482173,144,233141,184,213826,4.0,34389,14.0,36130,1.0,11989,159,181494,12.0,12585,12.0,7758,1101,51629
326,11/5/2021,2012,484185,227,233368,297,214123,14.0,34403,12.0,36142,17.0,12006,248,181742,14.0,12599,18.0,7776,1520,53149
327,11/6/2021,1577,485762,216,233584,142,214265,4.0,34407,8.0,36150,6.0,12012,115,181857,15.0,12614,6.0,7782,1227,54376
328,11/7/2021,525,486287,121,233705,77,214342,1.0,34408,8.0,36158,5.0,12017,63,181920,3.0,12617,6.0,7788,328,54704
329,11/8/2021,1521,487808,385,234090,198,214540,7.0,34415,9.0,36167,11.0,12028,164,182084,9.0,12626,14.0,7802,959,55663
330,11/9/2021,2619,490427,943,235033,221,214761,10.0,34425,22.0,36189,15.0,12043,163,182247,16.0,12642,27.0,7829,1476,57139
331,11/10/2021,2476,492903,813,235846,222,214983,12.0,34437,18.0,36207,11.0,12054,176,182423,22.0,12664,13.0,7842,1464,58603
332,11/11/2021,2329,495232,954,236800,189,215172,17.0,34454,8.0,36215,15.0,12069,153,182576,13.0,12677,8.0,7850,1208,59811
333,11/12/2021,2539,497771,746,237546,238,215410,13.0,34467,19.0,36234,23.0,12092,189,182765,13.0,12690,13.0,7863,1566,61377
334,11/13/2021,1926,499697,405,237951,139,215549,3.0,34470,13.0,36247,7.0,12099,103,182868,15.0,12705,14.0,7877,1392,62769
335,11/14/2021,1481,501178,913,238864,108,215657,1.0,34471,2.0,36249,12.0,12111,72,182940,14.0,12719,10.0,7887,470,63239
336,11/15/2021,1952,503130,452,239316,199,215856,7.0,34478,11.0,36260,12.0,12123,159,183099,12.0,12731,16.0,7903,1322,64561
337,11/16/2021,2397,505527,455,239771,212,216068,5.0,34483,21.0,36281,26.0,12149,155,183254,17.0,12748,14.0,7917,1742,66303
338,11/17/2021,2711,508238,632,240403,270,216338,12.0,34495,17.0,36298,16.0,12165,223,183477,17.0,12765,14.0,7931,1841,68144
339,11/18/2021,1882,510120,379,240782,178,216516,7.0,34502,11.0,36309,15.0,12180,143,183620,15.0,12780,5.0,7936,1340,69484
340,11/19/2021,2556,512676,717,241499,281,216797,13.0,34515,14.0,36323,9.0,12189,234,183854,20.0,12800,18.0,7954,1579,71063
341,11/20/2021,1872,514548,528,242027,113,216910,6.0,34521,5.0,36328,8.0,12197,96,183950,4.0,12804,5.0,7959,1234,72297
342,11/21/2021,641,515189,124,242151,83,216993,0.0,34521,1.0,36329,3.0,12200,67,184017,8.0,12812,5.0,7964,435,72732
343,11/22/2021,1969,517158,429,242580,208,217201,11.0,34532,22.0,36351,10.0,12210,169,184186,11.0,12823,18.0,7982,1352,74084
344,11/23/2021,1828,518986,286,242866,184,217385,8.0,34540,15.0,36366,15.0,12225,148,184334,14.0,12837,7.0,7989,1367,75451
345,11/24/2021,1503,520489,215,243081,162,217547,6.0,34546,11.0,36377,14.0,12239,131,184465,11.0,12848,6.0,7995,1140,76591
346,11/25/2021,46,520535,9,243090,2,217549,0.0,34546,0.0,36377,0.0,12239,1,184466,1.0,12849,,7995,35,76626
347,11/26/2021,1256,521791,195,243285,202,217751,3.0,34549,4.0,36381,17.0,12256,163,184629,12.0,12861,10.0,8005,878,77504
348,11/27/2021,946,522737,138,243423,152,217903,2.0,34551,2.0,36383,7.0,12263,130,184759,8.0,12869,7.0,8012,658,78162
349,11/28/2021,538,523275,96,243519,104,218007,2.0,34553,2.0,36385,9.0,12272,83,184842,5.0,12874,7.0,8019,344,78506
350,11/29/2021,1701,524976,224,243743,320,218327,8.0,34561,14.0,36399,23.0,12295,265,185107,20.0,12894,12.0,8031,1168,79674
351,11/30/2021,2654,527630,348,244091,780,219107,8.0,34569,13.0,36412,50.0,12345,658,185765,61.0,12955,11.0,8042,1546,81220
352,12/1/2021,2421,530051,267,244358,740,219847,12.0,34581,9.0,36421,30.0,12375,651,186416,56.0,13011,3.0,8045,1425,82645
353,12/2/2021,2793,532844,356,244714,902,220749,9.0,34590,11.0,36432,68.0,12443,732,187148,73.0,13084,29.0,8074,1562,84207
354,12/3/2021,2577,535421,291,245005,748,221497,11.0,34601,4.0,36436,61.0,12504,588,187736,69.0,13153,30.0,8104,1558,85765
355,12/4/2021,2177,537598,161,245166,418,221915,4.0,34605,1.0,36437,25.0,12529,327,188063,36.0,13189,30.0,8134,1605,87370
356,12/5/2021,1378,538976,105,245271,840,222755,1.0,34606,0.0,36437,67.0,12596,667,188730,69.0,13258,37.0,8171,442,87812
357,12/6/2021,1909,540885,236,245507,463,223218,7.0,34613,5.0,36442,52.0,12648,361,189091,34.0,13292,16.0,8187,1222,89034
358,12/7/2021,2434,543319,305,245812,469,223687,10.0,34623,9.0,36451,49.0,12697,372,189463,32.0,13324,16.0,8203,1680,90714
359,12/8/2021,2223,545542,274,246086,510,224197,9.0,34632,12.0,36463,29.0,12726,427,189890,40.0,13364,14.0,8217,1461,92175
360,12/9/2021,2142,547684,303,246389,460,224657,6.0,34638,8.0,36471,27.0,12753,355,190245,43.0,13407,35.0,8252,1393,93568
361,12/10/2021,2074,549758,239,246628,401,225058,10.0,34648,9.0,36480,37.0,12790,312,190557,32.0,13439,20.0,8272,1442,95010
362,12/11/2021,1769,551527,137,246765,487,225545,5.0,34653,3.0,36483,58.0,12848,361,190918,40.0,13479,28.0,8300,1147,96157
363,12/12/2021,413,551940,56,246821,89,225634,1.0,34654,3.0,36486,4.0,12852,72,190990,7.0,13486,6.0,8306,271,96428
364,12/13/2021,1742,553682,299,247120,391,226025,9.0,34663,10.0,36496,26.0,12878,317,191307,35.0,13521,13.0,8319,1068,97496
365,12/14/2021,2168,555850,279,247399,364,226389,7.0,34670,5.0,36501,33.0,12911,298,191605,16.0,13537,17.0,8336,1550,99046
366,12/15/2021,1725,557575,204,247603,225,226614,6.0,34676,4.0,36505,9.0,12920,184,191789,18.0,13555,14.0,8350,1309,100355
367,12/16/2021,1747,559322,315,247918,242,226856,7.0,34683,7.0,36512,14.0,12934,204,191993,15.0,13570,9.0,8359,1208,101563
368,12/17/2021,2103,561425,308,248226,437,227293,6.0,34689,10.0,36522,28.0,12962,363,192356,35.0,13605,11.0,8370,1368,102931
369,12/18/2021,1799,563224,185,248411,237,227530,4.0,34693,4.0,36526,17.0,12979,202,192558,10.0,13615,8.0,8378,1378,104309
370,12/19/2021,433,563657,43,248454,80,227610,1.0,34694,3.0,36529,5.0,12984,66,192624,3.0,13618,6.0,8384,310,104619
371,12/20/2021,1546,565203,204,248658,237,227847,10.0,34704,9.0,36538,27.0,13011,188,192812,15.0,13633,7.0,8391,1110,105729
372,12/21/2021,2179,567382,310,248968,294,228141,10.0,34714,8.0,36546,28.0,13039,227,193039,25.0,13658,14.0,8405,1583,107312
373,12/22/2021,1867,569249,225,249193,284,228425,4.0,34718,9.0,36555,27.0,13066,227,193266,22.0,13680,8.0,8413,1361,108673
374,12/23/2021,1228,570477,218,249411,203,228628,5.0,34723,5.0,36560,23.0,13089,156,193422,16.0,13696,8.0,8421,820,109493
375,12/24/2021,319,570796,46,249457,63,228691,3.0,34726,2.0,36562,4.0,13093,54,193476,4.0,13700,1.0,8422,212,109705
376,12/25/2021,13,570809,4,249461,2,228693,0.0,34726,0.0,36562,,13093,1,193477,1.0,13701,,8422,7,109712
377,12/26/2021,354,571163,62,249523,68,228761,1.0,34727,0.0,36562,7.0,13100,53,193530,5.0,13706,3.0,8425,226,109938
378,12/27/2021,1247,572410,174,249697,222,228983,4.0,34731,5.0,36567,19.0,13119,175,193705,20.0,13726,8.0,8433,858,110796
379,12/28/2021,1881,574291,270,249967,294,229277,12.0,34743,12.0,36579,35.0,13154,229,193934,16.0,13742,14.0,8447,1323,112119
380,12/29/2021,1684,575975,211,250178,248,229525,5.0,34748,6.0,36585,26.0,13180,189,194123,22.0,13764,11.0,8458,1236,113355
381,12/30/2021,1354,577329,221,250399,238,229763,7.0,34755,9.0,36594,26.0,13206,185,194308,15.0,13779,12.0,8470,907,114262
382,12/31/2021,499,577828,97,250496,91,229854,0.0,34755,2.0,36596,7.0,13213,74,194382,5.0,13784,5.0,8475,314,114576
383,1/1/2022,93,577921,12,250508,16,229870,1.0,34756,1.0,36597,0.0,13213,13,194395,2.0,13786,1.0,8476,65,114641
384,1/2/2022,316,578237,45,250553,61,229931,1.0,34757,1.0,36598,7.0,13220,42,194437,9.0,13795,3.0,8479,211,114852
385,1/3/2022,1577,579814,331,250884,333,230264,4.0,34761,5.0,36603,32.0,13252,273,194710,19.0,13814,9.0,8488,924,115776
386,1/4/2022,1643,581457,261,251145,271,230535,9.0,34770,7.0,36610,29.0,13281,215,194925,17.0,13831,10.0,8498,1124,116900
387,1/5/2022,1326,582783,206,251351,199,230734,7.0,34777,8.0,36618,13.0,13294,162,195087,9.0,13840,15.0,8513,935,117835
388,1/6/2022,1217,584000,250,251601,228,230962,4.0,34781,4.0,36622,22.0,13316,171,195258,13.0,13853,22.0,8535,749,118584
389,1/7/2022,2047,586047,256,251857,338,231300,6.0,34787,9.0,36631,35.0,13351,260,195518,30.0,13883,13.0,8548,1465,120049
390,1/8/2022,1572,587619,129,251986,130,231430,0.0,34787,3.0,36634,7.0,13358,109,195627,7.0,13890,7.0,8555,1317,121366
391,1/9/2022,489,588108,88,252074,72,231502,0.0,34787,1.0,36635,14.0,13372,49,195676,3.0,13893,6.0,8561,330,121696
392,1/10/2022,1548,589656,288,252362,250,231752,3.0,34790,6.0,36641,19.0,13391,194,195870,26.0,13919,11.0,8572,1021,122717
393,1/11/2022,1441,591097,209,252571,272,232024,2.0,34792,4.0,36645,31.0,13422,207,196077,15.0,13934,19.0,8591,973,123690
394,1/12/2022,1399,592496,182,252753,183,232207,6.0,34798,5.0,36650,29.0,13451,125,196202,20.0,13954,9.0,8600,1045,124735
395,1/13/2022,1076,593572,183,252936,171,232378,3.0,34801,2.0,36652,14.0,13465,127,196329,18.0,13972,12.0,8612,731,125466
396,1/14/2022,1602,595174,279,253215,210,232588,2.0,34803,8.0,36660,25.0,13490,153,196482,20.0,13992,12.0,8624,1128,126594
397,1/15/2022,1218,596392,140,253355,101,232689,1.0,34804,3.0,36663,10.0,13500,79,196561,10.0,14002,2.0,8626,978,127572
398,1/16/2022,281,596673,47,253402,33,232722,1.0,34805,0.0,36663,1.0,13501,29,196590,3.0,14005,0.0,8626,201,127773
399,1/17/2022,775,597448,156,253558,127,232849,4.0,34809,5.0,36668,12.0,13513,105,196695,8.0,14013,2.0,8628,494,128267
400,1/18/2022,887,598335,165,253723,165,233014,2.0,34811,6.0,36674,25.0,13538,127,196822,5.0,14018,8.0,8636,564,128831
401,1/19/2022,717,599052,121,253844,116,233130,4.0,34815,7.0,36681,9.0,13547,85,196907,10.0,14028,12.0,8648,492,129323
402,1/20/2022,763,599815,145,253989,146,233276,0.0,34815,10.0,36691,17.0,13564,110,197017,10.0,14038,9.0,8657,479,129802
403,1/21/2022,1149,600964,166,254155,170,233446,7.0,34822,2.0,36693,14.0,13578,132,197149,11.0,14049,13.0,8670,824,130626
404,1/22/2022,777,601741,88,254243,102,233548,0.0,34822,1.0,36694,14.0,13592,73,197222,6.0,14055,9.0,8679,590,131216
405,1/23/2022,172,601913,22,254265,41,233589,1.0,34823,0.0,36694,5.0,13597,30,197252,6.0,14061,0.0,8679,110,131326
406,1/24/2022,251,602164,35,254300,66,233655,1.0,34824,1.0,36695,13.0,13610,46,197298,5.0,14066,2.0,8681,151,131477
