,Date,daily number of doses received by Larimer County residents,total number of doses recevied by residents,daily number of residents receiving first dose,total number of residents receiving first dose,daily number of residents vaccinated,total number of residents vaccinated,daily number of 70+ vaccinated,total number of 70+ vaccinated,daily number of 70+ at least one dose,total number of 70+ at least one dose,daily number of Latinx residents vaccinated,total of Latinx residents vaccinated,daily number of White non-Latinx residents vaccinated,total of White non-Latinx residents vaccinated,daily number of non-White non-Latinx residents vaccinated,total of non-White non-Latinx residents vaccinated,dailyUnknown,totalUnknown,daily_additional_doses,total_additional_doses
0,2020-12-14,31,31,23,23,8,8,1.0,1,0.0,0,0.0,0,8,8,0.0,0,0.0,0,0,0
1,2020-12-15,16,47,6,29,10,18,0.0,1,1.0,1,0.0,0,9,17,1.0,1,,0,0,0
2,2020-12-16,311,358,300,329,11,29,0.0,1,1.0,2,1.0,1,9,26,1.0,2,0.0,0,0,0
3,2020-12-17,986,1344,969,1298,17,46,1.0,2,10.0,12,0.0,1,17,43,0.0,2,0.0,0,0,0
4,2020-12-18,1041,2385,1029,2327,12,58,2.0,4,14.0,26,0.0,1,12,55,0.0,2,0.0,0,0,0
5,2020-12-19,713,3098,710,3037,3,61,0.0,4,13.0,39,0.0,1,3,58,0.0,2,0.0,0,0,0
6,2020-12-20,264,3362,264,3301,0,61,0.0,4,4.0,43,0.0,1,0,58,0.0,2,0.0,0,0,0
7,2020-12-21,355,3717,337,3638,18,79,2.0,6,1.0,44,0.0,1,17,75,1.0,3,0.0,0,0,0
8,2020-12-22,362,4079,352,3990,10,89,1.0,7,6.0,50,0.0,1,10,85,0.0,3,0.0,0,0,0
9,2020-12-23,434,4513,427,4417,7,96,0.0,7,7.0,57,1.0,2,6,91,0.0,3,0.0,0,0,0
10,2020-12-24,101,4614,99,4516,2,98,0.0,7,3.0,60,0.0,2,2,93,0.0,3,0.0,0,0,0
11,2020-12-25,2,4616,2,4518,0,98,,7,,60,0.0,2,0,93,,3,,0,0,0
12,2020-12-26,225,4841,224,4742,1,99,0.0,7,3.0,63,0.0,2,1,94,0.0,3,0.0,0,0,0
13,2020-12-27,277,5118,276,5018,1,100,1.0,8,196.0,259,0.0,2,1,95,0.0,3,,0,0,0
14,2020-12-28,713,5831,702,5720,11,111,1.0,9,391.0,650,0.0,2,10,105,1.0,4,0.0,0,0,0
15,2020-12-29,920,6751,913,6633,7,118,1.0,10,462.0,1112,0.0,2,7,112,0.0,4,0.0,0,0,0
16,2020-12-30,875,7626,869,7502,6,124,1.0,11,275.0,1387,0.0,2,5,117,1.0,5,0.0,0,0,0
17,2020-12-31,924,8550,915,8417,10,134,3.0,14,348.0,1735,0.0,2,10,127,0.0,5,0.0,0,0,0
18,2021-01-01,4,8554,4,8421,0,134,,14,,1735,,2,0,127,,5,,0,0,0
19,2021-01-02,397,8951,392,8813,5,139,1.0,15,146.0,1881,0.0,2,5,132,0.0,5,0.0,0,0,0
20,2021-01-03,119,9070,118,8931,1,140,0.0,15,56.0,1937,0.0,2,1,133,0.0,5,0.0,0,0,0
21,2021-01-04,585,9655,563,9494,22,162,2.0,17,318.0,2255,0.0,2,18,151,3.0,8,1.0,1,0,0
22,2021-01-05,644,10299,628,10122,16,178,2.0,19,408.0,2663,0.0,2,15,166,1.0,9,0.0,1,0,0
23,2021-01-06,1238,11537,912,11034,325,503,3.0,22,525.0,3188,16.0,18,288,454,17.0,26,4.0,5,0,0
24,2021-01-07,1640,13177,691,11725,941,1444,12.0,34,402.0,3590,35.0,53,851,1305,40.0,66,15.0,20,0,0
25,2021-01-08,1965,15142,967,12692,995,2439,12.0,46,483.0,4073,44.0,97,890,2195,40.0,106,21.0,41,0,0
26,2021-01-09,1214,16356,524,13216,687,3126,18.0,64,299.0,4372,19.0,116,621,2816,34.0,140,13.0,54,0,0
27,2021-01-10,688,17044,413,13629,275,3401,4.0,68,254.0,4626,10.0,126,246,3062,14.0,154,5.0,59,0,0
28,2021-01-11,1142,18186,798,14427,341,3742,1.0,69,535.0,5161,10.0,136,309,3371,15.0,169,7.0,66,0,0
29,2021-01-12,1149,19335,858,15285,289,4031,7.0,76,510.0,5671,13.0,149,253,3624,17.0,186,6.0,72,0,0
30,2021-01-13,1074,20409,831,16116,243,4274,1.0,77,379.0,6050,23.0,172,197,3821,15.0,201,8.0,80,0,0
31,2021-01-14,850,21259,815,16931,34,4308,2.0,79,485.0,6535,2.0,174,30,3851,1.0,202,1.0,81,0,0
32,2021-01-15,1213,22472,1197,18128,14,4322,1.0,80,754.0,7289,1.0,175,12,3863,0.0,202,1.0,82,0,0
33,2021-01-16,977,23449,962,19090,15,4337,2.0,82,586.0,7875,0.0,175,14,3877,1.0,203,0.0,82,0,0
34,2021-01-17,48,23497,44,19134,4,4341,0.0,82,18.0,7893,1.0,176,3,3880,0.0,203,0.0,82,0,0
35,2021-01-18,1030,24527,826,19960,202,4543,55.0,137,620.0,8513,8.0,184,180,4060,9.0,212,5.0,87,0,0
36,2021-01-19,1233,25760,1096,21056,135,4678,9.0,146,717.0,9230,9.0,193,115,4175,4.0,216,7.0,94,0,0
37,2021-01-20,1435,27195,1208,22264,226,4904,24.0,170,566.0,9796,15.0,208,178,4353,10.0,226,23.0,117,0,0
38,2021-01-21,2243,29438,2035,24299,203,5107,13.0,183,1586.0,11382,12.0,220,169,4522,11.0,237,11.0,128,0,0
39,2021-01-22,1670,31108,1400,25699,267,5374,87.0,270,1067.0,12449,34.0,254,212,4734,10.0,247,11.0,139,0,0
40,2021-01-23,897,32005,561,26260,335,5709,59.0,329,414.0,12863,7.0,261,306,5040,12.0,259,10.0,149,0,0
41,2021-01-24,385,32390,97,26357,287,5996,207.0,536,54.0,12917,8.0,269,269,5309,9.0,268,1.0,150,0,0
42,2021-01-25,1411,33801,777,27134,631,6627,378.0,914,550.0,13467,14.0,283,589,5898,14.0,282,14.0,164,0,0
43,2021-01-26,1636,35437,700,27834,932,7559,462.0,1376,447.0,13914,31.0,314,856,6754,31.0,313,14.0,178,0,0
44,2021-01-27,1836,37273,771,28605,1065,8624,543.0,1919,328.0,14242,40.0,354,969,7723,40.0,353,16.0,194,0,0
45,2021-01-28,1368,38641,548,29153,819,9443,370.0,2289,305.0,14547,25.0,379,745,8468,22.0,375,27.0,221,0,0
46,2021-01-29,1604,40245,1125,30278,477,9920,166.0,2455,818.0,15365,22.0,401,404,8872,31.0,406,20.0,241,0,0
47,2021-01-30,1217,41462,721,30999,493,10413,216.0,2671,593.0,15958,24.0,425,440,9312,18.0,424,11.0,252,0,0
48,2021-01-31,628,42090,401,31400,223,10636,82.0,2753,361.0,16319,6.0,431,194,9506,10.0,434,13.0,265,0,0
49,2021-02-01,1621,43711,904,32304,712,11348,472.0,3225,655.0,16974,18.0,449,651,10157,26.0,460,17.0,282,0,0
50,2021-02-02,1833,45544,728,33032,1103,12451,721.0,3946,583.0,17557,42.0,491,1013,11170,29.0,489,19.0,301,0,0
51,2021-02-03,1259,46803,581,33613,677,13128,331.0,4277,228.0,17785,46.0,537,568,11738,42.0,531,21.0,322,0,0
52,2021-02-04,2514,49317,1782,35395,730,13858,494.0,4771,1546.0,19331,28.0,565,650,12388,35.0,566,17.0,339,0,0
53,2021-02-05,2552,51869,1521,36916,1022,14880,683.0,5454,1306.0,20637,42.0,607,925,13313,23.0,589,32.0,371,0,0
54,2021-02-06,2218,54087,1601,38517,615,15495,445.0,5899,1241.0,21878,11.0,618,575,13888,21.0,610,8.0,379,0,0
55,2021-02-07,234,54321,87,38604,142,15637,95.0,5994,26.0,21904,7.0,625,125,14013,3.0,613,7.0,386,0,0
56,2021-02-08,2485,56806,1594,40198,890,16527,603.0,6597,1138.0,23042,28.0,653,811,14824,24.0,637,27.0,413,0,0
57,2021-02-09,2375,59181,1564,41762,813,17340,497.0,7094,1009.0,24051,30.0,683,716,15540,32.0,669,35.0,448,0,0
58,2021-02-10,1611,60792,1017,42779,593,17933,323.0,7417,304.0,24355,25.0,708,526,16066,21.0,690,21.0,469,0,0
59,2021-02-11,3535,64327,2011,44790,1523,19456,1060.0,8477,810.0,25165,56.0,764,1387,17453,43.0,733,37.0,506,0,0
60,2021-02-12,3245,67572,1791,46581,1450,20906,953.0,9430,797.0,25962,59.0,823,1323,18776,39.0,772,29.0,535,0,0
61,2021-02-13,2991,70563,2383,48964,606,21512,313.0,9743,664.0,26626,14.0,837,553,19329,23.0,795,16.0,551,0,0
62,2021-02-14,419,70982,346,49310,72,21584,50.0,9793,42.0,26668,2.0,839,64,19393,2.0,797,4.0,555,0,0
63,2021-02-15,2616,73598,2124,51434,491,22075,331.0,10124,252.0,26920,17.0,856,454,19847,11.0,808,9.0,564,0,0
64,2021-02-16,2763,76361,1928,53362,833,22908,503.0,10627,229.0,27149,35.0,891,754,20601,23.0,831,21.0,585,0,0
65,2021-02-17,1615,77976,637,53999,968,23876,470.0,11097,155.0,27304,32.0,923,883,21484,36.0,867,17.0,602,0,0
66,2021-02-18,2647,80623,1679,55678,963,24839,742.0,11839,276.0,27580,37.0,960,877,22361,28.0,895,21.0,623,0,0
67,2021-02-19,2401,83024,1039,56717,1360,26199,1022.0,12861,158.0,27738,48.0,1008,1258,23619,35.0,930,19.0,642,0,0
68,2021-02-20,1650,84674,683,57400,965,27164,784.0,13645,131.0,27869,26.0,1034,895,24514,28.0,958,16.0,658,0,0
69,2021-02-21,99,84773,36,57436,62,27226,31.0,13676,8.0,27877,1.0,1035,59,24573,1.0,959,1.0,659,0,0
70,2021-02-22,2031,86804,765,58201,1263,28489,932.0,14608,149.0,28026,40.0,1075,1172,25745,38.0,997,13.0,672,0,0
71,2021-02-23,1216,88020,510,58711,705,29194,471.0,15079,155.0,28181,20.0,1095,633,26378,30.0,1027,22.0,694,0,0
72,2021-02-24,1409,89429,760,59471,645,29839,269.0,15348,134.0,28315,27.0,1122,593,26971,15.0,1042,10.0,704,0,0
73,2021-02-25,3871,93300,2069,61540,1800,31639,1517.0,16865,345.0,28660,48.0,1170,1695,28666,35.0,1077,22.0,726,0,0
74,2021-02-26,3265,96565,1158,62698,2101,33740,1751.0,18616,203.0,28863,38.0,1208,1980,30646,53.0,1130,30.0,756,0,0
75,2021-02-27,3489,100054,1663,64361,1820,35560,1562.0,20178,553.0,29416,41.0,1249,1695,32341,49.0,1179,35.0,791,0,0
76,2021-02-28,427,100481,360,64721,64,35624,39.0,20217,115.0,29531,2.0,1251,55,32396,2.0,1181,5.0,796,0,0
77,2021-03-01,2861,103342,1379,66100,1482,37106,1084.0,21301,303.0,29834,52.0,1303,1372,33768,40.0,1221,18.0,814,0,0
78,2021-03-02,3276,106618,1748,67848,1528,38634,1058.0,22359,384.0,30218,38.0,1341,1413,35181,37.0,1258,40.0,854,0,0
79,2021-03-03,1641,108259,1065,68913,579,39213,179.0,22538,198.0,30416,31.0,1372,521,35702,21.0,1279,6.0,860,0,0
80,2021-03-04,2990,111249,1569,70482,1453,40666,821.0,23359,166.0,30582,46.0,1418,1333,37035,50.0,1329,24.0,884,0,0
81,2021-03-05,3476,114725,2063,72545,1460,42126,821.0,24180,429.0,31011,40.0,1458,1347,38382,39.0,1368,34.0,918,0,0
82,2021-03-06,4066,118791,2294,74839,2692,44818,859.0,25039,265.0,31276,185.0,1643,2356,40738,105.0,1473,46.0,964,0,0
83,2021-03-07,407,119198,292,75131,148,44966,37.0,25076,21.0,31297,4.0,1647,134,40872,3.0,1476,7.0,971,0,0
84,2021-03-08,2812,122010,1037,76168,1928,46894,270.0,25346,74.0,31371,54.0,1701,1775,42647,66.0,1542,33.0,1004,0,0
85,2021-03-09,3157,125167,1625,77793,1636,48530,256.0,25602,93.0,31464,56.0,1757,1487,44134,60.0,1602,33.0,1037,0,0
86,2021-03-10,2362,127529,1348,79141,1092,49622,306.0,25908,84.0,31548,53.0,1810,980,45114,31.0,1633,28.0,1065,0,0
87,2021-03-11,4175,131704,2372,81513,1898,51520,395.0,26303,137.0,31685,67.0,1877,1723,46837,67.0,1700,41.0,1106,0,0
88,2021-03-12,3923,135627,2577,84090,1449,52969,196.0,26499,65.0,31750,89.0,1966,1266,48103,53.0,1753,41.0,1147,0,0
89,2021-03-13,210,135837,133,84223,128,53097,21.0,26520,6.0,31756,2.0,1968,119,48222,4.0,1757,3.0,1150,0,0
90,2021-03-14,94,135931,59,84282,36,53133,8.0,26528,1.0,31757,1.0,1969,34,48256,1.0,1758,,1150,0,0
91,2021-03-15,897,136828,362,84644,552,53685,84.0,26612,13.0,31770,22.0,1991,508,48764,15.0,1773,7.0,1157,0,0
92,2021-03-16,3294,140122,2123,86767,1213,54898,224.0,26836,42.0,31812,71.0,2062,1072,49836,40.0,1813,30.0,1187,0,0
93,2021-03-17,2888,143010,1773,88540,1164,56062,233.0,27069,89.0,31901,40.0,2102,1054,50890,38.0,1851,32.0,1219,0,0
94,2021-03-18,4017,147027,2090,90630,1953,58015,340.0,27409,96.0,31997,100.0,2202,1749,52639,58.0,1909,46.0,1265,0,0
95,2021-03-19,2990,150017,1726,92356,1283,59298,222.0,27631,41.0,32038,68.0,2270,1150,53789,43.0,1952,22.0,1287,0,0
96,2021-03-20,3067,153084,1951,94307,1158,60456,315.0,27946,52.0,32090,40.0,2310,1040,54829,51.0,2003,27.0,1314,0,0
97,2021-03-21,655,153739,392,94699,280,60736,26.0,27972,5.0,32095,14.0,2324,245,55074,18.0,2021,3.0,1317,0,0
98,2021-03-22,3128,156867,2247,96946,908,61644,190.0,28162,60.0,32155,20.0,2344,834,55908,35.0,2056,19.0,1336,0,0
99,2021-03-23,4461,161328,3586,100532,1716,63360,195.0,28357,79.0,32234,70.0,2414,1486,57394,99.0,2155,61.0,1397,0,0
100,2021-03-24,3127,164455,2405,102937,776,64136,117.0,28474,37.0,32271,50.0,2464,684,58078,26.0,2181,16.0,1413,0,0
101,2021-03-25,5055,169510,3044,105981,2030,66166,308.0,28782,68.0,32339,72.0,2536,1838,59916,67.0,2248,53.0,1466,0,0
102,2021-03-26,4596,174106,2745,108726,1876,68042,323.0,29105,67.0,32406,116.0,2652,1616,61532,108.0,2356,36.0,1502,0,0
103,2021-03-27,3332,177438,1908,110634,1426,69468,328.0,29433,22.0,32428,50.0,2702,1306,62838,43.0,2399,27.0,1529,0,0
104,2021-03-28,1145,178583,792,111426,354,69822,91.0,29524,14.0,32442,12.0,2714,323,63161,14.0,2413,5.0,1534,0,0
105,2021-03-29,3999,182582,2681,114107,1337,71159,237.0,29761,51.0,32493,45.0,2759,1245,64406,25.0,2438,22.0,1556,0,0
106,2021-03-30,4362,186944,2748,116855,1696,72855,243.0,30004,77.0,32570,60.0,2819,1535,65941,67.0,2505,34.0,1590,0,0
107,2021-03-31,3497,190441,2501,119356,1063,73918,167.0,30171,47.0,32617,40.0,2859,948,66889,48.0,2553,27.0,1617,0,0
108,2021-04-01,5040,195481,3267,122623,1815,75733,147.0,30318,73.0,32690,74.0,2933,1652,68541,55.0,2608,34.0,1651,0,0
109,2021-04-02,4670,200151,2481,125104,2221,77954,248.0,30566,47.0,32737,88.0,3021,2010,70551,84.0,2692,39.0,1690,0,0
110,2021-04-03,4273,204424,3553,128657,835,78789,92.0,30658,39.0,32776,40.0,3061,735,71286,25.0,2717,35.0,1725,0,0
111,2021-04-04,355,204779,244,128901,163,78952,7.0,30665,7.0,32783,4.0,3065,142,71428,12.0,2729,5.0,1730,0,0
112,2021-04-05,4666,209445,3745,132646,1046,79998,82.0,30747,47.0,32830,72.0,3137,906,72334,45.0,2774,23.0,1753,0,0
113,2021-04-06,5134,214579,3001,135647,2635,82633,90.0,30837,57.0,32887,97.0,3234,2302,74636,153.0,2927,83.0,1836,0,0
114,2021-04-07,4922,219501,3677,139324,3475,86108,84.0,30921,107.0,32994,144.0,3378,2985,77621,211.0,3138,135.0,1971,0,0
115,2021-04-08,6678,226179,4496,143820,4005,90113,168.0,31089,122.0,33116,175.0,3553,3497,81118,204.0,3342,129.0,2100,0,0
116,2021-04-09,5698,231877,3247,147067,4166,94279,91.0,31180,69.0,33185,196.0,3749,3617,84735,220.0,3562,133.0,2233,0,0
117,2021-04-10,4375,236252,3102,150169,2379,96658,70.0,31250,68.0,33253,133.0,3882,1998,86733,172.0,3734,76.0,2309,0,0
118,2021-04-11,1010,237262,777,150946,344,97002,6.0,31256,10.0,33263,12.0,3894,287,87020,36.0,3770,9.0,2318,0,0
119,2021-04-12,5036,242298,3640,154586,2654,99656,98.0,31354,96.0,33359,101.0,3995,2301,89321,166.0,3936,86.0,2404,0,0
120,2021-04-13,5057,247355,3585,158171,1515,101171,57.0,31411,76.0,33435,76.0,4071,1318,90639,91.0,4027,30.0,2434,0,0
121,2021-04-14,2892,250247,1396,159567,1490,102661,88.0,31499,26.0,33461,88.0,4159,1287,91926,63.0,4090,52.0,2486,0,0
122,2021-04-15,4936,255183,2315,161882,2616,105277,100.0,31599,55.0,33516,230.0,4389,2154,94080,156.0,4246,76.0,2562,0,0
123,2021-04-16,3885,259068,2062,163944,1814,107091,46.0,31645,32.0,33548,73.0,4462,1569,95649,119.0,4365,53.0,2615,0,0
124,2021-04-17,4555,263623,2376,166320,2173,109264,36.0,31681,57.0,33605,111.0,4573,1874,97523,127.0,4492,61.0,2676,0,0
125,2021-04-18,1006,264629,409,166729,592,109856,11.0,31692,11.0,33616,39.0,4612,503,98026,28.0,4520,22.0,2698,0,0
126,2021-04-19,3861,268490,1408,168137,2444,112300,44.0,31736,42.0,33658,178.0,4790,2038,100064,152.0,4672,76.0,2774,0,0
127,2021-04-20,4711,273201,1873,170010,2827,115127,48.0,31784,67.0,33725,154.0,4944,2395,102459,174.0,4846,104.0,2878,0,0
128,2021-04-21,3125,276326,704,170714,2408,117535,33.0,31817,32.0,33757,147.0,5091,2021,104480,151.0,4997,89.0,2967,0,0
129,2021-04-22,4627,280953,1752,172466,2865,120400,47.0,31864,63.0,33820,151.0,5242,2438,106918,185.0,5182,91.0,3058,0,0
130,2021-04-23,3545,284498,1170,173636,2367,122767,39.0,31903,32.0,33852,82.0,5324,2075,108993,116.0,5298,94.0,3152,0,0
131,2021-04-24,3358,287856,1098,174734,2252,125019,12.0,31915,21.0,33873,113.0,5437,1880,110873,184.0,5482,75.0,3227,0,0
132,2021-04-25,766,288622,339,175073,427,125446,6.0,31921,5.0,33878,105.0,5542,246,111119,32.0,5514,44.0,3271,0,0
133,2021-04-26,4318,292940,1091,176164,3219,128665,33.0,31954,30.0,33908,151.0,5693,2778,113897,197.0,5711,93.0,3364,0,0
134,2021-04-27,3349,296289,1204,177368,2158,130823,38.0,31992,36.0,33944,81.0,5774,1888,115785,128.0,5839,61.0,3425,0,0
135,2021-04-28,2932,299221,714,178082,2234,133057,44.0,32036,22.0,33966,167.0,5941,1791,117576,181.0,6020,95.0,3520,0,0
136,2021-04-29,3905,303126,816,178898,3101,136158,67.0,32103,35.0,34001,234.0,6175,2536,120112,225.0,6245,106.0,3626,0,0
137,2021-04-30,2816,305942,629,179527,2200,138358,48.0,32151,24.0,34025,67.0,6242,1868,121980,182.0,6427,83.0,3709,0,0
138,2021-05-01,3580,309522,807,180334,2762,141120,34.0,32185,16.0,34041,312.0,6554,2137,124117,187.0,6614,126.0,3835,0,0
139,2021-05-02,498,310020,232,180566,290,141410,8.0,32193,3.0,34044,9.0,6563,232,124349,35.0,6649,14.0,3849,0,0
140,2021-05-03,3426,313446,660,181226,2787,144197,45.0,32238,36.0,34080,116.0,6679,2378,126727,198.0,6847,95.0,3944,0,0
141,2021-05-04,4366,317812,711,181937,3718,147915,69.0,32307,31.0,34111,148.0,6827,3178,129905,243.0,7090,149.0,4093,0,0
142,2021-05-05,2184,319996,475,182412,1766,149681,65.0,32372,25.0,34136,83.0,6910,1456,131361,136.0,7226,91.0,4184,0,0
143,2021-05-06,3655,323651,820,183232,3026,152707,102.0,32474,40.0,34176,195.0,7105,2481,133842,191.0,7417,159.0,4343,0,0
144,2021-05-07,2929,326580,543,183775,2522,155229,47.0,32521,11.0,34187,149.0,7254,2058,135900,200.0,7617,115.0,4458,0,0
145,2021-05-08,3003,329583,559,184334,2621,157850,49.0,32570,16.0,34203,194.0,7448,2096,137996,184.0,7801,147.0,4605,0,0
146,2021-05-09,347,329930,135,184469,229,158079,4.0,32574,2.0,34205,9.0,7457,192,138188,19.0,7820,9.0,4614,0,0
147,2021-05-10,2414,332344,367,184836,2111,160190,64.0,32638,15.0,34220,96.0,7553,1699,139887,201.0,8021,115.0,4729,0,0
148,2021-05-11,2708,335052,539,185375,2233,162423,89.0,32727,24.0,34244,207.0,7760,1722,141609,196.0,8217,108.0,4837,0,0
149,2021-05-12,1173,336225,452,185827,803,163226,24.0,32751,12.0,34256,55.0,7815,631,142240,82.0,8299,35.0,4872,0,0
150,2021-05-13,3219,339444,1020,186847,2233,165459,81.0,32832,24.0,34280,167.0,7982,1796,144036,154.0,8453,116.0,4988,0,0
151,2021-05-14,2440,341884,1284,188131,1291,166750,52.0,32884,29.0,34309,68.0,8050,1073,145109,94.0,8547,56.0,5044,0,0
152,2021-05-15,2961,344845,1493,189624,1598,168348,41.0,32925,15.0,34324,116.0,8166,1269,146378,140.0,8687,73.0,5117,0,0
153,2021-05-16,931,345776,566,190190,408,168756,5.0,32930,7.0,34331,88.0,8254,251,146629,29.0,8716,40.0,5157,0,0
154,2021-05-17,2410,348186,1211,191401,1298,170054,36.0,32966,27.0,34358,53.0,8307,1080,147709,99.0,8815,66.0,5223,0,0
155,2021-05-18,2541,350727,1154,192555,1439,171493,44.0,33010,21.0,34379,76.0,8383,1199,148908,84.0,8899,80.0,5303,0,0
156,2021-05-19,1865,352592,1149,193704,795,172288,26.0,33036,19.0,34398,41.0,8424,650,149558,62.0,8961,42.0,5345,0,0
157,2021-05-20,1925,354517,912,194616,1074,173362,48.0,33084,28.0,34426,95.0,8519,853,150411,77.0,9038,49.0,5394,0,0
158,2021-05-21,1600,356117,913,195529,791,174153,21.0,33105,17.0,34443,50.0,8569,631,151042,54.0,9092,56.0,5450,0,0
159,2021-05-22,1656,357773,784,196313,911,175064,8.0,33113,14.0,34457,137.0,8706,634,151676,72.0,9164,68.0,5518,0,0
160,2021-05-23,670,358443,340,196653,361,175425,2.0,33115,5.0,34462,70.0,8776,223,151899,19.0,9183,49.0,5567,0,0
161,2021-05-24,1314,359757,526,197179,873,176298,39.0,33154,17.0,34479,50.0,8826,705,152604,80.0,9263,38.0,5605,0,0
162,2021-05-25,1204,360961,487,197666,765,177063,27.0,33181,19.0,34498,57.0,8883,594,153198,63.0,9326,51.0,5656,0,0
163,2021-05-26,928,361889,533,198199,536,177599,20.0,33201,25.0,34523,37.0,8920,430,153628,43.0,9369,26.0,5682,0,0
164,2021-05-27,1234,363123,644,198843,677,178276,30.0,33231,20.0,34543,59.0,8979,543,154171,46.0,9415,29.0,5711,0,0
165,2021-05-28,1026,364149,592,199435,500,178776,19.0,33250,22.0,34565,37.0,9016,387,154558,45.0,9460,31.0,5742,0,0
166,2021-05-29,1017,365166,495,199930,570,179346,16.0,33266,9.0,34574,37.0,9053,445,155003,44.0,9504,44.0,5786,0,0
167,2021-05-30,314,365480,210,200140,144,179490,5.0,33271,3.0,34577,14.0,9067,104,155107,16.0,9520,10.0,5796,0,0
168,2021-05-31,323,365803,185,200325,172,179662,8.0,33279,6.0,34583,8.0,9075,140,155247,12.0,9532,12.0,5808,0,0
169,2021-06-01,944,366747,383,200708,610,180272,29.0,33308,17.0,34600,54.0,9129,474,155721,39.0,9571,43.0,5851,0,0
170,2021-06-02,697,367444,350,201058,412,180684,14.0,33322,8.0,34608,34.0,9163,336,156057,18.0,9589,24.0,5875,0,0
171,2021-06-03,1293,368737,522,201580,837,181521,24.0,33346,12.0,34620,53.0,9216,695,156752,50.0,9639,39.0,5914,0,0
172,2021-06-04,1495,370232,408,201988,1139,182660,15.0,33361,9.0,34629,69.0,9285,952,157704,70.0,9709,48.0,5962,0,0
173,2021-06-05,1404,371636,364,202352,1077,183737,12.0,33373,6.0,34635,68.0,9353,881,158585,86.0,9795,42.0,6004,0,0
174,2021-06-06,511,372147,137,202489,391,184128,5.0,33378,3.0,34638,36.0,9389,317,158902,24.0,9819,14.0,6018,0,0
175,2021-06-07,1185,373332,334,202823,912,185040,15.0,33393,12.0,34650,71.0,9460,731,159633,80.0,9899,30.0,6048,0,0
176,2021-06-08,1061,374393,248,203071,851,185891,16.0,33409,5.0,34655,60.0,9520,692,160325,62.0,9961,37.0,6085,0,0
177,2021-06-09,1060,375453,281,203352,840,186731,14.0,33423,13.0,34668,76.0,9596,654,160979,62.0,10023,48.0,6133,0,0
178,2021-06-10,1281,376734,333,203685,996,187727,19.0,33442,5.0,34673,97.0,9693,788,161767,61.0,10084,50.0,6183,0,0
179,2021-06-11,1100,377834,325,204010,829,188556,19.0,33461,13.0,34686,58.0,9751,651,162418,72.0,10156,48.0,6231,0,0
180,2021-06-12,1026,378860,292,204302,789,189345,17.0,33478,10.0,34696,78.0,9829,614,163032,58.0,10214,39.0,6270,0,0
181,2021-06-13,366,379226,95,204397,286,189631,4.0,33482,1.0,34697,35.0,9864,206,163238,23.0,10237,22.0,6292,0,0
182,2021-06-14,802,380028,272,204669,577,190208,14.0,33496,4.0,34701,45.0,9909,446,163684,45.0,10282,41.0,6333,0,0
183,2021-06-15,671,380699,240,204909,461,190669,20.0,33516,10.0,34711,39.0,9948,380,164064,28.0,10310,14.0,6347,0,0
184,2021-06-16,605,381304,205,205114,434,191103,12.0,33528,4.0,34715,36.0,9984,329,164393,28.0,10338,41.0,6388,0,0
185,2021-06-17,672,381976,243,205357,457,191560,14.0,33542,10.0,34725,45.0,10029,343,164736,48.0,10386,21.0,6409,0,0
186,2021-06-18,1006,382982,372,205729,671,192231,22.0,33564,11.0,34736,54.0,10083,537,165273,54.0,10440,26.0,6435,0,0
187,2021-06-19,631,383613,153,205882,499,192730,10.0,33574,6.0,34742,51.0,10134,369,165642,50.0,10490,29.0,6464,0,0
188,2021-06-20,291,383904,110,205992,191,192921,3.0,33577,2.0,34744,38.0,10172,115,165757,14.0,10504,24.0,6488,0,0
189,2021-06-21,499,384403,211,206203,324,193245,5.0,33582,8.0,34752,29.0,10201,240,165997,35.0,10539,20.0,6508,0,0
190,2021-06-22,594,384997,246,206449,385,193630,13.0,33595,7.0,34759,31.0,10232,304,166301,21.0,10560,29.0,6537,0,0
191,2021-06-23,506,385503,197,206646,349,193979,9.0,33604,10.0,34769,39.0,10271,252,166553,35.0,10595,23.0,6560,0,0
192,2021-06-24,515,386018,211,206857,332,194311,12.0,33616,9.0,34778,28.0,10299,260,166813,21.0,10616,23.0,6583,0,0
193,2021-06-25,683,386701,269,207126,440,194751,13.0,33629,8.0,34786,49.0,10348,325,167138,37.0,10653,29.0,6612,0,0
194,2021-06-26,596,387297,168,207294,444,195195,10.0,33639,8.0,34794,78.0,10426,292,167430,40.0,10693,34.0,6646,0,0
195,2021-06-27,176,387473,73,207367,106,195301,2.0,33641,3.0,34797,10.0,10436,76,167506,10.0,10703,10.0,6656,0,0
196,2021-06-28,478,387951,210,207577,281,195582,6.0,33647,7.0,34804,40.0,10476,201,167707,24.0,10727,16.0,6672,0,0
197,2021-06-29,541,388492,256,207833,321,195903,17.0,33664,11.0,34815,44.0,10520,234,167941,20.0,10747,23.0,6695,0,0
198,2021-06-30,392,388884,197,208030,215,196118,8.0,33672,11.0,34826,17.0,10537,163,168104,16.0,10763,19.0,6714,0,0
199,2021-07-01,474,389358,205,208235,297,196415,10.0,33682,8.0,34834,21.0,10558,227,168331,30.0,10793,19.0,6733,0,0
200,2021-07-02,554,389912,269,208504,302,196717,5.0,33687,7.0,34841,26.0,10584,238,168569,21.0,10814,17.0,6750,0,0
201,2021-07-03,300,390212,117,208621,193,196910,4.0,33691,4.0,34845,34.0,10618,128,168697,19.0,10833,12.0,6762,0,0
202,2021-07-04,53,390265,18,208639,35,196945,1.0,33692,0.0,34845,5.0,10623,22,168719,1.0,10834,7.0,6769,0,0
203,2021-07-05,297,390562,136,208775,163,197108,3.0,33695,1.0,34846,17.0,10640,113,168832,22.0,10856,11.0,6780,0,0
204,2021-07-06,435,390997,184,208959,265,197373,4.0,33699,5.0,34851,45.0,10685,189,169021,15.0,10871,16.0,6796,0,0
205,2021-07-07,365,391362,211,209170,177,197550,8.0,33707,6.0,34857,19.0,10704,137,169158,9.0,10880,12.0,6808,0,0
206,2021-07-08,412,391774,195,209365,245,197795,11.0,33718,8.0,34865,27.0,10731,172,169330,22.0,10902,24.0,6832,0,0
207,2021-07-09,476,392250,190,209555,300,198095,10.0,33728,3.0,34868,37.0,10768,219,169549,24.0,10926,20.0,6852,0,0
208,2021-07-10,252,392502,141,209696,128,198223,5.0,33733,2.0,34870,6.0,10774,106,169655,11.0,10937,5.0,6857,0,0
209,2021-07-11,222,392724,125,209821,127,198350,6.0,33739,6.0,34876,10.0,10784,93,169748,10.0,10947,14.0,6871,0,0
210,2021-07-12,373,393097,201,210022,186,198536,6.0,33745,4.0,34880,26.0,10810,123,169871,20.0,10967,17.0,6888,0,0
211,2021-07-13,422,393519,219,210241,223,198759,15.0,33760,10.0,34890,26.0,10836,174,170045,12.0,10979,11.0,6899,0,0
212,2021-07-14,281,393800,145,210386,168,198927,8.0,33768,4.0,34894,19.0,10855,122,170167,10.0,10989,17.0,6916,0,0
213,2021-07-15,359,394159,186,210572,181,199108,1.0,33769,4.0,34898,16.0,10871,136,170303,14.0,11003,15.0,6931,0,0
214,2021-07-16,501,394660,239,210811,277,199385,8.0,33777,8.0,34906,21.0,10892,218,170521,18.0,11021,20.0,6951,0,0
215,2021-07-17,278,394938,160,210971,137,199522,12.0,33789,5.0,34911,12.0,10904,102,170623,11.0,11032,12.0,6963,0,0
216,2021-07-18,192,395130,120,211091,89,199611,3.0,33792,3.0,34914,14.0,10918,63,170686,7.0,11039,5.0,6968,0,0
217,2021-07-19,400,395530,202,211293,212,199823,9.0,33801,8.0,34922,27.0,10945,157,170843,16.0,11055,12.0,6980,0,0
218,2021-07-20,403,395933,208,211501,211,200034,6.0,33807,8.0,34930,16.0,10961,160,171003,20.0,11075,15.0,6995,0,0
219,2021-07-21,315,396248,175,211676,163,200197,13.0,33820,14.0,34944,12.0,10973,123,171126,12.0,11087,16.0,7011,0,0
220,2021-07-22,384,396632,231,211907,169,200366,8.0,33828,18.0,34962,19.0,10992,122,171248,17.0,11104,11.0,7022,0,0
221,2021-07-23,537,397169,313,212220,231,200597,6.0,33834,10.0,34972,33.0,11025,163,171411,17.0,11121,18.0,7040,0,0
222,2021-07-24,351,397520,219,212439,160,200757,10.0,33844,11.0,34983,19.0,11044,119,171530,9.0,11130,13.0,7053,0,0
223,2021-07-25,201,397721,149,212588,66,200823,1.0,33845,4.0,34987,7.0,11051,48,171578,5.0,11135,6.0,7059,0,0
224,2021-07-26,342,398063,205,212793,140,200963,1.0,33846,7.0,34994,7.0,11058,100,171678,15.0,11150,18.0,7077,0,0
225,2021-07-27,407,398470,237,213030,164,201127,5.0,33851,16.0,35010,19.0,11077,118,171796,16.0,11166,11.0,7088,0,0
226,2021-07-28,459,398929,281,213311,222,201349,4.0,33855,9.0,35019,28.0,11105,142,171938,16.0,11182,36.0,7124,0,0
227,2021-07-29,492,399421,311,213622,224,201573,7.0,33862,6.0,35025,24.0,11129,168,172106,12.0,11194,20.0,7144,0,0
228,2021-07-30,667,400088,470,214092,241,201814,10.0,33872,15.0,35040,27.0,11156,182,172288,15.0,11209,17.0,7161,0,0
229,2021-07-31,321,400409,197,214289,129,201943,4.0,33876,1.0,35041,12.0,11168,103,172391,8.0,11217,6.0,7167,0,0
230,2021-08-01,252,400661,159,214448,98,202041,0.0,33876,2.0,35043,12.0,11180,63,172454,6.0,11223,17.0,7184,0,0
231,2021-08-02,439,401100,298,214746,173,202214,4.0,33880,13.0,35056,20.0,11200,117,172571,20.0,11243,16.0,7200,0,0
232,2021-08-03,553,401653,345,215091,240,202454,6.0,33886,13.0,35069,37.0,11237,164,172735,15.0,11258,24.0,7224,0,0
233,2021-08-04,373,402026,266,215357,141,202595,5.0,33891,13.0,35082,10.0,11247,104,172839,5.0,11263,22.0,7246,0,0
234,2021-08-05,437,402463,291,215648,164,202759,5.0,33896,10.0,35092,20.0,11267,114,172953,17.0,11280,13.0,7259,0,0
235,2021-08-06,665,403128,460,216108,262,203021,12.0,33908,16.0,35108,22.0,11289,194,173147,23.0,11303,23.0,7282,0,0
236,2021-08-07,433,403561,301,216409,156,203177,3.0,33911,10.0,35118,13.0,11302,123,173270,4.0,11307,16.0,7298,0,0
237,2021-08-08,217,403778,129,216538,100,203277,3.0,33914,4.0,35122,8.0,11310,73,173343,6.0,11313,13.0,7311,0,0
238,2021-08-09,449,404227,278,216816,213,203490,4.0,33918,6.0,35128,21.0,11331,161,173504,13.0,11326,18.0,7329,0,0
239,2021-08-10,491,404718,293,217109,227,203717,6.0,33924,14.0,35142,26.0,11357,175,173679,12.0,11338,14.0,7343,0,0
240,2021-08-11,403,405121,261,217370,168,203885,11.0,33935,5.0,35147,13.0,11370,129,173808,14.0,11352,12.0,7355,0,0
241,2021-08-12,532,405653,320,217690,257,204142,6.0,33941,15.0,35162,32.0,11402,180,173988,22.0,11374,23.0,7378,0,0
242,2021-08-13,645,406298,375,218065,296,204438,12.0,33953,10.0,35172,29.0,11431,220,174208,17.0,11391,30.0,7408,0,0
243,2021-08-14,496,406794,261,218326,253,204691,7.0,33960,8.0,35180,9.0,11440,218,174426,9.0,11400,17.0,7425,43,43
244,2021-08-15,265,407059,131,218457,126,204817,2.0,33962,5.0,35185,10.0,11450,93,174519,7.0,11407,16.0,7441,16,59
245,2021-08-16,516,407575,300,218757,169,204986,6.0,33968,14.0,35199,13.0,11463,130,174649,13.0,11420,13.0,7454,75,134
246,2021-08-17,466,408041,221,218978,183,205169,16.0,33984,9.0,35208,17.0,11480,137,174786,9.0,11429,20.0,7474,84,218
247,2021-08-18,576,408617,325,219303,259,205428,6.0,33990,15.0,35223,32.0,11512,172,174958,12.0,11441,43.0,7517,68,286
248,2021-08-19,550,409167,277,219580,255,205683,7.0,33997,8.0,35231,21.0,11533,201,175159,16.0,11457,17.0,7534,78,364
249,2021-08-20,824,409991,338,219918,451,206134,18.0,34015,13.0,35244,49.0,11582,353,175512,28.0,11485,21.0,7555,89,453
250,2021-08-21,633,410624,209,220127,214,206348,5.0,34020,9.0,35253,19.0,11601,172,175684,12.0,11497,11.0,7566,222,675
251,2021-08-22,305,410929,147,220274,137,206485,1.0,34021,2.0,35255,17.0,11618,97,175781,9.0,11506,14.0,7580,31,706
252,2021-08-23,517,411446,260,220534,218,206703,11.0,34032,9.0,35264,19.0,11637,163,175944,13.0,11519,23.0,7603,63,769
253,2021-08-24,559,412005,276,220810,278,206981,12.0,34044,12.0,35276,25.0,11662,217,176161,14.0,11533,22.0,7625,50,819
254,2021-08-25,582,412587,323,221133,258,207239,10.0,34054,14.0,35290,19.0,11681,197,176358,9.0,11542,33.0,7658,41,860
255,2021-08-26,522,413109,263,221396,250,207489,10.0,34064,14.0,35304,18.0,11699,193,176551,22.0,11564,17.0,7675,45,905
256,2021-08-27,872,413981,353,221749,402,207891,16.0,34080,12.0,35316,36.0,11735,296,176847,24.0,11588,46.0,7721,162,1067
257,2021-08-28,1420,415401,217,221966,239,208130,8.0,34088,14.0,35330,23.0,11758,176,177023,13.0,11601,27.0,7748,972,2039
258,2021-08-29,1064,416465,172,222138,138,208268,4.0,34092,13.0,35343,6.0,11764,112,177135,12.0,11613,8.0,7756,759,2798
259,2021-08-30,592,417057,268,222406,282,208550,8.0,34100,15.0,35358,26.0,11790,215,177350,8.0,11621,33.0,7789,78,2876
260,2021-08-31,787,417844,235,222641,230,208780,6.0,34106,17.0,35375,17.0,11807,181,177531,18.0,11639,14.0,7803,335,3211
261,2021-09-01,866,418710,236,222877,218,208998,11.0,34117,15.0,35390,20.0,11827,168,177699,10.0,11649,20.0,7823,432,3643
262,2021-09-02,820,419530,194,223071,207,209205,13.0,34130,15.0,35405,20.0,11847,152,177851,16.0,11665,19.0,7842,444,4087
263,2021-09-03,836,420366,336,223407,366,209571,13.0,34143,14.0,35419,46.0,11893,265,178116,20.0,11685,35.0,7877,157,4244
264,2021-09-04,357,420723,165,223572,170,209741,8.0,34151,9.0,35428,14.0,11907,131,178247,12.0,11697,13.0,7890,40,4284
265,2021-09-05,249,420972,134,223706,108,209849,2.0,34153,6.0,35434,11.0,11918,77,178324,9.0,11706,11.0,7901,18,4302
266,2021-09-06,108,421080,48,223754,57,209906,1.0,34154,0.0,35434,3.0,11921,43,178367,8.0,11714,3.0,7904,8,4310
267,2021-09-07,916,421996,197,223951,272,210178,19.0,34173,14.0,35448,23.0,11944,209,178576,18.0,11732,22.0,7926,461,4771
268,2021-09-08,767,422763,223,224174,219,210397,10.0,34183,17.0,35465,22.0,11966,163,178739,9.0,11741,25.0,7951,350,5121
269,2021-09-09,394,423157,177,224351,189,210586,9.0,34192,10.0,35475,21.0,11987,139,178878,13.0,11754,16.0,7967,50,5171
270,2021-09-10,734,423891,339,224690,304,210890,8.0,34200,26.0,35501,26.0,12013,230,179108,20.0,11774,28.0,7995,135,5306
271,2021-09-11,1590,425481,166,224856,195,211085,7.0,34207,23.0,35524,18.0,12031,149,179257,16.0,11790,12.0,8007,1244,6550
272,2021-09-12,225,425706,102,224958,107,211192,1.0,34208,2.0,35526,10.0,12041,70,179327,7.0,11797,20.0,8027,16,6566
273,2021-09-13,482,426188,219,225177,240,211432,9.0,34217,8.0,35534,22.0,12063,182,179509,11.0,11808,25.0,8052,40,6606
274,2021-09-14,818,427006,195,225372,266,211698,12.0,34229,18.0,35552,17.0,12080,210,179719,14.0,11822,25.0,8077,392,6998
275,2021-09-15,810,427816,197,225569,263,211961,15.0,34244,19.0,35571,19.0,12099,190,179909,20.0,11842,34.0,8111,380,7378
276,2021-09-16,339,428155,130,225699,187,212148,7.0,34251,9.0,35580,26.0,12125,139,180048,11.0,11853,11.0,8122,37,7415
277,2021-09-17,728,428883,285,225984,380,212528,16.0,34267,16.0,35596,28.0,12153,282,180330,36.0,11889,34.0,8156,113,7528
278,2021-09-18,1792,430675,135,226119,163,212691,7.0,34274,23.0,35619,10.0,12163,122,180452,11.0,11900,20.0,8176,1504,9032
279,2021-09-19,177,430852,75,226194,105,212796,3.0,34277,2.0,35621,6.0,12169,81,180533,5.0,11905,13.0,8189,10,9042
280,2021-09-20,375,431227,138,226332,218,213014,8.0,34285,10.0,35631,26.0,12195,163,180696,9.0,11914,20.0,8209,49,9091
281,2021-09-21,741,431968,161,226493,183,213197,9.0,34294,17.0,35648,22.0,12217,139,180835,7.0,11921,15.0,8224,411,9502
282,2021-09-22,670,432638,166,226659,220,213417,4.0,34298,12.0,35660,15.0,12232,174,181009,14.0,11935,17.0,8241,326,9828
283,2021-09-23,336,432974,136,226795,177,213594,8.0,34306,3.0,35663,9.0,12241,129,181138,12.0,11947,27.0,8268,46,9874
284,2021-09-24,644,433618,187,226982,241,213835,13.0,34319,14.0,35677,16.0,12257,196,181334,9.0,11956,20.0,8288,223,10097
285,2021-09-25,1659,435277,148,227130,151,213986,12.0,34331,30.0,35707,14.0,12271,117,181451,10.0,11966,10.0,8298,1368,11465
286,2021-09-26,196,435473,47,227177,73,214059,2.0,34333,3.0,35710,8.0,12279,54,181505,4.0,11970,7.0,8305,76,11541
287,2021-09-27,293,435766,110,227287,75,214134,7.0,34340,8.0,35718,4.0,12283,54,181559,5.0,11975,12.0,8317,124,11665
288,2021-09-28,551,436317,51,227338,50,214184,7.0,34347,5.0,35723,6.0,12289,34,181593,4.0,11979,6.0,8323,453,12118
