,Date,daily number of doses received by Larimer County residents,total number of doses recevied by residents,daily number of residents receiving first dose,total number of residents receiving first dose,daily number of residents vaccinated,total number of residents vaccinated,daily number of 70+ vaccinated,total number of 70+ vaccinated,daily number of 70+ at least one dose,total number of 70+ at least one dose,daily number of Latinx residents vaccinated,total of Latinx residents vaccinated,daily number of White non-Latinx residents vaccinated,total of White non-Latinx residents vaccinated,daily number of non-White non-Latinx residents vaccinated,total of non-White non-Latinx residents vaccinated,dailyUnknown,totalUnknown,daily_additional_doses,total_additional_doses
0,12/14/2020,32,32,32,32,1,1,0.0,0,1.0,1,0.0,0,1,1,0.0,0,,0,0,0
1,12/15/2020,13,45,13,45,0,1,,0,,1,,0,0,1,0.0,0,,0,0,0
2,12/16/2020,303,348,303,348,0,1,0.0,0,2.0,3,0.0,0,0,1,0.0,0,0.0,0,0,0
3,12/17/2020,989,1337,989,1337,0,1,0.0,0,11.0,14,0.0,0,0,1,0.0,0,0.0,0,0,0
4,12/18/2020,1057,2394,1057,2394,2,3,0.0,0,15.0,29,0.0,0,2,3,0.0,0,0.0,0,0,0
5,12/19/2020,721,3115,721,3115,0,3,0.0,0,14.0,43,0.0,0,0,3,0.0,0,0.0,0,0,0
6,12/20/2020,265,3380,265,3380,0,3,0.0,0,4.0,47,0.0,0,0,3,0.0,0,0.0,0,0,0
7,12/21/2020,357,3737,357,3737,3,6,0.0,0,3.0,50,0.0,0,3,6,0.0,0,0.0,0,0,0
8,12/22/2020,363,4100,363,4100,0,6,0.0,0,7.0,57,0.0,0,0,6,0.0,0,0.0,0,0,0
9,12/23/2020,438,4538,438,4538,0,6,0.0,0,6.0,63,0.0,0,0,6,0.0,0,0.0,0,0,0
10,12/24/2020,106,4644,106,4644,0,6,0.0,0,3.0,66,0.0,0,0,6,0.0,0,0.0,0,0,0
11,12/25/2020,1,4645,1,4645,0,6,,0,,66,,0,0,6,,0,,0,0,0
12,12/26/2020,227,4872,227,4872,1,7,0.0,0,3.0,69,0.0,0,1,7,0.0,0,0.0,0,0,0
13,12/27/2020,278,5150,278,5150,0,7,0.0,0,197.0,266,0.0,0,0,7,0.0,0,,0,0,0
14,12/28/2020,711,5861,711,5861,0,7,0.0,0,386.0,652,0.0,0,0,7,0.0,0,0.0,0,0,0
15,12/29/2020,909,6770,908,6769,1,8,0.0,0,460.0,1112,0.0,0,1,8,0.0,0,0.0,0,0,0
16,12/30/2020,884,7654,884,7653,0,8,0.0,0,273.0,1385,0.0,0,0,8,0.0,0,0.0,0,0,0
17,12/31/2020,894,8548,894,8547,0,8,0.0,0,342.0,1727,0.0,0,0,8,0.0,0,0.0,0,0,0
18,1/1/2021,4,8552,3,8550,1,9,,0,,1727,,0,1,9,,0,,0,0,0
19,1/2/2021,391,8943,391,8941,1,10,0.0,0,141.0,1868,0.0,0,1,10,0.0,0,0.0,0,0,0
20,1/3/2021,124,9067,124,9065,0,10,0.0,0,52.0,1920,0.0,0,0,10,0.0,0,0.0,0,0,0
21,1/4/2021,590,9657,576,9641,13,23,0.0,0,320.0,2240,0.0,0,10,20,2.0,2,1.0,1,0,0
22,1/5/2021,645,10302,636,10277,10,33,0.0,0,409.0,2649,0.0,0,9,29,1.0,3,0.0,1,0,0
23,1/6/2021,1230,11532,912,11189,310,343,4.0,4,515.0,3164,18.0,18,272,301,16.0,19,4.0,5,0,0
24,1/7/2021,1658,13190,703,11892,927,1270,10.0,14,406.0,3570,33.0,51,837,1138,42.0,61,15.0,20,0,0
25,1/8/2021,1990,15180,981,12873,988,2258,11.0,25,479.0,4049,48.0,99,878,2016,43.0,104,19.0,39,1,1
26,1/9/2021,1230,16410,530,13403,682,2940,12.0,37,303.0,4352,16.0,115,618,2634,37.0,141,11.0,50,0,1
27,1/10/2021,701,17111,427,13830,270,3210,4.0,41,261.0,4613,10.0,125,244,2878,13.0,154,3.0,53,0,1
28,1/11/2021,1147,18258,797,14627,347,3557,1.0,42,535.0,5148,10.0,135,315,3193,19.0,173,3.0,56,0,1
29,1/12/2021,1179,19437,881,15508,297,3854,8.0,50,518.0,5666,14.0,149,257,3450,18.0,191,8.0,64,1,2
30,1/13/2021,1080,20517,836,16344,241,4095,1.0,51,378.0,6044,23.0,172,195,3645,15.0,206,8.0,72,0,2
31,1/14/2021,873,21390,838,17182,35,4130,1.0,52,494.0,6538,2.0,174,31,3676,1.0,207,1.0,73,0,2
32,1/15/2021,1220,22610,1207,18389,13,4143,0.0,52,760.0,7298,0.0,174,13,3689,0.0,207,0.0,73,0,2
33,1/16/2021,985,23595,971,19360,14,4157,1.0,53,585.0,7883,0.0,174,13,3702,1.0,208,0.0,73,0,2
34,1/17/2021,54,23649,50,19410,4,4161,0.0,53,19.0,7902,0.0,174,2,3704,2.0,210,0.0,73,0,2
35,1/18/2021,1013,24662,811,20221,200,4361,48.0,101,597.0,8499,8.0,182,174,3878,13.0,223,5.0,78,2,4
36,1/19/2021,1256,25918,1116,21337,138,4499,7.0,108,737.0,9236,7.0,189,117,3995,6.0,229,8.0,86,0,4
37,1/20/2021,1424,27342,1204,22541,218,4717,17.0,125,572.0,9808,15.0,204,177,4172,9.0,238,17.0,103,1,5
38,1/21/2021,2252,29594,2043,24584,209,4926,7.0,132,1585.0,11393,13.0,217,174,4346,15.0,253,7.0,110,0,5
39,1/22/2021,1737,31331,1461,26045,275,5201,89.0,221,1090.0,12483,34.0,251,221,4567,13.0,266,7.0,117,0,5
40,1/23/2021,895,32226,562,26607,327,5528,54.0,275,417.0,12900,8.0,259,299,4866,13.0,279,7.0,124,0,5
41,1/24/2021,393,32619,104,26711,283,5811,203.0,478,61.0,12961,8.0,267,267,5133,8.0,287,,124,0,5
42,1/25/2021,1408,34027,786,27497,608,6419,358.0,836,554.0,13515,14.0,281,567,5700,15.0,302,12.0,136,0,5
43,1/26/2021,1623,35650,694,28191,914,7333,452.0,1288,442.0,13957,30.0,311,840,6540,32.0,334,12.0,148,0,5
44,1/27/2021,1838,37488,771,28962,1059,8392,532.0,1820,334.0,14291,40.0,351,966,7506,44.0,378,9.0,157,0,5
45,1/28/2021,1348,38836,541,29503,802,9194,354.0,2174,297.0,14588,25.0,376,734,8240,28.0,406,15.0,172,2,7
46,1/29/2021,1633,40469,1155,30658,473,9667,156.0,2330,824.0,15412,21.0,397,410,8650,32.0,438,10.0,182,0,7
47,1/30/2021,1227,41696,733,31391,490,10157,213.0,2543,598.0,16010,24.0,421,439,9089,21.0,459,6.0,188,0,7
48,1/31/2021,624,42320,399,31790,224,10381,76.0,2619,354.0,16364,5.0,426,198,9287,15.0,474,6.0,194,1,8
49,2/1/2021,1608,43928,904,32694,699,11080,466.0,3085,654.0,17018,17.0,443,646,9933,26.0,500,10.0,204,1,9
50,2/2/2021,1865,45793,731,33425,1123,12203,729.0,3814,583.0,17601,43.0,486,1035,10968,34.0,534,11.0,215,0,9
51,2/3/2021,1270,47063,584,34009,683,12886,324.0,4138,225.0,17826,48.0,534,585,11553,41.0,575,9.0,224,0,9
52,2/4/2021,2535,49598,1793,35802,731,13617,488.0,4626,1550.0,19376,30.0,564,654,12207,37.0,612,10.0,234,1,10
53,2/5/2021,2580,52178,1533,37335,1033,14650,680.0,5306,1305.0,20681,38.0,602,948,13155,30.0,642,17.0,251,2,12
54,2/6/2021,2217,54395,1595,38930,613,15263,441.0,5747,1239.0,21920,6.0,608,583,13738,22.0,664,2.0,253,0,12
55,2/7/2021,233,54628,89,39019,140,15403,93.0,5840,26.0,21946,7.0,615,124,13862,4.0,668,5.0,258,1,13
56,2/8/2021,2481,57109,1595,40614,875,16278,589.0,6429,1138.0,23084,26.0,641,805,14667,27.0,695,17.0,275,0,13
57,2/9/2021,2391,59500,1545,42159,840,17118,511.0,6940,998.0,24082,26.0,667,755,15422,32.0,727,27.0,302,0,13
58,2/10/2021,1585,61085,965,43124,615,17733,320.0,7260,288.0,24370,25.0,692,548,15970,26.0,753,16.0,318,4,17
59,2/11/2021,3533,64618,1999,45123,1522,19255,1051.0,8311,808.0,25178,55.0,747,1391,17361,49.0,802,27.0,345,2,19
60,2/12/2021,3266,67884,1812,46935,1437,20692,948.0,9259,800.0,25978,60.0,807,1322,18683,42.0,844,13.0,358,0,19
61,2/13/2021,2998,70882,2365,49300,624,21316,307.0,9566,673.0,26651,13.0,820,577,19260,22.0,866,12.0,370,1,20
62,2/14/2021,420,71302,349,49649,71,21387,49.0,9615,46.0,26697,2.0,822,64,19324,3.0,869,2.0,372,0,20
63,2/15/2021,2628,73930,2132,51781,492,21879,324.0,9939,256.0,26953,17.0,839,461,19785,12.0,881,2.0,374,0,20
64,2/16/2021,2755,76685,1921,53702,824,22703,495.0,10434,231.0,27184,35.0,874,749,20534,24.0,905,16.0,390,0,20
65,2/17/2021,1633,78318,655,54357,971,23674,479.0,10913,155.0,27339,29.0,903,886,21420,36.0,941,20.0,410,0,20
66,2/18/2021,2639,80957,1676,56033,947,24621,726.0,11639,275.0,27614,37.0,940,873,22293,30.0,971,7.0,417,1,21
67,2/19/2021,2420,83377,1030,57063,1369,25990,1011.0,12650,156.0,27770,44.0,984,1266,23559,44.0,1015,15.0,432,3,24
68,2/20/2021,1654,85031,689,57752,956,26946,780.0,13430,134.0,27904,22.0,1006,895,24454,29.0,1044,10.0,442,1,25
69,2/21/2021,110,85141,40,57792,69,27015,38.0,13468,8.0,27912,1.0,1007,66,24520,2.0,1046,0.0,442,0,25
70,2/22/2021,2024,87165,763,58555,1243,28258,918.0,14386,147.0,28059,37.0,1044,1159,25679,37.0,1083,10.0,452,1,26
71,2/23/2021,1225,88390,518,59073,705,28963,471.0,14857,161.0,28220,20.0,1064,636,26315,36.0,1119,13.0,465,0,26
72,2/24/2021,1412,89802,754,59827,651,29614,276.0,15133,136.0,28356,31.0,1095,596,26911,19.0,1138,5.0,470,1,27
73,2/25/2021,3868,93670,2073,61900,1783,31397,1502.0,16635,352.0,28708,47.0,1142,1683,28594,36.0,1174,17.0,487,0,27
74,2/26/2021,3275,96945,1157,63057,2110,33507,1744.0,18379,202.0,28910,33.0,1175,1989,30583,59.0,1233,29.0,516,2,29
75,2/27/2021,3490,100435,1661,64718,1817,35324,1555.0,19934,544.0,29454,36.0,1211,1702,32285,52.0,1285,27.0,543,1,30
76,2/28/2021,429,100864,359,65077,69,35393,43.0,19977,115.0,29569,2.0,1213,63,32348,2.0,1287,2.0,545,0,30
77,3/1/2021,2822,103686,1347,66424,1467,36860,1076.0,21053,299.0,29868,53.0,1266,1356,33704,46.0,1333,12.0,557,5,35
78,3/2/2021,3255,106941,1727,68151,1520,38380,1051.0,22104,383.0,30251,38.0,1304,1411,35115,44.0,1377,27.0,584,1,36
79,3/3/2021,1658,108599,1093,69244,562,38942,174.0,22278,203.0,30454,32.0,1336,502,35617,24.0,1401,4.0,588,0,36
80,3/4/2021,3004,111603,1583,70827,1419,40361,814.0,23092,170.0,30624,42.0,1378,1303,36920,54.0,1455,20.0,608,25,61
81,3/5/2021,3489,115092,2060,72887,1433,41794,811.0,23903,426.0,31050,39.0,1417,1328,38248,43.0,1498,23.0,631,26,87
82,3/6/2021,4118,119210,2334,75221,1981,43775,753.0,24656,268.0,31318,94.0,1511,1778,40026,76.0,1574,33.0,664,589,676
83,3/7/2021,417,119627,302,75523,123,43898,37.0,24693,21.0,31339,1.0,1512,118,40144,2.0,1576,2.0,666,21,697
84,3/8/2021,2823,122450,1055,76578,1773,45671,259.0,24952,75.0,31414,49.0,1561,1639,41783,63.0,1639,22.0,688,124,821
85,3/9/2021,3188,125638,1653,78231,1549,47220,265.0,25217,96.0,31510,51.0,1612,1408,43191,65.0,1704,25.0,713,74,895
86,3/10/2021,2381,128019,1366,79597,1017,48237,298.0,25515,84.0,31594,54.0,1666,915,44106,32.0,1736,16.0,729,64,959
87,3/11/2021,4178,132197,2381,81978,1802,50039,400.0,25915,135.0,31729,63.0,1729,1653,45759,67.0,1803,19.0,748,75,1034
88,3/12/2021,3943,136140,2574,84552,1384,51423,197.0,26112,67.0,31796,64.0,1793,1234,46993,53.0,1856,33.0,781,73,1107
89,3/13/2021,212,136352,129,84681,99,51522,20.0,26132,6.0,31802,1.0,1794,92,47085,4.0,1860,2.0,783,30,1137
90,3/14/2021,101,136453,61,84742,39,51561,9.0,26141,0.0,31802,1.0,1795,36,47121,1.0,1861,1.0,784,2,1139
91,3/15/2021,900,137353,363,85105,537,52098,85.0,26226,15.0,31817,19.0,1814,494,47615,17.0,1878,7.0,791,19,1158
92,3/16/2021,3287,140640,2115,87220,1172,53270,227.0,26453,46.0,31863,65.0,1879,1043,48658,42.0,1920,22.0,813,30,1188
93,3/17/2021,2913,143553,1786,89006,1130,54400,239.0,26692,88.0,31951,40.0,1919,1035,49693,35.0,1955,20.0,833,32,1220
94,3/18/2021,4006,147559,2091,91097,1919,56319,336.0,27028,91.0,32042,96.0,2015,1738,51431,64.0,2019,21.0,854,21,1241
95,3/19/2021,3001,150560,1752,92849,1248,57567,221.0,27249,42.0,32084,60.0,2075,1122,52553,46.0,2065,20.0,874,16,1257
96,3/20/2021,3082,153642,1966,94815,1118,58685,313.0,27562,54.0,32138,37.0,2112,1005,53558,55.0,2120,21.0,895,36,1293
97,3/21/2021,661,154303,397,95212,266,58951,26.0,27588,5.0,32143,11.0,2123,236,53794,16.0,2136,3.0,898,18,1311
98,3/22/2021,3112,157415,2244,97456,866,59817,188.0,27776,56.0,32199,19.0,2142,797,54591,37.0,2173,13.0,911,25,1336
99,3/23/2021,4453,161868,3575,101031,1173,60990,194.0,27970,75.0,32274,38.0,2180,1045,55636,51.0,2224,39.0,950,496,1832
100,3/24/2021,3165,165033,2431,103462,743,61733,118.0,28088,37.0,32311,41.0,2221,662,56298,26.0,2250,14.0,964,39,1871
101,3/25/2021,5068,170101,3054,106516,2011,63744,312.0,28400,71.0,32382,67.0,2288,1843,58141,70.0,2320,31.0,995,15,1886
102,3/26/2021,4585,174686,2727,109243,1855,65599,329.0,28729,65.0,32447,115.0,2403,1595,59736,114.0,2434,31.0,1026,31,1917
103,3/27/2021,3343,178029,1915,111158,1423,67022,325.0,29054,21.0,32468,49.0,2452,1308,61044,46.0,2480,20.0,1046,4,1921
104,3/28/2021,1173,179202,811,111969,362,67384,93.0,29147,16.0,32484,12.0,2464,332,61376,16.0,2496,2.0,1048,4,1925
105,3/29/2021,3990,183192,2693,114662,1290,68674,229.0,29376,53.0,32537,38.0,2502,1211,62587,28.0,2524,13.0,1061,8,1933
106,3/30/2021,4364,187556,2748,117410,1637,70311,237.0,29613,74.0,32611,55.0,2557,1497,64084,67.0,2591,18.0,1079,43,1976
107,3/31/2021,3583,191139,2566,119976,1047,71358,165.0,29778,47.0,32658,42.0,2599,935,65019,50.0,2641,20.0,1099,33,2009
108,4/1/2021,5109,196248,3331,123307,1786,73144,147.0,29925,76.0,32734,73.0,2672,1634,66653,60.0,2701,19.0,1118,34,2043
109,4/2/2021,4713,200961,2526,125833,2182,75326,245.0,30170,50.0,32784,82.0,2754,1982,68635,91.0,2792,27.0,1145,29,2072
110,4/3/2021,4259,205220,3529,129362,761,76087,94.0,30264,41.0,32825,36.0,2790,677,69312,29.0,2821,19.0,1164,70,2142
111,4/4/2021,371,205591,257,129619,132,76219,6.0,30270,7.0,32832,3.0,2793,116,69428,11.0,2832,2.0,1166,33,2175
112,4/5/2021,4692,210283,3765,133384,948,77167,75.0,30345,47.0,32879,69.0,2862,811,70239,49.0,2881,19.0,1185,93,2268
113,4/6/2021,5168,215451,3032,136416,2316,79483,85.0,30430,58.0,32937,80.0,2942,2055,72294,126.0,3007,55.0,1240,274,2542
114,4/7/2021,4969,220420,3687,140103,2159,81642,60.0,30490,109.0,33046,119.0,3061,1833,74127,134.0,3141,73.0,1313,1175,3717
115,4/8/2021,6693,227113,4514,144617,2855,84497,137.0,30627,123.0,33169,136.0,3197,2506,76633,140.0,3281,73.0,1386,937,4654
116,4/9/2021,5726,232839,3271,147888,3216,87713,77.0,30704,71.0,33240,163.0,3360,2780,79413,180.0,3461,93.0,1479,822,5476
117,4/10/2021,4434,237273,3167,151055,1733,89446,50.0,30754,71.0,33311,97.0,3457,1467,80880,116.0,3577,53.0,1532,520,5996
118,4/11/2021,1038,238311,795,151850,288,89734,6.0,30760,11.0,33322,12.0,3469,241,81121,24.0,3601,11.0,1543,57,6053
119,4/12/2021,5040,243351,3640,155490,2004,91738,75.0,30835,96.0,33418,77.0,3546,1734,82855,133.0,3734,60.0,1603,515,6568
120,4/13/2021,5041,248392,3565,159055,1488,93226,55.0,30890,77.0,33495,70.0,3616,1298,84153,96.0,3830,24.0,1627,22,6590
121,4/14/2021,2959,251351,1441,160496,1511,94737,86.0,30976,26.0,33521,93.0,3709,1315,85468,70.0,3900,33.0,1660,2,6592
122,4/15/2021,4947,256298,2322,162818,2607,97344,102.0,31078,58.0,33579,217.0,3926,2168,87636,161.0,4061,61.0,1721,3,6595
123,4/16/2021,3909,260207,2075,164893,1820,99164,44.0,31122,34.0,33613,66.0,3992,1592,89228,127.0,4188,35.0,1756,4,6599
124,4/17/2021,4590,264797,2404,167297,2169,101333,39.0,31161,57.0,33670,99.0,4091,1887,91115,133.0,4321,50.0,1806,4,6603
125,4/18/2021,1040,265837,409,167706,624,101957,13.0,31174,11.0,33681,42.0,4133,519,91634,33.0,4354,30.0,1836,3,6606
126,4/19/2021,3858,269695,1407,169113,2426,104383,44.0,31218,40.0,33721,166.0,4299,2040,93674,162.0,4516,58.0,1894,5,6611
127,4/20/2021,4704,274399,1870,170983,2817,107200,47.0,31265,69.0,33790,159.0,4458,2402,96076,193.0,4709,63.0,1957,5,6616
128,4/21/2021,3177,277576,712,171695,2452,109652,35.0,31300,31.0,33821,145.0,4603,2063,98139,165.0,4874,79.0,2036,6,6622
129,4/22/2021,4655,282231,1769,173464,2873,112525,46.0,31346,62.0,33883,143.0,4746,2464,100603,193.0,5067,73.0,2109,2,6624
130,4/23/2021,3585,285816,1175,174639,2394,114919,41.0,31387,30.0,33913,73.0,4819,2111,102714,128.0,5195,82.0,2191,5,6629
131,4/24/2021,3357,289173,1119,175758,2234,117153,14.0,31401,20.0,33933,105.0,4924,1894,104608,195.0,5390,40.0,2231,4,6633
132,4/25/2021,797,289970,344,176102,452,117605,6.0,31407,6.0,33939,105.0,5029,268,104876,39.0,5429,40.0,2271,1,6634
133,4/26/2021,4360,294330,1111,177213,3238,120843,36.0,31443,31.0,33970,147.0,5176,2784,107660,215.0,5644,92.0,2363,4,6638
134,4/27/2021,3343,297673,1193,178406,2143,122986,36.0,31479,37.0,34007,79.0,5255,1888,109548,134.0,5778,42.0,2405,10,6648
135,4/28/2021,2991,300664,716,179122,2273,125259,45.0,31524,20.0,34027,168.0,5423,1843,111391,197.0,5975,65.0,2470,13,6661
136,4/29/2021,3965,304629,820,179942,3138,128397,67.0,31591,33.0,34060,226.0,5649,2578,113969,226.0,6201,108.0,2578,8,6669
137,4/30/2021,2874,307503,642,180584,2231,130628,44.0,31635,24.0,34084,74.0,5723,1894,115863,200.0,6401,63.0,2641,12,6681
138,5/1/2021,3651,311154,815,181399,2818,133446,35.0,31670,18.0,34102,283.0,6006,2193,118056,202.0,6603,140.0,2781,16,6697
139,5/2/2021,527,311681,232,181631,306,133752,7.0,31677,2.0,34104,12.0,6018,246,118302,38.0,6641,10.0,2791,10,6707
140,5/3/2021,3429,315110,638,182269,2790,136542,47.0,31724,34.0,34138,107.0,6125,2393,120695,214.0,6855,76.0,2867,13,6720
141,5/4/2021,4348,319458,698,182967,3668,140210,67.0,31791,27.0,34165,148.0,6273,3150,123845,259.0,7114,111.0,2978,30,6750
142,5/5/2021,2231,321689,476,183443,1789,141999,63.0,31854,24.0,34189,86.0,6359,1483,125328,141.0,7255,79.0,3057,14,6764
143,5/6/2021,3691,325380,822,184265,2988,144987,100.0,31954,40.0,34229,179.0,6538,2475,127803,196.0,7451,138.0,3195,44,6808
144,5/7/2021,2940,328320,543,184808,2485,147472,44.0,31998,11.0,34240,135.0,6673,2042,129845,211.0,7662,97.0,3292,40,6848
145,5/8/2021,2995,331315,554,185362,2544,150016,45.0,32043,16.0,34256,166.0,6839,2052,131897,195.0,7857,131.0,3423,47,6895
146,5/9/2021,368,331683,140,185502,241,150257,4.0,32047,2.0,34258,10.0,6849,201,132098,20.0,7877,10.0,3433,3,6898
147,5/10/2021,2428,334111,380,185882,2081,152338,59.0,32106,16.0,34274,87.0,6936,1693,133791,205.0,8082,96.0,3529,25,6923
148,5/11/2021,2719,336830,543,186425,2216,154554,91.0,32197,24.0,34298,189.0,7125,1728,135519,203.0,8285,96.0,3625,17,6940
149,5/12/2021,1231,338061,461,186886,822,155376,23.0,32220,14.0,34312,49.0,7174,652,136171,86.0,8371,35.0,3660,23,6963
150,5/13/2021,3249,341310,1030,187916,2233,157609,82.0,32302,25.0,34337,150.0,7324,1822,137993,156.0,8527,105.0,3765,17,6980
151,5/14/2021,2466,343776,1279,189195,1284,158893,51.0,32353,31.0,34368,64.0,7388,1069,139062,98.0,8625,53.0,3818,34,7014
152,5/15/2021,3021,346797,1512,190707,1590,160483,40.0,32393,15.0,34383,115.0,7503,1262,140324,139.0,8764,74.0,3892,28,7042
153,5/16/2021,944,347741,572,191279,405,160888,8.0,32401,8.0,34391,83.0,7586,252,140576,30.0,8794,40.0,3932,10,7052
154,5/17/2021,2441,350182,1211,192490,1303,162191,38.0,32439,27.0,34418,48.0,7634,1095,141671,102.0,8896,58.0,3990,20,7072
155,5/18/2021,2587,352769,1176,193666,1444,163635,44.0,32483,22.0,34440,72.0,7706,1214,142885,84.0,8980,74.0,4064,17,7089
156,5/19/2021,1876,354645,1153,194819,786,164421,24.0,32507,20.0,34460,42.0,7748,636,143521,69.0,9049,39.0,4103,17,7106
157,5/20/2021,1980,356625,924,195743,1096,165517,45.0,32552,27.0,34487,94.0,7842,873,144394,80.0,9129,49.0,4152,18,7124
158,5/21/2021,1630,358255,923,196666,784,166301,18.0,32570,16.0,34503,43.0,7885,624,145018,60.0,9189,57.0,4209,29,7153
159,5/22/2021,1689,359944,794,197460,924,167225,9.0,32579,13.0,34516,123.0,8008,642,145660,74.0,9263,85.0,4294,17,7170
160,5/23/2021,679,360623,340,197800,368,167593,2.0,32581,5.0,34521,68.0,8076,227,145887,18.0,9281,55.0,4349,3,7173
161,5/24/2021,1337,361960,539,198339,847,168440,36.0,32617,20.0,34541,43.0,8119,680,146567,83.0,9364,41.0,4390,22,7195
162,5/25/2021,1234,363194,510,198849,756,169196,22.0,32639,20.0,34561,58.0,8177,567,147134,66.0,9430,65.0,4455,19,7214
163,5/26/2021,966,364160,552,199401,523,169719,17.0,32656,25.0,34586,38.0,8215,414,147548,44.0,9474,27.0,4482,28,7242
164,5/27/2021,1276,365436,661,200062,678,170397,32.0,32688,19.0,34605,54.0,8269,549,148097,48.0,9522,27.0,4509,21,7263
165,5/28/2021,1032,366468,597,200659,479,170876,18.0,32706,22.0,34627,30.0,8299,372,148469,51.0,9573,26.0,4535,17,7280
166,5/29/2021,1018,367486,493,201152,562,171438,18.0,32724,8.0,34635,32.0,8331,443,148912,42.0,9615,45.0,4580,12,7292
167,5/30/2021,333,367819,220,201372,144,171582,5.0,32729,3.0,34638,12.0,8343,105,149017,17.0,9632,10.0,4590,10,7302
168,5/31/2021,338,368157,192,201564,171,171753,8.0,32737,6.0,34644,8.0,8351,138,149155,12.0,9644,13.0,4603,11,7313
169,6/1/2021,975,369132,401,201965,604,172357,26.0,32763,17.0,34661,49.0,8400,462,149617,46.0,9690,47.0,4650,25,7338
170,6/2/2021,721,369853,370,202335,406,172763,16.0,32779,8.0,34669,34.0,8434,321,149938,23.0,9713,28.0,4678,9,7347
171,6/3/2021,1308,371161,520,202855,836,173599,22.0,32801,12.0,34681,48.0,8482,689,150627,58.0,9771,41.0,4719,15,7362
172,6/4/2021,1496,372657,399,203254,1137,174736,16.0,32817,9.0,34690,72.0,8554,952,151579,67.0,9838,46.0,4765,4,7366
173,6/5/2021,1415,374072,357,203611,1085,175821,12.0,32829,6.0,34696,64.0,8618,889,152468,92.0,9930,40.0,4805,9,7375
174,6/6/2021,530,374602,142,203753,397,176218,5.0,32834,3.0,34699,43.0,8661,317,152785,25.0,9955,12.0,4817,11,7386
175,6/7/2021,1193,375795,335,204088,901,177119,14.0,32848,12.0,34711,68.0,8729,718,153503,83.0,10038,32.0,4849,18,7404
176,6/8/2021,1088,376883,253,204341,859,177978,18.0,32866,5.0,34716,59.0,8788,697,154200,70.0,10108,33.0,4882,4,7408
177,6/9/2021,1080,377963,282,204623,844,178822,16.0,32882,12.0,34728,78.0,8866,647,154847,72.0,10180,47.0,4929,12,7420
178,6/10/2021,1308,379271,336,204959,1009,179831,20.0,32902,4.0,34732,92.0,8958,796,155643,67.0,10247,54.0,4983,10,7430
179,6/11/2021,1113,380384,324,205283,831,180662,20.0,32922,13.0,34745,57.0,9015,652,156295,78.0,10325,44.0,5027,9,7439
180,6/12/2021,1048,381432,290,205573,800,181462,15.0,32937,9.0,34754,73.0,9088,619,156914,65.0,10390,43.0,5070,9,7448
181,6/13/2021,370,381802,98,205671,283,181745,4.0,32941,1.0,34755,37.0,9125,202,157116,25.0,10415,19.0,5089,6,7454
182,6/14/2021,828,382630,282,205953,590,182335,15.0,32956,4.0,34759,44.0,9169,448,157564,42.0,10457,56.0,5145,6,7460
183,6/15/2021,697,383327,236,206189,482,182817,20.0,32976,10.0,34769,41.0,9210,390,157954,34.0,10491,17.0,5162,2,7462
184,6/16/2021,628,383955,203,206392,451,183268,12.0,32988,4.0,34773,38.0,9248,344,158298,34.0,10525,35.0,5197,9,7471
185,6/17/2021,696,384651,252,206644,467,183735,13.0,33001,10.0,34783,42.0,9290,347,158645,49.0,10574,29.0,5226,5,7476
186,6/18/2021,1038,385689,381,207025,686,184421,23.0,33024,11.0,34794,52.0,9342,554,159199,51.0,10625,29.0,5255,8,7484
187,6/19/2021,637,386326,152,207177,499,184920,10.0,33034,6.0,34800,52.0,9394,367,159566,54.0,10679,26.0,5281,10,7494
188,6/20/2021,300,386626,114,207291,192,185112,3.0,33037,2.0,34802,36.0,9430,119,159685,15.0,10694,22.0,5303,5,7499
189,6/21/2021,516,387142,215,207506,327,185439,5.0,33042,8.0,34810,28.0,9458,243,159928,35.0,10729,21.0,5324,8,7507
190,6/22/2021,613,387755,251,207757,392,185831,12.0,33054,7.0,34817,31.0,9489,308,160236,26.0,10755,27.0,5351,5,7512
191,6/23/2021,511,388266,185,207942,354,186185,7.0,33061,10.0,34827,38.0,9527,256,160492,37.0,10792,23.0,5374,11,7523
192,6/24/2021,521,388787,211,208153,333,186518,12.0,33073,9.0,34836,30.0,9557,258,160750,23.0,10815,22.0,5396,1,7524
193,6/25/2021,690,389477,275,208428,437,186955,12.0,33085,8.0,34844,42.0,9599,325,161075,42.0,10857,28.0,5424,5,7529
194,6/26/2021,597,390074,166,208594,440,187395,9.0,33094,9.0,34853,77.0,9676,289,161364,43.0,10900,31.0,5455,4,7533
195,6/27/2021,183,390257,71,208665,113,187508,2.0,33096,3.0,34856,9.0,9685,82,161446,12.0,10912,10.0,5465,2,7535
196,6/28/2021,487,390744,209,208874,285,187793,7.0,33103,6.0,34862,39.0,9724,205,161651,25.0,10937,16.0,5481,2,7537
197,6/29/2021,559,391303,251,209125,329,188122,16.0,33119,11.0,34873,42.0,9766,238,161889,23.0,10960,26.0,5507,11,7548
198,6/30/2021,411,391714,205,209330,221,188343,8.0,33127,11.0,34884,19.0,9785,166,162055,16.0,10976,20.0,5527,11,7559
199,7/1/2021,489,392203,211,209541,295,188638,8.0,33135,7.0,34891,21.0,9806,221,162276,33.0,11009,20.0,5547,5,7564
200,7/2/2021,569,392772,272,209813,307,188945,5.0,33140,7.0,34898,27.0,9833,240,162516,24.0,11033,16.0,5563,3,7567
201,7/3/2021,307,393079,120,209933,194,189139,4.0,33144,3.0,34901,29.0,9862,126,162642,20.0,11053,19.0,5582,5,7572
202,7/4/2021,54,393133,19,209952,35,189174,1.0,33145,0.0,34901,4.0,9866,22,162664,1.0,11054,8.0,5590,0,7572
203,7/5/2021,315,393448,138,210090,177,189351,3.0,33148,1.0,34902,18.0,9884,121,162785,28.0,11082,10.0,5600,4,7576
204,7/6/2021,455,393903,191,210281,273,189624,4.0,33152,5.0,34907,45.0,9929,194,162979,19.0,11101,15.0,5615,1,7577
205,7/7/2021,372,394275,210,210491,176,189800,7.0,33159,6.0,34913,19.0,9948,130,163109,12.0,11113,15.0,5630,4,7581
206,7/8/2021,425,394700,199,210690,247,190047,10.0,33169,8.0,34921,23.0,9971,177,163286,23.0,11136,24.0,5654,3,7584
207,7/9/2021,484,395184,195,210885,295,190342,9.0,33178,2.0,34923,37.0,10008,216,163502,24.0,11160,18.0,5672,6,7590
208,7/10/2021,260,395444,148,211033,128,190470,5.0,33183,2.0,34925,5.0,10013,106,163608,10.0,11170,7.0,5679,2,7592
209,7/11/2021,223,395667,119,211152,122,190592,6.0,33189,6.0,34931,11.0,10024,88,163696,10.0,11180,13.0,5692,7,7599
210,7/12/2021,387,396054,203,211355,196,190788,7.0,33196,4.0,34935,25.0,10049,130,163826,24.0,11204,17.0,5709,5,7604
211,7/13/2021,436,396490,224,211579,225,191013,16.0,33212,10.0,34945,26.0,10075,176,164002,12.0,11216,11.0,5720,4,7608
212,7/14/2021,286,396776,152,211731,154,191167,8.0,33220,5.0,34950,20.0,10095,110,164112,9.0,11225,15.0,5735,9,7617
213,7/15/2021,363,397139,190,211921,184,191351,1.0,33221,4.0,34954,15.0,10110,138,164250,14.0,11239,17.0,5752,3,7620
214,7/16/2021,511,397650,245,212166,278,191629,8.0,33229,9.0,34963,25.0,10135,211,164461,22.0,11261,20.0,5772,4,7624
215,7/17/2021,275,397925,158,212324,127,191756,11.0,33240,5.0,34968,11.0,10146,96,164557,9.0,11270,11.0,5783,7,7631
216,7/18/2021,196,398121,119,212443,89,191845,4.0,33244,3.0,34971,13.0,10159,63,164620,6.0,11276,7.0,5790,4,7635
217,7/19/2021,406,398527,206,212649,206,192051,8.0,33252,8.0,34979,26.0,10185,150,164770,17.0,11293,13.0,5803,4,7639
218,7/20/2021,417,398944,210,212859,215,192266,6.0,33258,8.0,34987,12.0,10197,166,164936,23.0,11316,14.0,5817,5,7644
219,7/21/2021,335,399279,183,213042,172,192438,13.0,33271,14.0,35001,12.0,10209,129,165065,14.0,11330,17.0,5834,3,7647
220,7/22/2021,394,399673,232,213274,169,192607,6.0,33277,18.0,35019,19.0,10228,124,165189,18.0,11348,8.0,5842,6,7653
221,7/23/2021,552,400225,318,213592,237,192844,6.0,33283,10.0,35029,37.0,10265,161,165350,20.0,11368,19.0,5861,3,7656
222,7/24/2021,352,400577,214,213806,157,193001,8.0,33291,10.0,35039,19.0,10284,115,165465,9.0,11377,14.0,5875,5,7661
223,7/25/2021,195,400772,143,213949,62,193063,0.0,33291,4.0,35043,7.0,10291,44,165509,5.0,11382,6.0,5881,4,7665
224,7/26/2021,347,401119,201,214150,143,193206,1.0,33292,7.0,35050,11.0,10302,97,165606,18.0,11400,17.0,5898,4,7669
225,7/27/2021,424,401543,238,214388,174,193380,5.0,33297,16.0,35066,21.0,10323,122,165728,18.0,11418,13.0,5911,15,7684
226,7/28/2021,467,402010,283,214671,222,193602,3.0,33300,10.0,35076,28.0,10351,144,165872,17.0,11435,33.0,5944,5,7689
227,7/29/2021,510,402520,307,214978,232,193834,8.0,33308,6.0,35082,24.0,10375,176,166048,14.0,11449,18.0,5962,10,7699
228,7/30/2021,687,403207,476,215454,249,194083,10.0,33318,14.0,35096,25.0,10400,189,166237,16.0,11465,19.0,5981,5,7704
229,7/31/2021,334,403541,200,215654,138,194221,4.0,33322,1.0,35097,15.0,10415,109,166346,9.0,11474,5.0,5986,5,7709
230,8/1/2021,268,403809,171,215825,105,194326,0.0,33322,2.0,35099,15.0,10430,66,166412,8.0,11482,16.0,6002,8,7717
231,8/2/2021,448,404257,298,216123,174,194500,4.0,33326,13.0,35112,22.0,10452,119,166531,20.0,11502,13.0,6015,6,7723
232,8/3/2021,557,404814,345,216468,237,194737,6.0,33332,13.0,35125,37.0,10489,159,166690,15.0,11517,26.0,6041,4,7727
233,8/4/2021,393,405207,274,216742,140,194877,3.0,33335,14.0,35139,10.0,10499,107,166797,5.0,11522,18.0,6059,10,7737
234,8/5/2021,444,405651,287,217029,168,195045,5.0,33340,11.0,35150,19.0,10518,122,166919,16.0,11538,11.0,6070,4,7741
235,8/6/2021,681,406332,462,217491,265,195310,12.0,33352,16.0,35166,22.0,10540,201,167120,22.0,11560,20.0,6090,4,7745
236,8/7/2021,438,406770,306,217797,155,195465,4.0,33356,10.0,35176,12.0,10552,122,167242,5.0,11565,16.0,6106,5,7750
237,8/8/2021,218,406988,126,217923,99,195564,3.0,33359,5.0,35181,8.0,10560,72,167314,7.0,11572,12.0,6118,5,7755
238,8/9/2021,462,407450,279,218202,213,195777,4.0,33363,6.0,35187,22.0,10582,158,167472,11.0,11583,22.0,6140,6,7761
239,8/10/2021,505,407955,301,218503,229,196006,6.0,33369,14.0,35201,25.0,10607,180,167652,11.0,11594,13.0,6153,8,7769
240,8/11/2021,419,408374,264,218767,177,196183,11.0,33380,5.0,35206,17.0,10624,134,167786,14.0,11608,12.0,6165,2,7771
241,8/12/2021,541,408915,319,219086,259,196442,7.0,33387,13.0,35219,31.0,10655,183,167969,23.0,11631,22.0,6187,7,7778
242,8/13/2021,657,409572,378,219464,298,196740,11.0,33398,9.0,35228,31.0,10686,217,168186,19.0,11650,31.0,6218,5,7783
243,8/14/2021,505,410077,258,219722,249,196989,7.0,33405,9.0,35237,12.0,10698,211,168397,9.0,11659,17.0,6235,46,7829
244,8/15/2021,263,410340,129,219851,123,197112,2.0,33407,3.0,35240,11.0,10709,89,168486,6.0,11665,17.0,6252,15,7844
245,8/16/2021,539,410879,311,220162,170,197282,5.0,33412,11.0,35251,15.0,10724,130,168616,13.0,11678,12.0,6264,69,7913
246,8/17/2021,483,411362,228,220390,194,197476,19.0,33431,10.0,35261,17.0,10741,146,168762,10.0,11688,21.0,6285,67,7980
247,8/18/2021,591,411953,323,220713,257,197733,5.0,33436,15.0,35276,30.0,10771,175,168937,13.0,11701,39.0,6324,64,8044
248,8/19/2021,565,412518,278,220991,255,197988,7.0,33443,9.0,35285,21.0,10792,205,169142,17.0,11718,12.0,6336,68,8112
249,8/20/2021,843,413361,340,221331,450,198438,14.0,33457,10.0,35295,44.0,10836,357,169499,29.0,11747,20.0,6356,80,8192
250,8/21/2021,645,414006,209,221540,209,198647,4.0,33461,7.0,35302,14.0,10850,171,169670,13.0,11760,11.0,6367,180,8372
251,8/22/2021,314,414320,150,221690,141,198788,1.0,33462,2.0,35304,19.0,10869,99,169769,9.0,11769,14.0,6381,29,8401
252,8/23/2021,526,414846,261,221951,221,199009,10.0,33472,9.0,35313,19.0,10888,167,169936,12.0,11781,23.0,6404,58,8459
253,8/24/2021,571,415417,275,222226,274,199283,10.0,33482,8.0,35321,27.0,10915,215,170151,14.0,11795,18.0,6422,50,8509
254,8/25/2021,596,416013,322,222548,257,199540,12.0,33494,13.0,35334,19.0,10934,196,170347,9.0,11804,33.0,6455,48,8557
255,8/26/2021,535,416548,260,222808,253,199793,9.0,33503,14.0,35348,18.0,10952,195,170542,23.0,11827,17.0,6472,42,8599
256,8/27/2021,890,417438,351,223159,405,200198,15.0,33518,11.0,35359,38.0,10990,299,170841,23.0,11850,45.0,6517,144,8743
257,8/28/2021,1467,418905,202,223361,251,200449,7.0,33525,5.0,35364,23.0,11013,188,171029,13.0,11863,27.0,6544,972,9715
258,8/29/2021,1080,419985,160,223521,136,200585,4.0,33529,4.0,35368,8.0,11021,111,171140,12.0,11875,5.0,6549,766,10481
259,8/30/2021,616,420601,272,223793,280,200865,9.0,33538,13.0,35381,24.0,11045,215,171355,9.0,11884,32.0,6581,89,10570
260,8/31/2021,810,421411,235,224028,236,201101,7.0,33545,12.0,35393,18.0,11063,187,171542,18.0,11902,13.0,6594,337,10907
261,9/1/2021,952,422363,247,224275,222,201323,12.0,33557,15.0,35408,21.0,11084,169,171711,13.0,11915,19.0,6613,476,11383
262,9/2/2021,828,423191,184,224459,204,201527,14.0,33571,13.0,35421,18.0,11102,152,171863,17.0,11932,17.0,6630,451,11834
263,9/3/2021,853,424044,340,224799,370,201897,13.0,33584,12.0,35433,43.0,11145,271,172134,21.0,11953,35.0,6665,161,11995
264,9/4/2021,376,424420,163,224962,165,202062,6.0,33590,8.0,35441,13.0,11158,128,172262,11.0,11964,13.0,6678,57,12052
265,9/5/2021,251,424671,131,225093,108,202170,2.0,33592,4.0,35445,12.0,11170,77,172339,9.0,11973,10.0,6688,21,12073
266,9/6/2021,112,424783,46,225139,59,202229,1.0,33593,0.0,35445,4.0,11174,43,172382,8.0,11981,4.0,6692,11,12084
267,9/7/2021,952,425735,199,225338,272,202501,19.0,33612,12.0,35457,22.0,11196,208,172590,17.0,11998,25.0,6717,477,12561
268,9/8/2021,789,426524,219,225557,225,202726,11.0,33623,12.0,35469,24.0,11220,169,172759,10.0,12008,22.0,6739,364,12925
269,9/9/2021,402,426926,176,225733,193,202919,9.0,33632,8.0,35477,21.0,11241,141,172900,14.0,12022,17.0,6756,54,12979
270,9/10/2021,753,427679,340,226073,306,203225,9.0,33641,23.0,35500,28.0,11269,230,173130,20.0,12042,28.0,6784,144,13123
271,9/11/2021,1634,429313,162,226235,210,203435,10.0,33651,19.0,35519,17.0,11286,161,173291,15.0,12057,17.0,6801,1259,14382
272,9/12/2021,232,429545,101,226336,113,203548,1.0,33652,2.0,35521,11.0,11297,73,173364,10.0,12067,19.0,6820,16,14398
273,9/13/2021,493,430038,220,226556,245,203793,9.0,33661,8.0,35529,24.0,11321,184,173548,12.0,12079,25.0,6845,44,14442
274,9/14/2021,845,430883,203,226759,274,204067,13.0,33674,15.0,35544,17.0,11338,220,173768,14.0,12093,23.0,6868,394,14836
275,9/15/2021,832,431715,191,226950,268,204335,15.0,33689,15.0,35559,21.0,11359,199,173967,16.0,12109,32.0,6900,394,15230
276,9/16/2021,355,432070,134,227084,193,204528,9.0,33698,8.0,35567,32.0,11391,138,174105,12.0,12121,11.0,6911,41,15271
277,9/17/2021,749,432819,285,227369,389,204917,13.0,33711,13.0,35580,29.0,11420,291,174396,38.0,12159,31.0,6942,120,15391
278,9/18/2021,1841,434660,127,227496,175,205092,6.0,33717,20.0,35600,10.0,11430,129,174525,16.0,12175,20.0,6962,1530,16921
279,9/19/2021,181,434841,74,227570,105,205197,3.0,33720,2.0,35602,7.0,11437,80,174605,5.0,12180,13.0,6975,10,16931
280,9/20/2021,384,435225,143,227713,216,205413,8.0,33728,9.0,35611,27.0,11464,160,174765,10.0,12190,19.0,6994,54,16985
281,9/21/2021,770,435995,166,227879,200,205613,9.0,33737,14.0,35625,21.0,11485,154,174919,8.0,12198,17.0,7011,413,17398
282,9/22/2021,718,436713,164,228043,229,205842,6.0,33743,12.0,35637,15.0,11500,182,175101,16.0,12214,16.0,7027,358,17756
283,9/23/2021,347,437060,143,228186,179,206021,8.0,33751,3.0,35640,9.0,11509,132,175233,13.0,12227,25.0,7052,46,17802
284,9/24/2021,694,437754,208,228394,274,206295,16.0,33767,16.0,35656,20.0,11529,217,175450,11.0,12238,26.0,7078,229,18031
285,9/25/2021,1731,439485,133,228527,176,206471,11.0,33778,21.0,35677,15.0,11544,137,175587,12.0,12250,12.0,7090,1422,19453
286,9/26/2021,264,439749,66,228593,87,206558,3.0,33781,3.0,35680,11.0,11555,65,175652,4.0,12254,7.0,7097,109,19562
287,9/27/2021,567,440316,156,228749,123,206681,7.0,33788,11.0,35691,7.0,11562,95,175747,8.0,12262,13.0,7110,304,19866
288,9/28/2021,1133,441449,158,228907,203,206884,19.0,33807,23.0,35714,15.0,11577,154,175901,9.0,12271,25.0,7135,788,20654
289,9/29/2021,1137,442586,174,229081,170,207054,12.0,33819,19.0,35733,15.0,11592,127,176028,7.0,12278,21.0,7156,803,21457
290,9/30/2021,710,443296,161,229242,169,207223,15.0,33834,7.0,35740,11.0,11603,129,176157,11.0,12289,18.0,7174,409,21866
291,10/1/2021,1070,444366,177,229419,303,207526,21.0,33855,16.0,35756,20.0,11623,240,176397,21.0,12310,22.0,7196,602,22468
292,10/2/2021,1816,446182,118,229537,115,207641,12.0,33867,14.0,35770,9.0,11632,96,176493,5.0,12315,5.0,7201,1588,24056
293,10/3/2021,392,446574,64,229601,113,207754,1.0,33868,2.0,35772,18.0,11650,77,176570,7.0,12322,11.0,7212,226,24282
294,10/4/2021,795,447369,113,229714,157,207911,7.0,33875,12.0,35784,27.0,11677,103,176673,14.0,12336,13.0,7225,531,24813
295,10/5/2021,1121,448490,138,229852,134,208045,12.0,33887,17.0,35801,13.0,11690,102,176775,5.0,12341,14.0,7239,860,25673
296,10/6/2021,999,449489,107,229959,155,208200,8.0,33895,14.0,35815,11.0,11701,122,176897,5.0,12346,17.0,7256,753,26426
297,10/7/2021,790,450279,137,230096,108,208308,8.0,33903,16.0,35831,8.0,11709,84,176981,5.0,12351,11.0,7267,565,26991
298,10/8/2021,1040,451319,159,230255,241,208549,19.0,33922,11.0,35842,21.0,11730,186,177167,11.0,12362,23.0,7290,652,27643
299,10/9/2021,1676,452995,108,230363,132,208681,11.0,33933,8.0,35850,22.0,11752,98,177265,4.0,12366,8.0,7298,1435,29078
300,10/10/2021,243,453238,50,230413,63,208744,2.0,33935,2.0,35852,4.0,11756,49,177314,5.0,12371,5.0,7303,131,29209
301,10/11/2021,820,454058,121,230534,136,208880,17.0,33952,18.0,35870,3.0,11759,111,177425,10.0,12381,12.0,7315,574,29783
302,10/12/2021,1023,455081,115,230649,133,209013,8.0,33960,19.0,35889,16.0,11775,105,177530,4.0,12385,8.0,7323,785,30568
303,10/13/2021,973,456054,118,230767,151,209164,17.0,33977,9.0,35898,16.0,11791,114,177644,12.0,12397,9.0,7332,723,31291
304,10/14/2021,712,456766,100,230867,127,209291,14.0,33991,9.0,35907,20.0,11811,94,177738,8.0,12405,5.0,7337,492,31783
305,10/15/2021,1027,457793,176,231043,215,209506,11.0,34002,7.0,35914,15.0,11826,169,177907,13.0,12418,18.0,7355,671,32454
306,10/16/2021,802,458595,65,231108,80,209586,4.0,34006,3.0,35917,6.0,11832,69,177976,2.0,12420,3.0,7358,657,33111
307,10/17/2021,196,458791,48,231156,63,209649,1.0,34007,2.0,35919,4.0,11836,47,178023,3.0,12423,9.0,7367,83,33194
308,10/18/2021,650,459441,117,231273,134,209783,10.0,34017,3.0,35922,13.0,11849,105,178128,6.0,12429,10.0,7377,414,33608
309,10/19/2021,1051,460492,120,231393,134,209917,4.0,34021,11.0,35933,8.0,11857,108,178236,8.0,12437,10.0,7387,806,34414
310,10/20/2021,892,461384,121,231514,118,210035,6.0,34027,12.0,35945,8.0,11865,89,178325,7.0,12444,14.0,7401,665,35079
311,10/21/2021,533,461917,107,231621,127,210162,9.0,34036,8.0,35953,14.0,11879,85,178410,11.0,12455,17.0,7418,320,35399
312,10/22/2021,1476,463393,195,231816,227,210389,9.0,34045,13.0,35966,19.0,11898,168,178578,14.0,12469,26.0,7444,1074,36473
313,10/23/2021,1879,465272,86,231902,194,210583,14.0,34059,14.0,35980,4.0,11902,169,178747,11.0,12480,10.0,7454,1602,38075
314,10/24/2021,573,465845,81,231983,151,210734,8.0,34067,11.0,35991,12.0,11914,127,178874,7.0,12487,5.0,7459,353,38428
315,10/25/2021,1386,467231,135,232118,297,211031,27.0,34094,17.0,36008,12.0,11926,252,179126,21.0,12508,12.0,7471,966,39394
316,10/26/2021,2143,469374,178,232296,299,211330,15.0,34109,18.0,36026,19.0,11945,248,179374,18.0,12526,14.0,7485,1676,41070
317,10/27/2021,1969,471343,150,232446,273,211603,18.0,34127,18.0,36044,9.0,11954,241,179615,14.0,12540,9.0,7494,1552,42622
318,10/28/2021,1716,473059,137,232583,262,211865,11.0,34138,19.0,36063,11.0,11965,220,179835,17.0,12557,14.0,7508,1328,43950
319,10/29/2021,1663,474722,177,232760,279,212144,12.0,34150,16.0,36079,10.0,11975,244,180079,12.0,12569,13.0,7521,1218,45168
320,10/30/2021,1589,476311,78,232838,150,212294,13.0,34163,8.0,36087,6.0,11981,129,180208,9.0,12578,6.0,7527,1370,46538
321,10/31/2021,461,476772,48,232886,74,212368,2.0,34165,6.0,36093,6.0,11987,62,180270,4.0,12582,2.0,7529,337,46875
322,11/1/2021,1246,478018,138,233024,216,212584,10.0,34175,10.0,36103,9.0,11996,177,180447,12.0,12594,18.0,7547,898,47773
323,11/2/2021,1822,479840,129,233153,201,212785,8.0,34183,17.0,36120,14.0,12010,162,180609,14.0,12608,11.0,7558,1507,49280
324,11/3/2021,1743,481583,159,233312,230,213015,12.0,34195,17.0,36137,15.0,12025,182,180791,16.0,12624,17.0,7575,1369,50649
325,11/4/2021,1411,482994,144,233456,183,213198,4.0,34199,13.0,36150,1.0,12026,159,180950,12.0,12636,11.0,7586,1108,51757
326,11/5/2021,2016,485010,225,233681,298,213496,14.0,34213,12.0,36162,18.0,12044,251,181201,14.0,12650,15.0,7601,1525,53282
327,11/6/2021,1580,486590,215,233896,142,213638,4.0,34217,7.0,36169,6.0,12050,115,181316,15.0,12665,6.0,7607,1230,54512
328,11/7/2021,531,487121,123,234019,77,213715,1.0,34218,8.0,36177,4.0,12054,64,181380,3.0,12668,6.0,7613,331,54843
329,11/8/2021,1526,488647,386,234405,198,213913,7.0,34225,9.0,36186,11.0,12065,164,181544,9.0,12677,14.0,7627,960,55803
330,11/9/2021,2632,491279,943,235348,221,214134,10.0,34235,21.0,36207,15.0,12080,163,181707,16.0,12693,27.0,7654,1488,57291
331,11/10/2021,2487,493766,823,236171,223,214357,11.0,34246,17.0,36224,12.0,12092,176,181883,22.0,12715,13.0,7667,1463,58754
332,11/11/2021,2350,496116,966,237137,187,214544,17.0,34263,8.0,36232,13.0,12105,153,182036,13.0,12728,8.0,7675,1216,59970
333,11/12/2021,2554,498670,756,237893,240,214784,12.0,34275,19.0,36251,23.0,12128,191,182227,14.0,12742,12.0,7687,1569,61539
334,11/13/2021,1928,500598,404,238297,140,214924,4.0,34279,12.0,36263,7.0,12135,104,182331,15.0,12757,14.0,7701,1393,62932
335,11/14/2021,1482,502080,909,239206,107,215031,1.0,34280,2.0,36265,11.0,12146,72,182403,14.0,12771,10.0,7711,475,63407
336,11/15/2021,1956,504036,450,239656,200,215231,7.0,34287,11.0,36276,12.0,12158,160,182563,12.0,12783,16.0,7727,1327,64734
337,11/16/2021,2401,506437,455,240111,210,215441,5.0,34292,21.0,36297,26.0,12184,153,182716,17.0,12800,14.0,7741,1748,66482
338,11/17/2021,2725,509162,633,240744,268,215709,12.0,34304,16.0,36313,16.0,12200,220,182936,18.0,12818,14.0,7755,1854,68336
339,11/18/2021,1889,511051,377,241121,177,215886,7.0,34311,10.0,36323,15.0,12215,142,183078,15.0,12833,5.0,7760,1350,69686
340,11/19/2021,2565,513616,714,241835,282,216168,13.0,34324,15.0,36338,9.0,12224,235,183313,20.0,12853,18.0,7778,1589,71275
341,11/20/2021,1882,515498,534,242369,113,216281,6.0,34330,5.0,36343,8.0,12232,96,183409,4.0,12857,5.0,7783,1238,72513
342,11/21/2021,639,516137,123,242492,86,216367,0.0,34330,1.0,36344,3.0,12235,70,183479,8.0,12865,5.0,7788,433,72946
343,11/22/2021,1973,518110,425,242917,208,216575,11.0,34341,21.0,36365,10.0,12245,168,183647,12.0,12877,18.0,7806,1360,74306
344,11/23/2021,1839,519949,286,243203,187,216762,8.0,34349,15.0,36380,15.0,12260,151,183798,14.0,12891,7.0,7813,1375,75681
345,11/24/2021,1515,521464,214,243417,166,216928,6.0,34355,11.0,36391,14.0,12274,134,183932,12.0,12903,6.0,7819,1150,76831
346,11/25/2021,46,521510,9,243426,2,216930,0.0,34355,0.0,36391,0.0,12274,1,183933,1.0,12904,,7819,35,76866
347,11/26/2021,1257,522767,190,243616,202,217132,3.0,34358,4.0,36395,17.0,12291,163,184096,12.0,12916,10.0,7829,884,77750
348,11/27/2021,954,523721,136,243752,153,217285,2.0,34360,2.0,36397,8.0,12299,130,184226,8.0,12924,7.0,7836,667,78417
349,11/28/2021,538,524259,94,243846,105,217390,2.0,34362,2.0,36399,9.0,12308,84,184310,5.0,12929,7.0,7843,345,78762
350,11/29/2021,1844,526103,270,244116,412,217802,8.0,34370,13.0,36412,29.0,12337,343,184653,25.0,12954,15.0,7858,1183,79945
351,11/30/2021,2664,528767,336,244452,789,218591,8.0,34378,11.0,36423,51.0,12388,665,185318,61.0,13015,12.0,7870,1559,81504
352,12/1/2021,2436,531203,264,244716,746,219337,13.0,34391,11.0,36434,30.0,12418,656,185974,56.0,13071,4.0,7874,1437,82941
353,12/2/2021,2813,534016,351,245067,912,220249,9.0,34400,15.0,36449,69.0,12487,741,186715,73.0,13144,29.0,7903,1577,84518
354,12/3/2021,2587,536603,279,245346,759,221008,11.0,34411,4.0,36453,61.0,12548,599,187314,71.0,13215,28.0,7931,1569,86087
355,12/4/2021,2187,538790,161,245507,421,221429,4.0,34415,1.0,36454,24.0,12572,329,187643,37.0,13252,31.0,7962,1612,87699
356,12/5/2021,1376,540166,102,245609,841,222270,1.0,34416,0.0,36454,68.0,12640,666,188309,71.0,13323,36.0,7998,442,88141
357,12/6/2021,1924,542090,233,245842,469,222739,7.0,34423,5.0,36459,54.0,12694,366,188675,33.0,13356,16.0,8014,1234,89375
358,12/7/2021,2450,544540,305,246147,468,223207,10.0,34433,9.0,36468,48.0,12742,372,189047,31.0,13387,17.0,8031,1696,91071
359,12/8/2021,2230,546770,268,246415,513,223720,9.0,34442,12.0,36480,31.0,12773,429,189476,40.0,13427,13.0,8044,1470,92541
360,12/9/2021,2151,548921,301,246716,461,224181,6.0,34448,8.0,36488,27.0,12800,357,189833,43.0,13470,34.0,8078,1402,93943
361,12/10/2021,2086,551007,236,246952,402,224583,10.0,34458,9.0,36497,38.0,12838,312,190145,32.0,13502,20.0,8098,1457,95400
362,12/11/2021,1783,552790,137,247089,492,225075,6.0,34464,1.0,36498,59.0,12897,366,190511,41.0,13543,26.0,8124,1156,96556
363,12/12/2021,419,553209,57,247146,87,225162,1.0,34465,3.0,36501,4.0,12901,70,190581,7.0,13550,6.0,8130,277,96833
364,12/13/2021,1750,554959,297,247443,393,225555,9.0,34474,8.0,36509,26.0,12927,319,190900,35.0,13585,13.0,8143,1078,97911
365,12/14/2021,2182,557141,276,247719,364,225919,7.0,34481,5.0,36514,33.0,12960,298,191198,16.0,13601,17.0,8160,1567,99478
366,12/15/2021,1740,558881,199,247918,229,226148,6.0,34487,4.0,36518,9.0,12969,185,191383,20.0,13621,15.0,8175,1326,100804
367,12/16/2021,1769,560650,311,248229,246,226394,7.0,34494,8.0,36526,16.0,12985,207,191590,14.0,13635,9.0,8184,1230,102034
368,12/17/2021,2117,562767,307,248536,443,226837,6.0,34500,9.0,36535,28.0,13013,365,191955,39.0,13674,11.0,8195,1378,103412
369,12/18/2021,1805,564572,177,248713,243,227080,4.0,34504,4.0,36539,17.0,13030,208,192163,10.0,13684,8.0,8203,1385,104797
370,12/19/2021,439,565011,44,248757,80,227160,1.0,34505,3.0,36542,5.0,13035,67,192230,4.0,13688,4.0,8207,315,105112
371,12/20/2021,1551,566562,197,248954,243,227403,10.0,34515,9.0,36551,27.0,13062,194,192424,16.0,13704,6.0,8213,1115,106227
372,12/21/2021,2193,568755,313,249267,295,227698,10.0,34525,8.0,36559,28.0,13090,229,192653,24.0,13728,14.0,8227,1593,107820
373,12/22/2021,1883,570638,221,249488,286,227984,5.0,34530,9.0,36568,29.0,13119,226,192879,23.0,13751,8.0,8235,1378,109198
374,12/23/2021,1242,571880,216,249704,208,228192,5.0,34535,4.0,36572,23.0,13142,157,193036,17.0,13768,11.0,8246,831,110029
375,12/24/2021,321,572201,45,249749,62,228254,2.0,34537,2.0,36574,4.0,13146,53,193089,4.0,13772,1.0,8247,216,110245
376,12/25/2021,13,572214,3,249752,2,228256,0.0,34537,0.0,36574,,13146,1,193090,1.0,13773,,8247,8,110253
377,12/26/2021,358,572572,60,249812,69,228325,1.0,34538,0.0,36574,8.0,13154,53,193143,5.0,13778,3.0,8250,231,110484
378,12/27/2021,1254,573826,172,249984,223,228548,3.0,34541,5.0,36579,17.0,13171,178,193321,20.0,13798,8.0,8258,864,111348
379,12/28/2021,1894,575720,265,250249,297,228845,12.0,34553,11.0,36590,35.0,13206,230,193551,16.0,13814,16.0,8274,1335,112683
380,12/29/2021,1701,577421,208,250457,253,229098,5.0,34558,6.0,36596,28.0,13234,192,193743,22.0,13836,11.0,8285,1251,113934
381,12/30/2021,1372,578793,221,250678,241,229339,7.0,34565,9.0,36605,27.0,13261,187,193930,15.0,13851,12.0,8297,920,114854
382,12/31/2021,507,579300,96,250774,92,229431,0.0,34565,2.0,36607,7.0,13268,75,194005,5.0,13856,5.0,8302,322,115176
383,1/1/2022,93,579393,12,250786,16,229447,1.0,34566,1.0,36608,0.0,13268,13,194018,2.0,13858,1.0,8303,65,115241
384,1/2/2022,315,579708,45,250831,59,229506,1.0,34567,1.0,36609,7.0,13275,41,194059,8.0,13866,3.0,8306,212,115453
385,1/3/2022,1600,581308,327,251158,346,229852,4.0,34571,5.0,36614,34.0,13309,282,194341,20.0,13886,10.0,8316,937,116390
386,1/4/2022,1677,582985,262,251420,276,230128,10.0,34581,7.0,36621,30.0,13339,218,194559,17.0,13903,11.0,8327,1152,117542
387,1/5/2022,1331,584316,203,251623,199,230327,7.0,34588,8.0,36629,13.0,13352,163,194722,9.0,13912,14.0,8341,942,118484
388,1/6/2022,1229,585545,254,251877,232,230559,4.0,34592,4.0,36633,24.0,13376,173,194895,13.0,13925,22.0,8363,752,119236
389,1/7/2022,2058,587603,254,252131,341,230900,6.0,34598,9.0,36642,35.0,13411,263,195158,30.0,13955,13.0,8376,1475,120711
390,1/8/2022,1577,589180,123,252254,130,231030,0.0,34598,3.0,36645,7.0,13418,109,195267,7.0,13962,7.0,8383,1328,122039
391,1/9/2022,497,589677,90,252344,73,231103,0.0,34598,2.0,36647,14.0,13432,50,195317,3.0,13965,6.0,8389,335,122374
392,1/10/2022,1561,591238,290,252634,251,231354,3.0,34601,6.0,36653,19.0,13451,196,195513,27.0,13992,9.0,8398,1031,123405
393,1/11/2022,1565,592803,221,252855,276,231630,3.0,34604,4.0,36657,32.0,13483,210,195723,15.0,14007,19.0,8417,1080,124485
394,1/12/2022,1402,594205,176,253031,186,231816,6.0,34610,5.0,36662,29.0,13512,128,195851,20.0,14027,9.0,8426,1052,125537
395,1/13/2022,1097,595302,192,253223,177,231993,3.0,34613,2.0,36664,13.0,13525,132,195983,18.0,14045,14.0,8440,737,126274
396,1/14/2022,1618,596920,278,253501,215,232208,2.0,34615,9.0,36673,25.0,13550,157,196140,20.0,14065,13.0,8453,1141,127415
397,1/15/2022,1215,598135,134,253635,102,232310,1.0,34616,3.0,36676,11.0,13561,80,196220,9.0,14074,2.0,8455,980,128395
398,1/16/2022,290,598425,47,253682,35,232345,1.0,34617,0.0,36676,1.0,13562,31,196251,3.0,14077,0.0,8455,208,128603
399,1/17/2022,778,599203,161,253843,128,232473,4.0,34621,5.0,36681,12.0,13574,106,196357,8.0,14085,2.0,8457,491,129094
400,1/18/2022,885,600088,163,254006,165,232638,2.0,34623,6.0,36687,25.0,13599,126,196483,6.0,14091,8.0,8465,564,129658
401,1/19/2022,721,600809,121,254127,118,232756,4.0,34627,7.0,36694,9.0,13608,87,196570,10.0,14101,12.0,8477,494,130152
402,1/20/2022,783,601592,145,254272,146,232902,0.0,34627,10.0,36704,17.0,13625,110,196680,10.0,14111,9.0,8486,499,130651
403,1/21/2022,1177,602769,168,254440,171,233073,7.0,34634,2.0,36706,15.0,13640,133,196813,12.0,14123,11.0,8497,847,131498
404,1/22/2022,785,603554,86,254526,104,233177,0.0,34634,1.0,36707,14.0,13654,74,196887,7.0,14130,9.0,8506,596,132094
405,1/23/2022,210,603764,23,254549,54,233231,1.0,34635,0.0,36707,6.0,13660,41,196928,7.0,14137,0.0,8506,134,132228
406,1/24/2022,490,604254,75,254624,107,233338,1.0,34636,1.0,36708,14.0,13674,78,197006,8.0,14145,7.0,8513,311,132539
407,1/25/2022,663,604917,116,254740,143,233481,3.0,34639,2.0,36710,15.0,13689,100,197106,21.0,14166,7.0,8520,405,132944
408,1/26/2022,644,605561,100,254840,140,233621,8.0,34647,2.0,36712,13.0,13702,106,197212,13.0,14179,8.0,8528,413,133357
409,1/27/2022,620,606181,114,254954,173,233794,5.0,34652,1.0,36713,29.0,13731,128,197340,10.0,14189,6.0,8534,339,133696
410,1/28/2022,972,607153,163,255117,170,233964,6.0,34658,6.0,36719,20.0,13751,119,197459,15.0,14204,16.0,8550,642,134338
411,1/29/2022,559,607712,65,255182,88,234052,1.0,34659,4.0,36723,10.0,13761,65,197524,8.0,14212,5.0,8555,406,134744
412,1/30/2022,193,607905,33,255215,45,234097,1.0,34660,1.0,36724,14.0,13775,27,197551,1.0,14213,3.0,8558,117,134861
413,1/31/2022,558,608463,136,255351,122,234219,2.0,34662,2.0,36726,17.0,13792,81,197632,13.0,14226,11.0,8569,303,135164
414,2/1/2022,550,609013,99,255450,138,234357,1.0,34663,4.0,36730,19.0,13811,102,197734,11.0,14237,6.0,8575,315,135479
415,2/2/2022,127,609140,18,255468,45,234402,0.0,34663,1.0,36731,2.0,13813,41,197775,1.0,14238,1.0,8576,67,135546
416,2/3/2022,371,609511,77,255545,117,234519,1.0,34664,3.0,36734,24.0,13837,82,197857,6.0,14244,5.0,8581,182,135728
417,2/4/2022,645,610156,110,255655,147,234666,7.0,34671,5.0,36739,17.0,13854,115,197972,9.0,14253,6.0,8587,389,136117
418,2/5/2022,455,610611,57,255712,112,234778,2.0,34673,0.0,36739,7.0,13861,90,198062,6.0,14259,9.0,8596,288,136405
419,2/6/2022,124,610735,21,255733,34,234812,0.0,34673,1.0,36740,1.0,13862,23,198085,6.0,14265,4.0,8600,70,136475
420,2/7/2022,362,611097,61,255794,109,234921,0.0,34673,0.0,36740,12.0,13874,84,198169,5.0,14270,8.0,8608,194,136669
421,2/8/2022,445,611542,86,255880,116,235037,0.0,34673,3.0,36743,19.0,13893,85,198254,5.0,14275,7.0,8615,253,136922
422,2/9/2022,354,611896,63,255943,98,235135,3.0,34676,1.0,36744,18.0,13911,65,198319,3.0,14278,12.0,8627,196,137118
423,2/10/2022,378,612274,85,256028,89,235224,1.0,34677,3.0,36747,15.0,13926,60,198379,8.0,14286,6.0,8633,205,137323
424,2/11/2022,551,612825,96,256124,157,235381,4.0,34681,1.0,36748,28.0,13954,108,198487,9.0,14295,12.0,8645,303,137626
425,2/12/2022,250,613075,41,256165,51,235432,0.0,34681,0.0,36748,5.0,13959,39,198526,5.0,14300,2.0,8647,161,137787
426,2/13/2022,75,613150,18,256183,16,235448,0.0,34681,1.0,36749,0.0,13959,10,198536,4.0,14304,2.0,8649,43,137830
427,2/14/2022,238,613388,41,256224,51,235499,4.0,34685,2.0,36751,8.0,13967,37,198573,2.0,14306,4.0,8653,148,137978
428,2/15/2022,303,613691,44,256268,95,235594,0.0,34685,0.0,36751,16.0,13983,65,198638,7.0,14313,7.0,8660,168,138146
429,2/16/2022,230,613921,44,256312,64,235658,2.0,34687,0.0,36751,12.0,13995,44,198682,5.0,14318,3.0,8663,125,138271
430,2/17/2022,165,614086,31,256343,44,235702,1.0,34688,1.0,36752,8.0,14003,32,198714,3.0,14321,1.0,8664,93,138364
431,2/18/2022,491,614577,106,256449,111,235813,3.0,34691,2.0,36754,15.0,14018,65,198779,20.0,14341,11.0,8675,274,138638
432,2/19/2022,215,614792,27,256476,61,235874,0.0,34691,0.0,36754,12.0,14030,41,198820,2.0,14343,6.0,8681,129,138767
433,2/20/2022,69,614861,16,256492,13,235887,0.0,34691,0.0,36754,0.0,14030,11,198831,0.0,14343,2.0,8683,41,138808
434,2/21/2022,250,615111,57,256549,75,235962,2.0,34693,1.0,36755,17.0,14047,49,198880,5.0,14348,4.0,8687,123,138931
435,2/22/2022,264,615375,46,256595,85,236047,5.0,34698,0.0,36755,7.0,14054,65,198945,4.0,14352,9.0,8696,138,139069
436,2/23/2022,209,615584,44,256639,45,236092,1.0,34699,0.0,36755,4.0,14058,33,198978,5.0,14357,3.0,8699,120,139189
437,2/24/2022,200,615784,31,256670,51,236143,0.0,34699,1.0,36756,9.0,14067,33,199011,2.0,14359,7.0,8706,120,139309
438,2/25/2022,314,616098,55,256725,103,236246,2.0,34701,0.0,36756,13.0,14080,69,199080,13.0,14372,8.0,8714,159,139468
439,2/26/2022,178,616276,26,256751,43,236289,2.0,34703,1.0,36757,1.0,14081,34,199114,6.0,14378,2.0,8716,111,139579
440,2/27/2022,70,616346,13,256764,21,236310,0.0,34703,1.0,36758,2.0,14083,15,199129,3.0,14381,1.0,8717,36,139615
441,2/28/2022,176,616522,48,256812,44,236354,0.0,34703,0.0,36758,9.0,14092,23,199152,5.0,14386,7.0,8724,85,139700
442,3/1/2022,174,616696,24,256836,46,236400,3.0,34706,2.0,36760,3.0,14095,42,199194,1.0,14387,0.0,8724,109,139809
443,3/2/2022,80,616776,14,256850,23,236423,1.0,34707,0.0,36760,3.0,14098,11,199205,5.0,14392,4.0,8728,44,139853
