,Date,daily number of doses received by Larimer County residents,total number of doses recevied by residents,daily number of residents receiving first dose,total number of residents receiving first dose,daily number of residents vaccinated,total number of residents vaccinated,daily number of 70+ vaccinated,total number of 70+ vaccinated,daily number of 70+ at least one dose,total number of 70+ at least one dose,daily number of Latinx residents vaccinated,total of Latinx residents vaccinated,daily number of White non-Latinx residents vaccinated,total of White non-Latinx residents vaccinated,daily number of non-White non-Latinx residents vaccinated,total of non-White non-Latinx residents vaccinated,dailyUnknown,totalUnknown,daily_additional_doses,total_additional_doses
0,12/14/2020,32,32,32,32,1,1,0.0,0,1.0,1,0.0,0,1,1,0.0,0,,0,0,0
1,12/15/2020,13,45,13,45,0,1,,0,,1,,0,0,1,0.0,0,,0,0,0
2,12/16/2020,303,348,303,348,0,1,0.0,0,2.0,3,0.0,0,0,1,0.0,0,0.0,0,0,0
3,12/17/2020,990,1338,990,1338,0,1,0.0,0,11.0,14,0.0,0,0,1,0.0,0,0.0,0,0,0
4,12/18/2020,1057,2395,1057,2395,2,3,0.0,0,15.0,29,0.0,0,2,3,0.0,0,0.0,0,0,0
5,12/19/2020,722,3117,722,3117,0,3,0.0,0,14.0,43,0.0,0,0,3,0.0,0,0.0,0,0,0
6,12/20/2020,266,3383,266,3383,0,3,0.0,0,4.0,47,0.0,0,0,3,0.0,0,0.0,0,0,0
7,12/21/2020,358,3741,358,3741,3,6,0.0,0,3.0,50,0.0,0,3,6,0.0,0,0.0,0,0,0
8,12/22/2020,364,4105,364,4105,0,6,0.0,0,7.0,57,0.0,0,0,6,0.0,0,0.0,0,0,0
9,12/23/2020,440,4545,440,4545,0,6,0.0,0,6.0,63,0.0,0,0,6,0.0,0,0.0,0,0,0
10,12/24/2020,105,4650,105,4650,0,6,0.0,0,3.0,66,0.0,0,0,6,0.0,0,0.0,0,0,0
11,12/25/2020,1,4651,1,4651,0,6,,0,,66,,0,0,6,,0,,0,0,0
12,12/26/2020,228,4879,228,4879,1,7,0.0,0,3.0,69,0.0,0,1,7,0.0,0,0.0,0,0,0
13,12/27/2020,278,5157,278,5157,0,7,0.0,0,197.0,266,0.0,0,0,7,0.0,0,,0,0,0
14,12/28/2020,709,5866,709,5866,0,7,0.0,0,386.0,652,0.0,0,0,7,0.0,0,0.0,0,0,0
15,12/29/2020,912,6778,911,6777,1,8,0.0,0,461.0,1113,0.0,0,1,8,0.0,0,0.0,0,0,0
16,12/30/2020,882,7660,882,7659,0,8,0.0,0,273.0,1386,0.0,0,0,8,0.0,0,0.0,0,0,0
17,12/31/2020,895,8555,895,8554,0,8,0.0,0,343.0,1729,0.0,0,0,8,0.0,0,0.0,0,0,0
18,1/1/2021,4,8559,3,8557,1,9,,0,,1729,,0,1,9,,0,,0,0,0
19,1/2/2021,392,8951,392,8949,1,10,0.0,0,141.0,1870,0.0,0,1,10,0.0,0,0.0,0,0,0
20,1/3/2021,123,9074,123,9072,0,10,0.0,0,52.0,1922,0.0,0,0,10,0.0,0,0.0,0,0,0
21,1/4/2021,587,9661,574,9646,12,22,0.0,0,320.0,2242,0.0,0,10,20,2.0,2,0.0,0,0,0
22,1/5/2021,646,10307,637,10283,10,32,0.0,0,409.0,2651,0.0,0,9,29,1.0,3,0.0,0,0,0
23,1/6/2021,1232,11539,914,11197,310,342,4.0,4,515.0,3166,18.0,18,272,301,16.0,19,4.0,4,0,0
24,1/7/2021,1657,13196,702,11899,932,1274,11.0,15,406.0,3572,34.0,52,841,1142,42.0,61,15.0,19,0,0
25,1/8/2021,1991,15187,981,12880,994,2268,11.0,26,479.0,4051,48.0,100,883,2025,44.0,105,19.0,38,1,1
26,1/9/2021,1230,16417,529,13409,684,2952,12.0,38,303.0,4354,16.0,116,619,2644,37.0,142,12.0,50,0,1
27,1/10/2021,702,17119,427,13836,272,3224,4.0,42,260.0,4614,10.0,126,245,2889,14.0,156,3.0,53,0,1
28,1/11/2021,1149,18268,798,14634,348,3572,1.0,43,536.0,5150,10.0,136,316,3205,19.0,175,3.0,56,0,1
29,1/12/2021,1178,19446,880,15514,297,3869,8.0,51,517.0,5667,14.0,150,257,3462,18.0,193,8.0,64,1,2
30,1/13/2021,1080,20526,834,16348,243,4112,1.0,52,376.0,6043,23.0,173,197,3659,15.0,208,8.0,72,0,2
31,1/14/2021,872,21398,837,17185,35,4147,1.0,53,494.0,6537,2.0,175,31,3690,1.0,209,1.0,73,0,2
32,1/15/2021,1218,22616,1206,18391,12,4159,0.0,53,760.0,7297,0.0,175,12,3702,0.0,209,0.0,73,0,2
33,1/16/2021,985,23601,971,19362,14,4173,1.0,54,585.0,7882,0.0,175,13,3715,1.0,210,0.0,73,0,2
34,1/17/2021,54,23655,50,19412,4,4177,0.0,54,19.0,7901,0.0,175,2,3717,2.0,212,0.0,73,0,2
35,1/18/2021,1015,24670,813,20225,200,4377,48.0,102,599.0,8500,8.0,183,174,3891,13.0,225,5.0,78,2,4
36,1/19/2021,1258,25928,1117,21342,139,4516,8.0,110,737.0,9237,7.0,190,118,4009,6.0,231,8.0,86,0,4
37,1/20/2021,1422,27350,1203,22545,217,4733,17.0,127,571.0,9808,15.0,205,176,4185,9.0,240,17.0,103,1,5
38,1/21/2021,2253,29603,2043,24588,210,4943,7.0,134,1587.0,11395,13.0,218,174,4359,15.0,255,8.0,111,0,5
39,1/22/2021,1738,31341,1462,26050,275,5218,90.0,224,1091.0,12486,34.0,252,222,4581,13.0,268,6.0,117,0,5
40,1/23/2021,895,32236,560,26610,334,5552,58.0,282,416.0,12902,8.0,260,305,4886,13.0,281,8.0,125,0,5
41,1/24/2021,393,32629,104,26714,286,5838,206.0,488,61.0,12963,8.0,268,269,5155,9.0,290,,125,0,5
42,1/25/2021,1405,34034,784,27498,609,6447,360.0,848,554.0,13517,14.0,282,568,5723,15.0,305,12.0,137,0,5
43,1/26/2021,1622,35656,692,28190,917,7364,453.0,1301,441.0,13958,30.0,312,842,6565,32.0,337,13.0,150,0,5
44,1/27/2021,1837,37493,769,28959,1062,8426,535.0,1836,334.0,14292,40.0,352,968,7533,44.0,381,10.0,160,0,5
45,1/28/2021,1345,38838,539,29498,803,9229,356.0,2192,295.0,14587,25.0,377,735,8268,28.0,409,15.0,175,2,7
46,1/29/2021,1634,40472,1155,30653,476,9705,158.0,2350,826.0,15413,21.0,398,412,8680,33.0,442,10.0,185,0,7
47,1/30/2021,1230,41702,736,31389,490,10195,213.0,2563,599.0,16012,24.0,422,440,9120,20.0,462,6.0,191,0,7
48,1/31/2021,623,42325,398,31787,224,10419,76.0,2639,353.0,16365,5.0,427,198,9318,15.0,477,6.0,197,1,8
49,2/1/2021,1604,43929,901,32688,701,11120,467.0,3106,654.0,17019,17.0,444,648,9966,26.0,503,10.0,207,1,9
50,2/2/2021,1863,45792,729,33417,1128,12248,733.0,3839,582.0,17601,43.0,487,1040,11006,34.0,537,11.0,218,0,9
51,2/3/2021,1264,47056,583,34000,678,12926,320.0,4159,225.0,17826,48.0,535,578,11584,41.0,578,11.0,229,0,9
52,2/4/2021,2535,49591,1794,35794,731,13657,488.0,4647,1551.0,19377,29.0,564,655,12239,37.0,615,10.0,239,1,10
53,2/5/2021,2580,52171,1533,37327,1033,14690,680.0,5327,1305.0,20682,38.0,602,947,13186,30.0,645,18.0,257,2,12
54,2/6/2021,2219,54390,1596,38923,614,15304,441.0,5768,1241.0,21923,6.0,608,584,13770,22.0,667,2.0,259,0,12
55,2/7/2021,232,54622,89,39012,141,15445,94.0,5862,26.0,21949,7.0,615,125,13895,4.0,671,5.0,264,1,13
56,2/8/2021,2485,57107,1597,40609,882,16327,597.0,6459,1139.0,23088,26.0,641,811,14706,28.0,699,17.0,281,0,13
57,2/9/2021,2390,59497,1545,42154,840,17167,511.0,6970,997.0,24085,25.0,666,755,15461,32.0,731,28.0,309,0,13
58,2/10/2021,1587,61084,966,43120,617,17784,321.0,7291,288.0,24373,26.0,692,549,16010,26.0,757,16.0,325,4,17
59,2/11/2021,3535,64619,2001,45121,1526,19310,1054.0,8345,809.0,25182,55.0,747,1395,17405,50.0,807,26.0,351,2,19
60,2/12/2021,3263,67882,1811,46932,1441,20751,953.0,9298,800.0,25982,61.0,808,1325,18730,42.0,849,13.0,364,0,19
61,2/13/2021,2996,70878,2363,49295,627,21378,309.0,9607,672.0,26654,13.0,821,580,19310,23.0,872,11.0,375,1,20
62,2/14/2021,421,71299,350,49645,71,21449,49.0,9656,46.0,26700,2.0,823,64,19374,3.0,875,2.0,377,0,20
63,2/15/2021,2624,73923,2130,51775,491,21940,324.0,9980,256.0,26956,17.0,840,460,19834,12.0,887,2.0,379,0,20
64,2/16/2021,2752,76675,1919,53694,826,22766,497.0,10477,231.0,27187,35.0,875,751,20585,24.0,911,16.0,395,0,20
65,2/17/2021,1634,78309,656,54350,972,23738,479.0,10956,155.0,27342,29.0,904,887,21472,36.0,947,20.0,415,0,20
66,2/18/2021,2640,80949,1674,56024,955,24693,733.0,11689,275.0,27617,37.0,941,881,22353,30.0,977,7.0,422,1,21
67,2/19/2021,2424,83373,1031,57055,1376,26069,1017.0,12706,155.0,27772,44.0,985,1273,23626,44.0,1021,15.0,437,3,24
68,2/20/2021,1651,85024,688,57743,958,27027,783.0,13489,134.0,27906,22.0,1007,898,24524,28.0,1049,10.0,447,1,25
69,2/21/2021,108,85132,40,57783,67,27094,37.0,13526,8.0,27914,1.0,1008,64,24588,2.0,1051,0.0,447,0,25
70,2/22/2021,2024,87156,763,58546,1248,28342,923.0,14449,147.0,28061,37.0,1045,1164,25752,37.0,1088,10.0,457,1,26
71,2/23/2021,1222,88378,518,59064,703,29045,470.0,14919,161.0,28222,20.0,1065,635,26387,35.0,1123,13.0,470,0,26
72,2/24/2021,1409,89787,754,59818,648,29693,276.0,15195,137.0,28359,31.0,1096,593,26980,19.0,1142,5.0,475,1,27
73,2/25/2021,3867,93654,2072,61890,1789,31482,1508.0,16703,351.0,28710,47.0,1143,1689,28669,36.0,1178,17.0,492,0,27
74,2/26/2021,3272,96926,1157,63047,2109,33591,1745.0,18448,201.0,28911,33.0,1176,1988,30657,59.0,1237,29.0,521,2,29
75,2/27/2021,3495,100421,1662,64709,1824,35415,1561.0,20009,544.0,29455,36.0,1212,1709,32366,52.0,1289,27.0,548,1,30
76,2/28/2021,427,100848,357,65066,69,35484,43.0,20052,114.0,29569,2.0,1214,63,32429,2.0,1291,2.0,550,0,30
77,3/1/2021,2819,103667,1344,66410,1469,36953,1078.0,21130,300.0,29869,53.0,1267,1358,33787,46.0,1337,12.0,562,5,35
78,3/2/2021,3257,106924,1729,68139,1520,38473,1050.0,22180,383.0,30252,38.0,1305,1411,35198,44.0,1381,27.0,589,1,36
79,3/3/2021,1656,108580,1091,69230,562,39035,174.0,22354,203.0,30455,32.0,1337,502,35700,24.0,1405,4.0,593,0,36
80,3/4/2021,3004,111584,1582,70812,1423,40458,816.0,23170,170.0,30625,43.0,1380,1306,37006,54.0,1459,20.0,613,25,61
81,3/5/2021,3485,115069,2056,72868,1434,41892,811.0,23981,426.0,31051,39.0,1419,1329,38335,43.0,1502,23.0,636,26,87
82,3/6/2021,4106,119175,2324,75192,1988,43880,754.0,24735,268.0,31319,95.0,1514,1781,40116,77.0,1579,35.0,671,585,672
83,3/7/2021,417,119592,301,75493,125,44005,37.0,24772,20.0,31339,1.0,1515,119,40235,3.0,1582,2.0,673,23,695
84,3/8/2021,2823,122415,1056,76549,1773,45778,260.0,25032,74.0,31413,49.0,1564,1639,41874,62.0,1644,23.0,696,125,820
85,3/9/2021,3186,125601,1653,78202,1548,47326,264.0,25296,96.0,31509,51.0,1615,1408,43282,64.0,1708,25.0,721,73,893
86,3/10/2021,2382,127983,1367,79569,1021,48347,300.0,25596,83.0,31592,54.0,1669,919,44201,32.0,1740,16.0,737,63,956
87,3/11/2021,4176,132159,2379,81948,1802,50149,400.0,25996,135.0,31727,63.0,1732,1652,45853,67.0,1807,20.0,757,76,1032
88,3/12/2021,3949,136108,2576,84524,1395,51544,198.0,26194,67.0,31794,67.0,1799,1242,47095,53.0,1860,33.0,790,69,1101
89,3/13/2021,214,136322,131,84655,99,51643,20.0,26214,7.0,31801,1.0,1800,92,47187,4.0,1864,2.0,792,30,1131
90,3/14/2021,100,136422,60,84715,39,51682,9.0,26223,0.0,31801,1.0,1801,36,47223,1.0,1865,1.0,793,2,1133
91,3/15/2021,899,137321,362,85077,537,52219,85.0,26308,15.0,31816,19.0,1820,494,47717,17.0,1882,7.0,800,19,1152
92,3/16/2021,3287,140608,2116,87193,1173,53392,227.0,26535,46.0,31862,64.0,1884,1046,48763,41.0,1923,22.0,822,30,1182
93,3/17/2021,2907,143515,1786,88979,1124,54516,238.0,26773,88.0,31950,40.0,1924,1029,49792,35.0,1958,20.0,842,32,1214
94,3/18/2021,4003,147518,2090,91069,1924,56440,338.0,27111,91.0,32041,97.0,2021,1742,51534,64.0,2022,21.0,863,21,1235
95,3/19/2021,3002,150520,1753,92822,1250,57690,221.0,27332,42.0,32083,60.0,2081,1125,52659,46.0,2068,19.0,882,16,1251
96,3/20/2021,3082,153602,1966,94788,1118,58808,313.0,27645,54.0,32137,37.0,2118,1006,53665,54.0,2122,21.0,903,36,1287
97,3/21/2021,659,154261,396,95184,265,59073,26.0,27671,5.0,32142,11.0,2129,236,53901,16.0,2138,2.0,905,18,1305
98,3/22/2021,3109,157370,2243,97427,865,59938,188.0,27859,56.0,32198,19.0,2148,796,54697,37.0,2175,13.0,918,26,1331
99,3/23/2021,4443,161813,3567,100994,1175,61113,194.0,28053,75.0,32273,39.0,2187,1048,55745,50.0,2225,38.0,956,490,1821
100,3/24/2021,3161,164974,2427,103421,747,61860,118.0,28171,37.0,32310,40.0,2227,667,56412,26.0,2251,14.0,970,33,1854
101,3/25/2021,5070,170044,3055,106476,2015,63875,312.0,28483,71.0,32381,68.0,2295,1847,58259,69.0,2320,31.0,1001,15,1869
102,3/26/2021,4580,174624,2731,109207,1847,65722,328.0,28811,65.0,32446,119.0,2414,1585,59844,112.0,2432,31.0,1032,30,1899
103,3/27/2021,3342,177966,1914,111121,1423,67145,325.0,29136,21.0,32467,49.0,2463,1308,61152,46.0,2478,20.0,1052,5,1904
104,3/28/2021,1169,179135,809,111930,361,67506,92.0,29228,16.0,32483,12.0,2475,331,61483,16.0,2494,2.0,1054,4,1908
105,3/29/2021,3982,183117,2687,114617,1294,68800,229.0,29457,52.0,32535,39.0,2514,1214,62697,28.0,2522,13.0,1067,8,1916
106,3/30/2021,4373,187490,2756,117373,1644,70444,237.0,29694,74.0,32609,55.0,2569,1503,64200,68.0,2590,18.0,1085,46,1962
107,3/31/2021,3567,191057,2554,119927,1045,71489,166.0,29860,47.0,32656,41.0,2610,934,65134,50.0,2640,20.0,1105,30,1992
108,4/1/2021,5109,196166,3330,123257,1789,73278,148.0,30008,76.0,32732,72.0,2682,1638,66772,60.0,2700,19.0,1124,32,2024
109,4/2/2021,4706,200872,2522,125779,2183,75461,245.0,30253,49.0,32781,82.0,2764,1984,68756,91.0,2791,26.0,1150,27,2051
110,4/3/2021,4257,205129,3527,129306,762,76223,94.0,30347,41.0,32822,36.0,2800,677,69433,29.0,2820,20.0,1170,70,2121
111,4/4/2021,371,205500,257,129563,132,76355,6.0,30353,7.0,32829,3.0,2803,116,69549,11.0,2831,2.0,1172,33,2154
112,4/5/2021,4689,210189,3759,133322,954,77309,75.0,30428,47.0,32876,70.0,2873,816,70365,49.0,2880,19.0,1191,91,2245
113,4/6/2021,5164,215353,3030,136352,2319,79628,85.0,30513,58.0,32934,80.0,2953,2057,72422,126.0,3006,56.0,1247,271,2516
114,4/7/2021,4970,220323,3689,140041,2173,81801,59.0,30572,109.0,33043,118.0,3071,1848,74270,134.0,3140,73.0,1320,1165,3681
115,4/8/2021,6688,227011,4511,144552,2868,84669,137.0,30709,123.0,33166,136.0,3207,2516,76786,141.0,3281,75.0,1395,926,4607
116,4/9/2021,5724,232735,3266,147818,3227,87896,77.0,30786,71.0,33237,163.0,3370,2796,79582,181.0,3462,87.0,1482,810,5417
117,4/10/2021,4434,237169,3165,150983,1747,89643,51.0,30837,71.0,33308,99.0,3469,1475,81057,119.0,3581,54.0,1536,514,5931
118,4/11/2021,1034,238203,793,151776,286,89929,5.0,30842,11.0,33319,12.0,3481,239,81296,24.0,3605,11.0,1547,57,5988
119,4/12/2021,5040,243243,3640,155416,2016,91945,76.0,30918,96.0,33415,77.0,3558,1746,83042,133.0,3738,60.0,1607,507,6495
120,4/13/2021,5034,248277,3563,158979,1485,93430,55.0,30973,77.0,33492,69.0,3627,1296,84338,96.0,3834,24.0,1631,21,6516
121,4/14/2021,2953,251230,1435,160414,1511,94941,86.0,31059,26.0,33518,93.0,3720,1315,85653,70.0,3904,33.0,1664,2,6518
122,4/15/2021,4952,256182,2327,162741,2608,97549,102.0,31161,58.0,33576,217.0,3937,2169,87822,161.0,4065,61.0,1725,3,6521
123,4/16/2021,3910,260092,2078,164819,1818,99367,44.0,31205,34.0,33610,67.0,4004,1590,89412,127.0,4192,34.0,1759,4,6525
124,4/17/2021,4588,264680,2402,167221,2170,101537,39.0,31244,57.0,33667,99.0,4103,1887,91299,132.0,4324,52.0,1811,4,6529
125,4/18/2021,1038,265718,408,167629,623,102160,13.0,31257,11.0,33678,42.0,4145,518,91817,33.0,4357,30.0,1841,4,6533
126,4/19/2021,3860,269578,1411,169040,2425,104585,44.0,31301,40.0,33718,164.0,4309,2040,93857,161.0,4518,60.0,1901,5,6538
127,4/20/2021,4696,274274,1866,170906,2817,107402,47.0,31348,69.0,33787,160.0,4469,2400,96257,193.0,4711,64.0,1965,5,6543
128,4/21/2021,3168,277442,710,171616,2448,109850,35.0,31383,31.0,33818,146.0,4615,2061,98318,163.0,4874,78.0,2043,4,6547
129,4/22/2021,4656,282098,1770,173386,2874,112724,46.0,31429,62.0,33880,143.0,4758,2464,100782,193.0,5067,74.0,2117,2,6549
130,4/23/2021,3588,285686,1176,174562,2396,115120,41.0,31470,30.0,33910,73.0,4831,2113,102895,128.0,5195,82.0,2199,5,6554
131,4/24/2021,3358,289044,1117,175679,2236,117356,14.0,31484,20.0,33930,104.0,4935,1895,104790,196.0,5391,41.0,2240,5,6559
132,4/25/2021,794,289838,343,176022,450,117806,6.0,31490,6.0,33936,105.0,5040,267,105057,38.0,5429,40.0,2280,1,6560
133,4/26/2021,4358,294196,1113,177135,3237,121043,35.0,31525,31.0,33967,147.0,5187,2783,107840,214.0,5643,93.0,2373,4,6564
134,4/27/2021,3345,297541,1192,178327,2146,123189,36.0,31561,37.0,34004,79.0,5266,1890,109730,134.0,5777,43.0,2416,10,6574
135,4/28/2021,2988,300529,718,179045,2270,125459,45.0,31606,20.0,34024,167.0,5433,1842,111572,196.0,5973,65.0,2481,14,6588
136,4/29/2021,3969,304498,820,179865,3143,128602,67.0,31673,33.0,34057,227.0,5660,2583,114155,225.0,6198,108.0,2589,8,6596
137,4/30/2021,2870,307368,641,180506,2229,130831,44.0,31717,24.0,34081,73.0,5733,1895,116050,198.0,6396,63.0,2652,11,6607
138,5/1/2021,3642,311010,818,181324,2806,133637,35.0,31752,18.0,34099,282.0,6015,2185,118235,200.0,6596,139.0,2791,16,6623
139,5/2/2021,527,311537,232,181556,306,133943,7.0,31759,2.0,34101,12.0,6027,246,118481,38.0,6634,10.0,2801,10,6633
140,5/3/2021,3426,314963,637,182193,2788,136731,47.0,31806,34.0,34135,107.0,6134,2392,120873,212.0,6846,77.0,2878,12,6645
141,5/4/2021,4346,319309,698,182891,3666,140397,67.0,31873,27.0,34162,148.0,6282,3149,124022,258.0,7104,111.0,2989,29,6674
142,5/5/2021,2227,321536,477,183368,1786,142183,63.0,31936,24.0,34186,86.0,6368,1480,125502,141.0,7245,79.0,3068,13,6687
143,5/6/2021,3688,325224,822,184190,2984,145167,100.0,32036,40.0,34226,179.0,6547,2474,127976,195.0,7440,136.0,3204,45,6732
144,5/7/2021,2941,328165,542,184732,2490,147657,44.0,32080,11.0,34237,135.0,6682,2046,130022,212.0,7652,97.0,3301,38,6770
145,5/8/2021,2985,331150,554,185286,2535,150192,45.0,32125,16.0,34253,167.0,6849,2043,132065,194.0,7846,131.0,3432,47,6817
146,5/9/2021,367,331517,141,185427,239,150431,4.0,32129,2.0,34255,10.0,6859,199,132264,20.0,7866,10.0,3442,3,6820
147,5/10/2021,2425,333942,380,185807,2079,152510,60.0,32189,16.0,34271,87.0,6946,1691,133955,205.0,8071,96.0,3538,25,6845
148,5/11/2021,2716,336658,541,186348,2217,154727,92.0,32281,24.0,34295,189.0,7135,1729,135684,203.0,8274,96.0,3634,17,6862
149,5/12/2021,1228,337886,459,186807,821,155548,23.0,32304,14.0,34309,49.0,7184,651,136335,86.0,8360,35.0,3669,23,6885
150,5/13/2021,3250,341136,1033,187840,2232,157780,82.0,32386,25.0,34334,151.0,7335,1820,138155,156.0,8516,105.0,3774,16,6901
151,5/14/2021,2473,343609,1280,189120,1291,159071,51.0,32437,30.0,34364,64.0,7399,1072,139227,100.0,8616,55.0,3829,34,6935
152,5/15/2021,3023,346632,1511,190631,1597,160668,40.0,32477,15.0,34379,115.0,7514,1267,140494,141.0,8757,74.0,3903,26,6961
153,5/16/2021,945,347577,573,191204,405,161073,8.0,32485,8.0,34387,83.0,7597,252,140746,30.0,8787,40.0,3943,10,6971
154,5/17/2021,2448,350025,1211,192415,1310,162383,38.0,32523,27.0,34414,48.0,7645,1101,141847,101.0,8888,60.0,4003,20,6991
155,5/18/2021,2587,352612,1178,193593,1443,163826,44.0,32567,22.0,34436,72.0,7717,1212,143059,84.0,8972,75.0,4078,19,7010
156,5/19/2021,1876,354488,1153,194746,787,164613,24.0,32591,19.0,34455,42.0,7759,637,143696,69.0,9041,39.0,4117,16,7026
157,5/20/2021,1979,356467,923,195669,1098,165711,45.0,32636,27.0,34482,94.0,7853,874,144570,81.0,9122,49.0,4166,18,7044
158,5/21/2021,1627,358094,924,196593,782,166493,18.0,32654,16.0,34498,43.0,7896,622,145192,60.0,9182,57.0,4223,27,7071
159,5/22/2021,1688,359782,795,197388,923,167416,9.0,32663,13.0,34511,122.0,8018,641,145833,74.0,9256,86.0,4309,16,7087
160,5/23/2021,680,360462,342,197730,368,167784,2.0,32665,5.0,34516,68.0,8086,227,146060,18.0,9274,55.0,4364,3,7090
161,5/24/2021,1336,361798,537,198267,851,168635,36.0,32701,20.0,34536,43.0,8129,685,146745,82.0,9356,41.0,4405,19,7109
162,5/25/2021,1233,363031,509,198776,755,169390,22.0,32723,20.0,34556,57.0,8186,568,147313,65.0,9421,65.0,4470,19,7128
163,5/26/2021,966,363997,553,199329,526,169916,17.0,32740,25.0,34581,38.0,8224,415,147728,44.0,9465,29.0,4499,25,7153
164,5/27/2021,1271,365268,657,199986,678,170594,32.0,32772,19.0,34600,54.0,8278,548,148276,49.0,9514,27.0,4526,20,7173
165,5/28/2021,1032,366300,597,200583,480,171074,18.0,32790,22.0,34622,29.0,8307,374,148650,49.0,9563,28.0,4554,16,7189
166,5/29/2021,1017,367317,492,201075,562,171636,18.0,32808,8.0,34630,32.0,8339,443,149093,42.0,9605,45.0,4599,12,7201
167,5/30/2021,332,367649,220,201295,143,171779,5.0,32813,3.0,34633,12.0,8351,104,149197,17.0,9622,10.0,4609,10,7211
168,5/31/2021,339,367988,192,201487,174,171953,8.0,32821,6.0,34639,8.0,8359,139,149336,13.0,9635,14.0,4623,10,7221
169,6/1/2021,969,368957,398,201885,602,172555,26.0,32847,17.0,34656,49.0,8408,460,149796,46.0,9681,47.0,4670,24,7245
170,6/2/2021,720,369677,369,202254,407,172962,16.0,32863,8.0,34664,34.0,8442,322,150118,23.0,9704,28.0,4698,8,7253
171,6/3/2021,1308,370985,522,202776,834,173796,22.0,32885,12.0,34676,48.0,8490,687,150805,58.0,9762,41.0,4739,15,7268
172,6/4/2021,1504,372489,404,203180,1141,174937,16.0,32901,9.0,34685,71.0,8561,952,151757,70.0,9832,48.0,4787,4,7272
173,6/5/2021,1414,373903,358,203538,1083,176020,12.0,32913,6.0,34691,64.0,8625,887,152644,92.0,9924,40.0,4827,9,7281
174,6/6/2021,530,374433,141,203679,398,176418,5.0,32918,3.0,34694,43.0,8668,318,152962,25.0,9949,12.0,4839,10,7291
175,6/7/2021,1194,375627,335,204014,902,177320,14.0,32932,12.0,34706,68.0,8736,719,153681,83.0,10032,32.0,4871,19,7310
176,6/8/2021,1087,376714,253,204267,858,178178,18.0,32950,5.0,34711,57.0,8793,697,154378,69.0,10101,35.0,4906,4,7314
177,6/9/2021,1080,377794,283,204550,843,179021,15.0,32965,12.0,34723,78.0,8871,646,155024,72.0,10173,47.0,4953,12,7326
178,6/10/2021,1310,379104,334,204884,1013,180034,20.0,32985,4.0,34727,93.0,8964,799,155823,67.0,10240,54.0,5007,10,7336
179,6/11/2021,1114,380218,325,205209,831,180865,19.0,33004,13.0,34740,57.0,9021,652,156475,78.0,10318,44.0,5051,9,7345
180,6/12/2021,1046,381264,289,205498,799,181664,15.0,33019,9.0,34749,73.0,9094,620,157095,63.0,10381,43.0,5094,9,7354
181,6/13/2021,371,381635,98,205596,284,181948,4.0,33023,1.0,34750,37.0,9131,203,157298,25.0,10406,19.0,5113,6,7360
182,6/14/2021,830,382465,282,205878,592,182540,15.0,33038,4.0,34754,44.0,9175,449,157747,42.0,10448,57.0,5170,6,7366
183,6/15/2021,695,383160,238,206116,479,183019,20.0,33058,10.0,34764,40.0,9215,389,158136,34.0,10482,16.0,5186,2,7368
184,6/16/2021,624,383784,204,206320,446,183465,12.0,33070,4.0,34768,38.0,9253,340,158476,33.0,10515,35.0,5221,9,7377
185,6/17/2021,694,384478,251,206571,468,183933,13.0,33083,10.0,34778,41.0,9294,349,158825,49.0,10564,29.0,5250,4,7381
186,6/18/2021,1036,385514,379,206950,687,184620,23.0,33106,11.0,34789,52.0,9346,555,159380,51.0,10615,29.0,5279,7,7388
187,6/19/2021,635,386149,154,207104,496,185116,10.0,33116,6.0,34795,51.0,9397,365,159745,54.0,10669,26.0,5305,9,7397
188,6/20/2021,300,386449,114,207218,192,185308,3.0,33119,2.0,34797,36.0,9433,119,159864,15.0,10684,22.0,5327,5,7402
189,6/21/2021,516,386965,214,207432,328,185636,5.0,33124,8.0,34805,29.0,9462,243,160107,35.0,10719,21.0,5348,8,7410
190,6/22/2021,611,387576,250,207682,391,186027,12.0,33136,7.0,34812,31.0,9493,307,160414,25.0,10744,28.0,5376,5,7415
191,6/23/2021,510,388086,186,207868,351,186378,7.0,33143,10.0,34822,38.0,9531,254,160668,37.0,10781,22.0,5398,11,7426
192,6/24/2021,519,388605,211,208079,332,186710,12.0,33155,9.0,34831,30.0,9561,258,160926,23.0,10804,21.0,5419,1,7427
193,6/25/2021,690,389295,274,208353,438,187148,12.0,33167,8.0,34839,42.0,9603,325,161251,43.0,10847,28.0,5447,5,7432
194,6/26/2021,598,389893,166,208519,441,187589,9.0,33176,9.0,34848,77.0,9680,290,161541,43.0,10890,31.0,5478,4,7436
195,6/27/2021,183,390076,71,208590,113,187702,2.0,33178,3.0,34851,9.0,9689,82,161623,12.0,10902,10.0,5488,2,7438
196,6/28/2021,487,390563,209,208799,285,187987,7.0,33185,6.0,34857,39.0,9728,206,161829,24.0,10926,16.0,5504,2,7440
197,6/29/2021,560,391123,252,209051,329,188316,16.0,33201,11.0,34868,42.0,9770,239,162068,22.0,10948,26.0,5530,11,7451
198,6/30/2021,412,391535,206,209257,220,188536,8.0,33209,11.0,34879,19.0,9789,165,162233,16.0,10964,20.0,5550,12,7463
199,7/1/2021,486,392021,208,209465,296,188832,8.0,33217,7.0,34886,21.0,9810,222,162455,33.0,10997,20.0,5570,4,7467
200,7/2/2021,569,392590,273,209738,307,189139,5.0,33222,7.0,34893,26.0,9836,242,162697,23.0,11020,16.0,5586,3,7470
201,7/3/2021,307,392897,120,209858,194,189333,4.0,33226,3.0,34896,29.0,9865,126,162823,20.0,11040,19.0,5605,5,7475
202,7/4/2021,53,392950,18,209876,35,189368,1.0,33227,0.0,34896,4.0,9869,22,162845,1.0,11041,8.0,5613,0,7475
203,7/5/2021,316,393266,139,210015,175,189543,3.0,33230,1.0,34897,18.0,9887,121,162966,26.0,11067,10.0,5623,4,7479
204,7/6/2021,453,393719,190,210205,272,189815,4.0,33234,5.0,34902,45.0,9932,193,163159,19.0,11086,15.0,5638,1,7480
205,7/7/2021,372,394091,210,210415,176,189991,7.0,33241,6.0,34908,19.0,9951,130,163289,12.0,11098,15.0,5653,4,7484
206,7/8/2021,424,394515,199,210614,246,190237,10.0,33251,8.0,34916,23.0,9974,177,163466,23.0,11121,23.0,5676,3,7487
207,7/9/2021,482,394997,195,210809,293,190530,9.0,33260,2.0,34918,36.0,10010,215,163681,24.0,11145,18.0,5694,6,7493
208,7/10/2021,259,395256,147,210956,127,190657,5.0,33265,2.0,34920,5.0,10015,105,163786,10.0,11155,7.0,5701,2,7495
209,7/11/2021,223,395479,119,211075,122,190779,6.0,33271,6.0,34926,11.0,10026,88,163874,10.0,11165,13.0,5714,7,7502
210,7/12/2021,385,395864,202,211277,196,190975,7.0,33278,4.0,34930,25.0,10051,130,164004,24.0,11189,17.0,5731,4,7506
211,7/13/2021,437,396301,225,211502,224,191199,16.0,33294,10.0,34940,26.0,10077,175,164179,12.0,11201,11.0,5742,5,7511
212,7/14/2021,282,396583,149,211651,155,191354,8.0,33302,5.0,34945,20.0,10097,111,164290,9.0,11210,15.0,5757,8,7519
213,7/15/2021,361,396944,189,211840,183,191537,1.0,33303,4.0,34949,15.0,10112,138,164428,13.0,11223,17.0,5774,3,7522
214,7/16/2021,510,397454,243,212083,277,191814,8.0,33311,9.0,34958,25.0,10137,210,164638,22.0,11245,20.0,5794,5,7527
215,7/17/2021,276,397730,158,212241,128,191942,11.0,33322,5.0,34963,11.0,10148,97,164735,9.0,11254,11.0,5805,6,7533
216,7/18/2021,195,397925,118,212359,89,192031,4.0,33326,3.0,34966,13.0,10161,63,164798,6.0,11260,7.0,5812,4,7537
217,7/19/2021,406,398331,206,212565,206,192237,8.0,33334,8.0,34974,26.0,10187,150,164948,17.0,11277,13.0,5825,4,7541
218,7/20/2021,416,398747,209,212774,215,192452,6.0,33340,8.0,34982,12.0,10199,166,165114,23.0,11300,14.0,5839,5,7546
219,7/21/2021,335,399082,183,212957,172,192624,13.0,33353,14.0,34996,12.0,10211,129,165243,14.0,11314,17.0,5856,3,7549
220,7/22/2021,394,399476,234,213191,168,192792,7.0,33360,19.0,35015,18.0,10229,124,165367,18.0,11332,8.0,5864,6,7555
221,7/23/2021,551,400027,318,213509,236,193028,6.0,33366,10.0,35025,36.0,10265,161,165528,20.0,11352,19.0,5883,3,7558
222,7/24/2021,352,400379,215,213724,156,193184,8.0,33374,10.0,35035,19.0,10284,114,165642,9.0,11361,14.0,5897,5,7563
223,7/25/2021,199,400578,145,213869,62,193246,0.0,33374,4.0,35039,7.0,10291,44,165686,5.0,11366,6.0,5903,4,7567
224,7/26/2021,345,400923,199,214068,144,193390,1.0,33375,7.0,35046,11.0,10302,98,165784,18.0,11384,17.0,5920,4,7571
225,7/27/2021,423,401346,237,214305,174,193564,5.0,33380,16.0,35062,21.0,10323,122,165906,18.0,11402,13.0,5933,15,7586
226,7/28/2021,468,401814,284,214589,222,193786,3.0,33383,10.0,35072,28.0,10351,144,166050,17.0,11419,33.0,5966,5,7591
227,7/29/2021,510,402324,306,214895,233,194019,8.0,33391,6.0,35078,24.0,10375,177,166227,13.0,11432,19.0,5985,9,7600
228,7/30/2021,683,403007,474,215369,247,194266,10.0,33401,14.0,35092,25.0,10400,187,166414,16.0,11448,19.0,6004,5,7605
229,7/31/2021,334,403341,202,215571,136,194402,4.0,33405,1.0,35093,15.0,10415,107,166521,9.0,11457,5.0,6009,5,7610
230,8/1/2021,267,403608,170,215741,105,194507,0.0,33405,2.0,35095,15.0,10430,66,166587,8.0,11465,16.0,6025,8,7618
231,8/2/2021,446,404054,297,216038,173,194680,4.0,33409,13.0,35108,21.0,10451,119,166706,20.0,11485,13.0,6038,6,7624
232,8/3/2021,560,404614,346,216384,240,194920,6.0,33415,13.0,35121,37.0,10488,162,166868,15.0,11500,26.0,6064,4,7628
233,8/4/2021,390,405004,273,216657,138,195058,3.0,33418,14.0,35135,10.0,10498,105,166973,5.0,11505,18.0,6082,10,7638
234,8/5/2021,445,405449,287,216944,169,195227,5.0,33423,11.0,35146,19.0,10517,122,167095,17.0,11522,11.0,6093,4,7642
235,8/6/2021,679,406128,460,217404,265,195492,12.0,33435,16.0,35162,22.0,10539,201,167296,22.0,11544,20.0,6113,4,7646
236,8/7/2021,439,406567,305,217709,157,195649,4.0,33439,10.0,35172,12.0,10551,124,167420,5.0,11549,16.0,6129,5,7651
237,8/8/2021,217,406784,126,217835,98,195747,3.0,33442,5.0,35177,8.0,10559,71,167491,7.0,11556,12.0,6141,5,7656
238,8/9/2021,465,407249,281,218116,214,195961,4.0,33446,6.0,35183,22.0,10581,159,167650,11.0,11567,22.0,6163,8,7664
239,8/10/2021,503,407752,300,218416,228,196189,6.0,33452,14.0,35197,25.0,10606,179,167829,11.0,11578,13.0,6176,8,7672
240,8/11/2021,418,408170,265,218681,176,196365,11.0,33463,5.0,35202,16.0,10622,134,167963,14.0,11592,12.0,6188,3,7675
241,8/12/2021,541,408711,319,219000,258,196623,7.0,33470,13.0,35215,31.0,10653,181,168144,23.0,11615,23.0,6211,7,7682
242,8/13/2021,658,409369,378,219378,298,196921,11.0,33481,9.0,35224,31.0,10684,217,168361,19.0,11634,31.0,6242,6,7688
243,8/14/2021,504,409873,257,219635,250,197171,7.0,33488,9.0,35233,11.0,10695,213,168574,9.0,11643,17.0,6259,45,7733
244,8/15/2021,264,410137,128,219763,125,197296,2.0,33490,3.0,35236,11.0,10706,91,168665,6.0,11649,17.0,6276,17,7750
245,8/16/2021,539,410676,310,220073,169,197465,5.0,33495,11.0,35247,15.0,10721,129,168794,13.0,11662,12.0,6288,75,7825
246,8/17/2021,483,411159,228,220301,194,197659,19.0,33514,10.0,35257,17.0,10738,146,168940,10.0,11672,21.0,6309,76,7901
247,8/18/2021,592,411751,324,220625,255,197914,5.0,33519,15.0,35272,30.0,10768,172,169112,13.0,11685,40.0,6349,69,7970
248,8/19/2021,567,412318,278,220903,256,198170,7.0,33526,9.0,35281,21.0,10789,206,169318,17.0,11702,12.0,6361,74,8044
249,8/20/2021,840,413158,340,221243,450,198620,15.0,33541,11.0,35292,44.0,10833,357,169675,29.0,11731,20.0,6381,83,8127
250,8/21/2021,646,413804,211,221454,209,198829,4.0,33545,7.0,35299,14.0,10847,171,169846,13.0,11744,11.0,6392,190,8317
251,8/22/2021,316,414120,150,221604,142,198971,1.0,33546,2.0,35301,19.0,10866,100,169946,9.0,11753,14.0,6406,31,8348
252,8/23/2021,528,414648,263,221867,221,199192,10.0,33556,9.0,35310,19.0,10885,167,170113,12.0,11765,23.0,6429,62,8410
253,8/24/2021,569,415217,272,222139,276,199468,10.0,33566,8.0,35318,27.0,10912,216,170329,15.0,11780,18.0,6447,53,8463
254,8/25/2021,591,415808,318,222457,256,199724,12.0,33578,13.0,35331,19.0,10931,195,170524,9.0,11789,33.0,6480,47,8510
255,8/26/2021,533,416341,261,222718,251,199975,9.0,33587,14.0,35345,18.0,10949,193,170717,23.0,11812,17.0,6497,43,8553
256,8/27/2021,888,417229,351,223069,404,200379,15.0,33602,11.0,35356,38.0,10987,299,171016,22.0,11834,45.0,6542,150,8703
257,8/28/2021,1465,418694,202,223271,249,200628,7.0,33609,5.0,35361,23.0,11010,184,171200,14.0,11848,28.0,6570,984,9687
258,8/29/2021,1080,419774,160,223431,136,200764,4.0,33613,4.0,35365,8.0,11018,111,171311,12.0,11860,5.0,6575,770,10457
259,8/30/2021,616,420390,271,223702,281,201045,9.0,33622,13.0,35378,24.0,11042,216,171527,9.0,11869,32.0,6607,90,10547
260,8/31/2021,810,421200,234,223936,237,201282,7.0,33629,12.0,35390,18.0,11060,188,171715,18.0,11887,13.0,6620,339,10886
261,9/1/2021,949,422149,248,224184,221,201503,12.0,33641,15.0,35405,21.0,11081,168,171883,13.0,11900,19.0,6639,481,11367
262,9/2/2021,828,422977,184,224368,204,201707,13.0,33654,14.0,35419,18.0,11099,152,172035,16.0,11916,18.0,6657,457,11824
263,9/3/2021,853,423830,340,224708,370,202077,13.0,33667,12.0,35431,43.0,11142,271,172306,21.0,11937,35.0,6692,163,11987
264,9/4/2021,375,424205,163,224871,164,202241,6.0,33673,8.0,35439,13.0,11155,127,172433,11.0,11948,13.0,6705,57,12044
265,9/5/2021,251,424456,131,225002,108,202349,2.0,33675,4.0,35443,12.0,11167,77,172510,9.0,11957,10.0,6715,21,12065
266,9/6/2021,112,424568,46,225048,59,202408,1.0,33676,0.0,35443,4.0,11171,43,172553,8.0,11965,4.0,6719,12,12077
267,9/7/2021,952,425520,199,225247,272,202680,19.0,33695,12.0,35455,22.0,11193,208,172761,17.0,11982,25.0,6744,484,12561
268,9/8/2021,790,426310,219,225466,226,202906,11.0,33706,12.0,35467,24.0,11217,168,172929,10.0,11992,24.0,6768,367,12928
269,9/9/2021,401,426711,175,225641,193,203099,9.0,33715,8.0,35475,21.0,11238,141,173070,14.0,12006,17.0,6785,54,12982
270,9/10/2021,753,427464,340,225981,307,203406,9.0,33724,23.0,35498,28.0,11266,231,173301,20.0,12026,28.0,6813,145,13127
271,9/11/2021,1634,429098,162,226143,210,203616,10.0,33734,19.0,35517,18.0,11284,160,173461,15.0,12041,17.0,6830,1264,14391
272,9/12/2021,232,429330,100,226243,114,203730,1.0,33735,2.0,35519,11.0,11295,74,173535,10.0,12051,19.0,6849,16,14407
273,9/13/2021,492,429822,220,226463,245,203975,9.0,33744,8.0,35527,24.0,11319,184,173719,12.0,12063,25.0,6874,44,14451
274,9/14/2021,845,430667,204,226667,274,204249,14.0,33758,16.0,35543,17.0,11336,220,173939,14.0,12077,23.0,6897,398,14849
275,9/15/2021,829,431496,190,226857,265,204514,15.0,33773,15.0,35558,21.0,11357,195,174134,17.0,12094,32.0,6929,398,15247
276,9/16/2021,354,431850,134,226991,192,204706,9.0,33782,8.0,35566,32.0,11389,137,174271,11.0,12105,12.0,6941,43,15290
277,9/17/2021,746,432596,284,227275,387,205093,13.0,33795,13.0,35579,29.0,11418,289,174560,38.0,12143,31.0,6972,122,15412
278,9/18/2021,1838,434434,128,227403,171,205264,5.0,33800,20.0,35599,10.0,11428,126,174686,15.0,12158,20.0,6992,1539,16951
279,9/19/2021,180,434614,74,227477,104,205368,3.0,33803,2.0,35601,6.0,11434,80,174766,5.0,12163,13.0,7005,11,16962
280,9/20/2021,385,434999,144,227621,216,205584,8.0,33811,9.0,35610,27.0,11461,160,174926,10.0,12173,19.0,7024,55,17017
281,9/21/2021,771,435770,166,227787,199,205783,9.0,33820,14.0,35624,21.0,11482,153,175079,8.0,12181,17.0,7041,420,17437
282,9/22/2021,718,436488,164,227951,229,206012,6.0,33826,12.0,35636,15.0,11497,181,175260,16.0,12197,17.0,7058,361,17798
283,9/23/2021,348,436836,144,228095,179,206191,8.0,33834,3.0,35639,9.0,11506,132,175392,13.0,12210,25.0,7083,47,17845
284,9/24/2021,696,437532,208,228303,275,206466,16.0,33850,16.0,35655,20.0,11526,218,175610,11.0,12221,26.0,7109,231,18076
285,9/25/2021,1734,439266,136,228439,176,206642,11.0,33861,21.0,35676,15.0,11541,137,175747,12.0,12233,12.0,7121,1428,19504
286,9/26/2021,263,439529,65,228504,87,206729,3.0,33864,3.0,35679,11.0,11552,65,175812,4.0,12237,7.0,7128,110,19614
287,9/27/2021,566,440095,156,228660,123,206852,7.0,33871,11.0,35690,7.0,11559,96,175908,7.0,12244,13.0,7141,303,19917
288,9/28/2021,1130,441225,157,228817,202,207054,19.0,33890,23.0,35713,15.0,11574,153,176061,9.0,12253,25.0,7166,792,20709
289,9/29/2021,1140,442365,174,228991,170,207224,12.0,33902,19.0,35732,15.0,11589,127,176188,7.0,12260,21.0,7187,810,21519
290,9/30/2021,707,443072,162,229153,166,207390,15.0,33917,7.0,35739,11.0,11600,127,176315,10.0,12270,18.0,7205,409,21928
291,10/1/2021,1065,444137,175,229328,301,207691,20.0,33937,15.0,35754,20.0,11620,238,176553,21.0,12291,22.0,7227,604,22532
292,10/2/2021,1815,445952,118,229446,115,207806,12.0,33949,14.0,35768,9.0,11629,96,176649,5.0,12296,5.0,7232,1588,24120
293,10/3/2021,392,446344,64,229510,113,207919,1.0,33950,2.0,35770,18.0,11647,77,176726,7.0,12303,11.0,7243,227,24347
294,10/4/2021,794,447138,113,229623,156,208075,7.0,33957,12.0,35782,27.0,11674,102,176828,14.0,12317,13.0,7256,532,24879
295,10/5/2021,1119,448257,137,229760,135,208210,12.0,33969,17.0,35799,13.0,11687,103,176931,5.0,12322,14.0,7270,858,25737
296,10/6/2021,997,449254,106,229866,155,208365,8.0,33977,14.0,35813,11.0,11698,122,177053,5.0,12327,17.0,7287,753,26490
297,10/7/2021,784,450038,132,229998,107,208472,8.0,33985,14.0,35827,8.0,11706,83,177136,5.0,12332,11.0,7298,565,27055
298,10/8/2021,1037,451075,157,230155,239,208711,19.0,34004,11.0,35838,20.0,11726,186,177322,11.0,12343,22.0,7320,652,27707
299,10/9/2021,1676,452751,108,230263,131,208842,11.0,34015,8.0,35846,22.0,11748,98,177420,3.0,12346,8.0,7328,1439,29146
300,10/10/2021,243,452994,50,230313,63,208905,2.0,34017,2.0,35848,4.0,11752,49,177469,5.0,12351,5.0,7333,131,29277
301,10/11/2021,821,453815,122,230435,136,209041,17.0,34034,18.0,35866,3.0,11755,112,177581,10.0,12361,11.0,7344,574,29851
302,10/12/2021,1024,454839,117,230552,133,209174,8.0,34042,19.0,35885,16.0,11771,104,177685,4.0,12365,9.0,7353,784,30635
303,10/13/2021,972,455811,117,230669,151,209325,17.0,34059,9.0,35894,16.0,11787,114,177799,12.0,12377,9.0,7362,723,31358
304,10/14/2021,710,456521,99,230768,127,209452,14.0,34073,9.0,35903,20.0,11807,94,177893,8.0,12385,5.0,7367,491,31849
305,10/15/2021,1028,457549,177,230945,215,209667,11.0,34084,7.0,35910,15.0,11822,169,178062,13.0,12398,18.0,7385,671,32520
306,10/16/2021,803,458352,66,231011,80,209747,4.0,34088,3.0,35913,6.0,11828,69,178131,2.0,12400,3.0,7388,657,33177
307,10/17/2021,196,458548,48,231059,63,209810,1.0,34089,2.0,35915,4.0,11832,47,178178,3.0,12403,9.0,7397,83,33260
308,10/18/2021,652,459200,119,231178,135,209945,10.0,34099,4.0,35919,13.0,11845,106,178284,6.0,12409,10.0,7407,413,33673
309,10/19/2021,1049,460249,120,231298,134,210079,4.0,34103,11.0,35930,8.0,11853,108,178392,8.0,12417,10.0,7417,805,34478
310,10/20/2021,893,461142,122,231420,121,210200,6.0,34109,12.0,35942,9.0,11862,91,178483,7.0,12424,14.0,7431,664,35142
311,10/21/2021,534,461676,107,231527,127,210327,9.0,34118,8.0,35950,14.0,11876,85,178568,11.0,12435,17.0,7448,321,35463
312,10/22/2021,1476,463152,195,231722,229,210556,9.0,34127,13.0,35963,20.0,11896,170,178738,14.0,12449,25.0,7473,1072,36535
313,10/23/2021,1880,465032,88,231810,195,210751,14.0,34141,15.0,35978,4.0,11900,170,178908,11.0,12460,10.0,7483,1600,38135
314,10/24/2021,571,465603,81,231891,152,210903,8.0,34149,11.0,35989,12.0,11912,128,179036,7.0,12467,5.0,7488,351,38486
315,10/25/2021,1386,466989,136,232027,297,211200,27.0,34176,17.0,36006,12.0,11924,252,179288,21.0,12488,12.0,7500,966,39452
316,10/26/2021,2144,469133,177,232204,300,211500,15.0,34191,17.0,36023,19.0,11943,249,179537,18.0,12506,14.0,7514,1677,41129
317,10/27/2021,1972,471105,153,232357,274,211774,19.0,34210,19.0,36042,9.0,11952,242,179779,14.0,12520,9.0,7523,1552,42681
318,10/28/2021,1713,472818,138,232495,260,212034,11.0,34221,20.0,36062,11.0,11963,219,179998,17.0,12537,13.0,7536,1326,44007
319,10/29/2021,1658,474476,178,232673,279,212313,12.0,34233,15.0,36077,10.0,11973,244,180242,12.0,12549,13.0,7549,1212,45219
320,10/30/2021,1587,476063,79,232752,150,212463,13.0,34246,8.0,36085,6.0,11979,129,180371,9.0,12558,6.0,7555,1367,46586
321,10/31/2021,462,476525,48,232800,74,212537,2.0,34248,6.0,36091,6.0,11985,62,180433,4.0,12562,2.0,7557,339,46925
322,11/1/2021,1241,477766,138,232938,215,212752,10.0,34258,10.0,36101,8.0,11993,177,180610,12.0,12574,18.0,7575,894,47819
323,11/2/2021,1821,479587,129,233067,201,212953,8.0,34266,17.0,36118,14.0,12007,162,180772,14.0,12588,11.0,7586,1506,49325
324,11/3/2021,1744,481331,159,233226,229,213182,12.0,34278,17.0,36135,15.0,12022,181,180953,16.0,12604,17.0,7603,1371,50696
325,11/4/2021,1410,482741,145,233371,183,213365,4.0,34282,13.0,36148,1.0,12023,159,181112,12.0,12616,11.0,7614,1106,51802
326,11/5/2021,2015,484756,226,233597,298,213663,14.0,34296,12.0,36160,17.0,12040,250,181362,14.0,12630,17.0,7631,1523,53325
327,11/6/2021,1578,486334,215,233812,142,213805,4.0,34300,7.0,36167,6.0,12046,115,181477,15.0,12645,6.0,7637,1229,54554
328,11/7/2021,524,486858,118,233930,77,213882,1.0,34301,8.0,36175,5.0,12051,63,181540,3.0,12648,6.0,7643,329,54883
329,11/8/2021,1525,488383,385,234315,198,214080,7.0,34308,9.0,36184,11.0,12062,164,181704,9.0,12657,14.0,7657,963,55846
330,11/9/2021,2631,491014,942,235257,221,214301,10.0,34318,21.0,36205,15.0,12077,163,181867,16.0,12673,27.0,7684,1488,57334
331,11/10/2021,2485,493499,822,236079,223,214524,11.0,34329,17.0,36222,12.0,12089,176,182043,22.0,12695,13.0,7697,1464,58798
332,11/11/2021,2348,495847,965,237044,187,214711,17.0,34346,8.0,36230,13.0,12102,153,182196,13.0,12708,8.0,7705,1215,60013
333,11/12/2021,2553,498400,754,237798,240,214951,12.0,34358,19.0,36249,23.0,12125,191,182387,13.0,12721,13.0,7718,1570,61583
334,11/13/2021,1927,500327,405,238203,140,215091,4.0,34362,12.0,36261,7.0,12132,104,182491,15.0,12736,14.0,7732,1392,62975
335,11/14/2021,1481,501808,910,239113,107,215198,1.0,34363,2.0,36263,11.0,12143,72,182563,14.0,12750,10.0,7742,473,63448
336,11/15/2021,1954,503762,452,239565,200,215398,7.0,34370,11.0,36274,12.0,12155,160,182723,12.0,12762,16.0,7758,1323,64771
337,11/16/2021,2397,506159,454,240019,212,215610,5.0,34375,21.0,36295,26.0,12181,155,182878,17.0,12779,14.0,7772,1743,66514
338,11/17/2021,2723,508882,633,240652,269,215879,12.0,34387,16.0,36311,16.0,12197,222,183100,17.0,12796,14.0,7786,1852,68366
339,11/18/2021,1886,510768,377,241029,177,216056,7.0,34394,11.0,36322,15.0,12212,142,183242,15.0,12811,5.0,7791,1347,69713
340,11/19/2021,2562,513330,716,241745,280,216336,13.0,34407,14.0,36336,9.0,12221,234,183476,20.0,12831,17.0,7808,1586,71299
341,11/20/2021,1878,515208,533,242278,112,216448,6.0,34413,5.0,36341,8.0,12229,95,183571,4.0,12835,5.0,7813,1236,72535
342,11/21/2021,639,515847,124,242402,85,216533,0.0,34413,1.0,36342,3.0,12232,69,183640,8.0,12843,5.0,7818,433,72968
343,11/22/2021,1973,517820,427,242829,207,216740,11.0,34424,21.0,36363,10.0,12242,168,183808,11.0,12854,18.0,7836,1359,74327
344,11/23/2021,1837,519657,289,243118,184,216924,8.0,34432,15.0,36378,15.0,12257,148,183956,14.0,12868,7.0,7843,1372,75699
345,11/24/2021,1509,521166,215,243333,163,217087,6.0,34438,11.0,36389,14.0,12271,131,184087,12.0,12880,6.0,7849,1145,76844
346,11/25/2021,46,521212,9,243342,2,217089,0.0,34438,0.0,36389,0.0,12271,1,184088,1.0,12881,,7849,35,76879
347,11/26/2021,1257,522469,191,243533,202,217291,3.0,34441,4.0,36393,17.0,12288,163,184251,12.0,12893,10.0,7859,883,77762
348,11/27/2021,949,523418,136,243669,153,217444,2.0,34443,2.0,36395,8.0,12296,130,184381,8.0,12901,7.0,7866,662,78424
349,11/28/2021,539,523957,95,243764,105,217549,2.0,34445,2.0,36397,9.0,12305,84,184465,5.0,12906,7.0,7873,345,78769
350,11/29/2021,1842,525799,274,244038,408,217957,8.0,34453,13.0,36410,29.0,12334,339,184804,25.0,12931,15.0,7888,1181,79950
351,11/30/2021,2657,528456,337,244375,788,218745,8.0,34461,11.0,36421,51.0,12385,664,185468,61.0,12992,12.0,7900,1552,81502
352,12/1/2021,2432,530888,264,244639,745,219490,13.0,34474,11.0,36432,30.0,12415,655,186123,56.0,13048,4.0,7904,1434,82936
353,12/2/2021,2806,533694,351,244990,911,220401,9.0,34483,15.0,36447,69.0,12484,740,186863,73.0,13121,29.0,7933,1571,84507
354,12/3/2021,2588,536282,286,245276,755,221156,11.0,34494,4.0,36451,61.0,12545,595,187458,70.0,13191,29.0,7962,1567,86074
355,12/4/2021,2183,538465,161,245437,420,221576,4.0,34498,1.0,36452,24.0,12569,329,187787,36.0,13227,31.0,7993,1609,87683
356,12/5/2021,1375,539840,102,245539,839,222415,1.0,34499,0.0,36452,67.0,12636,666,188453,69.0,13296,37.0,8030,443,88126
357,12/6/2021,1921,541761,233,245772,466,222881,7.0,34506,5.0,36457,54.0,12690,363,188816,33.0,13329,16.0,8046,1234,89360
358,12/7/2021,2447,544208,307,246079,467,223348,10.0,34516,9.0,36466,48.0,12738,372,189188,31.0,13360,16.0,8062,1692,91052
359,12/8/2021,2229,546437,271,246350,512,223860,9.0,34525,12.0,36478,29.0,12767,429,189617,40.0,13400,14.0,8076,1468,92520
360,12/9/2021,2144,548581,303,246653,459,224319,6.0,34531,8.0,36486,27.0,12794,356,189973,43.0,13443,33.0,8109,1396,93916
361,12/10/2021,2087,550668,241,246894,403,224722,10.0,34541,9.0,36495,38.0,12832,313,190286,32.0,13475,20.0,8129,1453,95369
362,12/11/2021,1783,552451,137,247031,493,225215,6.0,34547,1.0,36496,59.0,12891,367,190653,41.0,13516,26.0,8155,1155,96524
363,12/12/2021,415,552866,55,247086,88,225303,1.0,34548,3.0,36499,4.0,12895,71,190724,7.0,13523,6.0,8161,275,96799
364,12/13/2021,1751,554617,297,247383,393,225696,9.0,34557,8.0,36507,26.0,12921,319,191043,35.0,13558,13.0,8174,1079,97878
365,12/14/2021,2179,556796,276,247659,365,226061,7.0,34564,5.0,36512,33.0,12954,299,191342,16.0,13574,17.0,8191,1563,99441
366,12/15/2021,1738,558534,200,247859,229,226290,6.0,34570,4.0,36516,9.0,12963,185,191527,20.0,13594,15.0,8206,1323,100764
367,12/16/2021,1767,560301,313,248172,246,226536,7.0,34577,8.0,36524,15.0,12978,207,191734,15.0,13609,9.0,8215,1226,101990
368,12/17/2021,2116,562417,307,248479,443,226979,6.0,34583,10.0,36534,28.0,13006,365,192099,39.0,13648,11.0,8226,1377,103367
369,12/18/2021,1803,564220,179,248658,241,227220,4.0,34587,4.0,36538,17.0,13023,206,192305,10.0,13658,8.0,8234,1384,104751
370,12/19/2021,438,564658,44,248702,80,227300,1.0,34588,3.0,36541,5.0,13028,66,192371,4.0,13662,5.0,8239,314,105065
371,12/20/2021,1550,566208,197,248899,243,227543,10.0,34598,9.0,36550,27.0,13055,192,192563,16.0,13678,8.0,8247,1115,106180
372,12/21/2021,2189,568397,311,249210,295,227838,10.0,34608,8.0,36558,28.0,13083,228,192791,25.0,13703,14.0,8261,1591,107771
373,12/22/2021,1874,570271,219,249429,285,228123,4.0,34612,9.0,36567,28.0,13111,227,193018,22.0,13725,8.0,8269,1373,109144
374,12/23/2021,1235,571506,217,249646,206,228329,5.0,34617,4.0,36571,23.0,13134,156,193174,16.0,13741,11.0,8280,825,109969
375,12/24/2021,320,571826,45,249691,63,228392,3.0,34620,2.0,36573,4.0,13138,54,193228,4.0,13745,1.0,8281,214,110183
376,12/25/2021,14,571840,3,249694,2,228394,0.0,34620,0.0,36573,,13138,1,193229,1.0,13746,,8281,9,110192
377,12/26/2021,356,572196,60,249754,68,228462,1.0,34621,0.0,36573,7.0,13145,53,193282,5.0,13751,3.0,8284,230,110422
378,12/27/2021,1251,573447,175,249929,221,228683,4.0,34625,5.0,36578,18.0,13163,175,193457,20.0,13771,8.0,8292,862,111284
379,12/28/2021,1892,575339,268,250197,295,228978,12.0,34637,11.0,36589,35.0,13198,230,193687,16.0,13787,14.0,8306,1333,112617
380,12/29/2021,1698,577037,212,250409,252,229230,5.0,34642,6.0,36595,27.0,13225,192,193879,22.0,13809,11.0,8317,1245,113862
381,12/30/2021,1366,578403,222,250631,240,229470,7.0,34649,9.0,36604,26.0,13251,187,194066,15.0,13824,12.0,8329,914,114776
382,12/31/2021,504,578907,97,250728,92,229562,0.0,34649,2.0,36606,7.0,13258,75,194141,5.0,13829,5.0,8334,318,115094
383,1/1/2022,93,579000,12,250740,16,229578,1.0,34650,1.0,36607,0.0,13258,13,194154,2.0,13831,1.0,8335,65,115159
384,1/2/2022,315,579315,45,250785,59,229637,1.0,34651,1.0,36608,7.0,13265,41,194195,8.0,13839,3.0,8338,212,115371
385,1/3/2022,1594,580909,330,251115,345,229982,4.0,34655,5.0,36613,34.0,13299,281,194476,20.0,13859,10.0,8348,929,116300
386,1/4/2022,1674,582583,264,251379,275,230257,10.0,34665,7.0,36620,30.0,13329,217,194693,17.0,13876,11.0,8359,1148,117448
387,1/5/2022,1330,583913,205,251584,200,230457,7.0,34672,8.0,36628,13.0,13342,163,194856,9.0,13885,15.0,8374,938,118386
388,1/6/2022,1227,585140,254,251838,232,230689,4.0,34676,4.0,36632,24.0,13366,173,195029,13.0,13898,22.0,8396,750,119136
389,1/7/2022,2055,587195,253,252091,341,231030,6.0,34682,9.0,36641,35.0,13401,263,195292,30.0,13928,13.0,8409,1473,120609
390,1/8/2022,1574,588769,124,252215,130,231160,0.0,34682,3.0,36644,7.0,13408,109,195401,7.0,13935,7.0,8416,1324,121933
391,1/9/2022,499,589268,92,252307,72,231232,0.0,34682,2.0,36646,14.0,13422,49,195450,3.0,13938,6.0,8422,336,122269
392,1/10/2022,1553,590821,287,252594,250,231482,3.0,34685,6.0,36652,19.0,13441,193,195643,27.0,13965,11.0,8433,1027,123296
393,1/11/2022,1560,592381,220,252814,274,231756,3.0,34688,4.0,36656,31.0,13472,209,195852,15.0,13980,19.0,8452,1078,124374
394,1/12/2022,1402,593783,178,252992,185,231941,6.0,34694,5.0,36661,29.0,13501,127,195979,20.0,14000,9.0,8461,1051,125425
395,1/13/2022,1097,594880,191,253183,177,232118,3.0,34697,2.0,36663,14.0,13515,131,196110,18.0,14018,14.0,8475,738,126163
396,1/14/2022,1618,596498,278,253461,213,232331,2.0,34699,9.0,36672,25.0,13540,155,196265,20.0,14038,13.0,8488,1142,127305
397,1/15/2022,1215,597713,136,253597,102,232433,1.0,34700,3.0,36675,11.0,13551,80,196345,9.0,14047,2.0,8490,978,128283
398,1/16/2022,290,598003,47,253644,35,232468,1.0,34701,0.0,36675,1.0,13552,31,196376,3.0,14050,0.0,8490,208,128491
399,1/17/2022,774,598777,160,253804,127,232595,4.0,34705,5.0,36680,12.0,13564,105,196481,8.0,14058,2.0,8492,489,128980
400,1/18/2022,886,599663,164,253968,165,232760,2.0,34707,6.0,36686,25.0,13589,126,196607,6.0,14064,8.0,8500,564,129544
401,1/19/2022,720,600383,121,254089,118,232878,4.0,34711,7.0,36693,9.0,13598,87,196694,10.0,14074,12.0,8512,493,130037
402,1/20/2022,780,601163,146,254235,147,233025,0.0,34711,10.0,36703,17.0,13615,111,196805,10.0,14084,9.0,8521,494,130531
403,1/21/2022,1174,602337,167,254402,171,233196,7.0,34718,2.0,36705,15.0,13630,132,196937,12.0,14096,12.0,8533,845,131376
404,1/22/2022,781,603118,87,254489,102,233298,0.0,34718,1.0,36706,14.0,13644,73,197010,6.0,14102,9.0,8542,593,131969
405,1/23/2022,210,603328,24,254513,53,233351,1.0,34719,0.0,36706,5.0,13649,41,197051,7.0,14109,0.0,8542,134,132103
406,1/24/2022,490,603818,75,254588,107,233458,1.0,34720,1.0,36707,14.0,13663,78,197129,8.0,14117,7.0,8549,311,132414
407,1/25/2022,661,604479,116,254704,142,233600,3.0,34723,2.0,36709,15.0,13678,100,197229,20.0,14137,7.0,8556,404,132818
408,1/26/2022,643,605122,100,254804,140,233740,8.0,34731,2.0,36711,13.0,13691,106,197335,13.0,14150,8.0,8564,412,133230
409,1/27/2022,616,605738,114,254918,171,233911,5.0,34736,1.0,36712,29.0,13720,126,197461,10.0,14160,6.0,8570,337,133567
410,1/28/2022,968,606706,163,255081,169,234080,6.0,34742,6.0,36718,20.0,13740,119,197580,14.0,14174,16.0,8586,641,134208
411,1/29/2022,558,607264,68,255149,85,234165,1.0,34743,4.0,36722,10.0,13750,62,197642,8.0,14182,5.0,8591,405,134613
412,1/30/2022,191,607455,33,255182,43,234208,1.0,34744,1.0,36723,13.0,13763,26,197668,1.0,14183,3.0,8594,117,134730
413,1/31/2022,558,608013,138,255320,120,234328,2.0,34746,2.0,36725,17.0,13780,79,197747,13.0,14196,11.0,8605,304,135034
414,2/1/2022,548,608561,99,255419,137,234465,0.0,34746,4.0,36729,19.0,13799,102,197849,11.0,14207,5.0,8610,314,135348
415,2/2/2022,127,608688,18,255437,45,234510,0.0,34746,1.0,36730,2.0,13801,41,197890,1.0,14208,1.0,8611,67,135415
416,2/3/2022,367,609055,75,255512,115,234625,1.0,34747,3.0,36733,24.0,13825,79,197969,6.0,14214,6.0,8617,182,135597
417,2/4/2022,642,609697,108,255620,146,234771,6.0,34753,3.0,36736,17.0,13842,114,198083,9.0,14223,6.0,8623,390,135987
418,2/5/2022,456,610153,57,255677,112,234883,2.0,34755,0.0,36736,7.0,13849,90,198173,6.0,14229,9.0,8632,289,136276
419,2/6/2022,123,610276,20,255697,34,234917,0.0,34755,1.0,36737,1.0,13850,23,198196,6.0,14235,4.0,8636,70,136346
420,2/7/2022,362,610638,61,255758,110,235027,0.0,34755,0.0,36737,12.0,13862,85,198281,5.0,14240,8.0,8644,193,136539
421,2/8/2022,441,611079,85,255843,115,235142,0.0,34755,3.0,36740,19.0,13881,84,198365,5.0,14245,7.0,8651,251,136790
422,2/9/2022,353,611432,63,255906,98,235240,3.0,34758,1.0,36741,18.0,13899,65,198430,3.0,14248,12.0,8663,195,136985
423,2/10/2022,371,611803,83,255989,89,235329,1.0,34759,3.0,36744,16.0,13915,60,198490,8.0,14256,5.0,8668,200,137185
424,2/11/2022,541,612344,95,256084,155,235484,3.0,34762,0.0,36744,28.0,13943,106,198596,9.0,14265,12.0,8680,296,137481
425,2/12/2022,249,612593,41,256125,51,235535,0.0,34762,0.0,36744,5.0,13948,39,198635,5.0,14270,2.0,8682,160,137641
426,2/13/2022,75,612668,18,256143,16,235551,0.0,34762,1.0,36745,0.0,13948,10,198645,4.0,14274,2.0,8684,43,137684
427,2/14/2022,237,612905,42,256185,51,235602,4.0,34766,2.0,36747,8.0,13956,37,198682,2.0,14276,4.0,8688,146,137830
428,2/15/2022,272,613177,35,256220,82,235684,0.0,34766,0.0,36747,12.0,13968,58,198740,7.0,14283,5.0,8693,159,137989
429,2/16/2022,121,613298,22,256242,26,235710,1.0,34767,0.0,36747,6.0,13974,18,198758,2.0,14285,0.0,8693,74,138063
